fg,fga,fg_pct,fg3,fg3a,fg3_pct,ft,fta,ft_pct,orb,drb,trb,ast,stl,blk,tov,pf,fg2,fga2,fg2_pct,result
43,93,0.462,16,39,0.41,12,14,0.857,10,38,48,24,8,3,11,20,27,54,0.5,1
35,86,0.407,7,37,0.189,19,23,0.826,10,35,45,19,6,6,15,16,28,49,0.5714285714285714,0
43,90,0.478,14,39,0.359,8,10,0.8,10,38,48,34,10,6,17,18,29,51,0.5686274509803921,1
35,86,0.407,9,31,0.29,14,21,0.667,10,32,42,23,9,4,19,15,26,55,0.4727272727272727,0
29,78,0.372,7,33,0.212,18,25,0.72,5,36,41,20,10,2,16,24,22,45,0.4888888888888889,0
32,78,0.41,12,37,0.324,17,23,0.739,4,45,49,18,9,3,17,25,20,41,0.4878048780487805,1
37,76,0.487,13,35,0.371,19,21,0.905,8,29,37,24,1,4,17,20,24,41,0.5853658536585366,1
39,86,0.453,12,29,0.414,13,16,0.813,8,30,38,28,7,1,12,25,27,57,0.47368421052631576,0
39,83,0.47,8,31,0.258,7,14,0.5,7,37,44,20,12,11,21,20,31,52,0.5961538461538461,0
36,88,0.409,11,34,0.324,13,20,0.65,12,36,48,18,9,2,20,16,25,54,0.46296296296296297,1
40,92,0.435,20,43,0.465,23,30,0.767,8,43,51,23,11,3,10,27,20,49,0.40816326530612246,1
31,79,0.392,7,35,0.2,29,33,0.879,3,41,44,19,4,9,15,28,24,44,0.5454545454545454,0
38,87,0.437,6,26,0.231,14,20,0.7,6,36,42,18,10,6,21,21,32,61,0.5245901639344263,0
42,85,0.494,22,45,0.489,20,30,0.667,5,39,44,27,16,6,17,19,20,40,0.5,1
49,89,0.551,16,33,0.485,16,21,0.762,8,35,43,35,9,3,16,19,33,56,0.5892857142857143,1
42,88,0.477,13,36,0.361,12,21,0.571,11,32,43,17,9,3,20,22,29,52,0.5576923076923077,0
41,101,0.406,14,33,0.424,13,16,0.813,16,42,58,27,8,7,13,20,27,68,0.39705882352941174,1
36,85,0.424,13,34,0.382,18,26,0.692,8,37,45,23,3,8,13,20,23,51,0.45098039215686275,0
33,85,0.388,13,33,0.394,21,24,0.875,12,31,43,19,6,8,10,16,20,52,0.38461538461538464,0
41,89,0.461,15,42,0.357,9,14,0.643,13,33,46,28,3,3,14,20,26,47,0.5531914893617021,1
38,91,0.418,7,29,0.241,13,17,0.765,15,31,46,19,10,2,15,21,31,62,0.5,1
35,85,0.412,11,32,0.344,10,19,0.526,15,33,48,22,9,5,22,20,24,53,0.4528301886792453,0
35,90,0.389,9,28,0.321,15,21,0.714,14,33,47,11,5,4,15,21,26,62,0.41935483870967744,0
36,81,0.444,13,41,0.317,17,23,0.739,6,42,48,15,10,10,14,22,23,40,0.575,1
42,83,0.506,12,27,0.444,10,13,0.769,10,41,51,23,4,3,16,16,30,56,0.5357142857142857,1
34,84,0.405,19,50,0.38,15,18,0.833,5,27,32,22,6,4,9,21,15,34,0.4411764705882353,0
38,91,0.418,14,48,0.292,26,27,0.963,10,30,40,21,6,4,10,29,24,43,0.5581395348837209,0
35,83,0.422,14,38,0.368,36,47,0.766,14,36,50,26,6,7,13,18,21,45,0.4666666666666667,1
38,86,0.442,13,41,0.317,19,21,0.905,6,46,52,22,5,5,12,17,25,45,0.5555555555555556,1
40,108,0.37,10,38,0.263,9,12,0.75,15,40,55,21,7,1,6,18,30,70,0.42857142857142855,0
38,92,0.413,13,35,0.371,23,26,0.885,14,26,40,34,15,5,12,18,25,57,0.43859649122807015,0
47,79,0.595,16,35,0.457,17,24,0.708,7,38,45,35,10,7,22,17,31,44,0.7045454545454546,1
43,104,0.413,12,33,0.364,25,34,0.735,13,36,49,27,9,3,7,22,31,71,0.43661971830985913,1
40,81,0.494,14,32,0.438,28,31,0.903,7,44,51,25,5,9,20,24,26,49,0.5306122448979592,0
39,89,0.438,11,42,0.262,19,27,0.704,11,30,41,23,6,4,15,27,28,47,0.5957446808510638,0
39,85,0.459,13,37,0.351,27,30,0.9,11,37,48,16,11,2,16,24,26,48,0.5416666666666666,1
49,87,0.563,15,33,0.455,9,13,0.692,12,29,41,35,4,5,18,22,34,54,0.6296296296296297,1
41,86,0.477,16,36,0.444,22,25,0.88,8,25,33,29,8,7,10,16,25,50,0.5,0
41,98,0.418,14,43,0.326,26,33,0.788,12,28,40,16,7,2,12,27,27,55,0.4909090909090909,0
49,88,0.557,13,34,0.382,26,34,0.765,11,42,53,23,4,7,15,24,36,54,0.6666666666666666,1
41,89,0.461,12,35,0.343,14,19,0.737,12,37,49,24,9,5,10,15,29,54,0.5370370370370371,1
39,95,0.411,9,33,0.273,7,8,0.875,14,36,50,23,6,3,13,18,30,62,0.4838709677419355,0
45,92,0.489,19,45,0.422,15,21,0.714,13,30,43,34,6,4,15,11,26,47,0.5531914893617021,1
44,85,0.518,10,31,0.323,11,16,0.688,9,27,36,30,11,6,14,17,34,54,0.6296296296296297,0
40,83,0.482,17,29,0.586,15,19,0.789,8,29,37,24,5,2,10,22,23,54,0.42592592592592593,1
37,75,0.493,10,33,0.303,23,28,0.821,7,33,40,23,4,3,14,22,27,42,0.6428571428571429,0
49,89,0.551,21,41,0.512,11,19,0.579,9,48,57,29,4,11,20,18,28,48,0.5833333333333334,1
44,105,0.419,6,19,0.316,15,21,0.714,14,31,45,23,13,4,7,16,38,86,0.4418604651162791,0
43,85,0.506,7,21,0.333,20,25,0.8,11,34,45,26,9,6,16,21,36,64,0.5625,1
40,87,0.46,10,31,0.323,18,23,0.783,10,30,40,24,4,2,13,21,30,56,0.5357142857142857,0
34,90,0.378,10,35,0.286,28,39,0.718,11,41,52,20,5,6,15,20,24,55,0.43636363636363634,0
51,97,0.526,23,43,0.535,12,14,0.857,3,45,48,41,4,6,11,28,28,54,0.5185185185185185,1
39,82,0.476,16,39,0.41,19,20,0.95,10,41,51,24,4,3,18,31,23,43,0.5348837209302325,1
30,77,0.39,11,40,0.275,29,36,0.806,7,28,35,17,5,4,12,19,19,37,0.5135135135135135,0
29,79,0.367,13,48,0.271,19,27,0.704,6,32,38,20,6,4,18,15,16,31,0.5161290322580645,0
46,81,0.568,16,34,0.471,10,18,0.556,4,43,47,34,7,0,16,20,30,47,0.6382978723404256,1
43,98,0.439,17,40,0.425,12,12,1.0,6,25,31,27,9,5,9,17,26,58,0.4482758620689655,0
49,85,0.576,14,34,0.412,13,16,0.813,7,42,49,32,6,4,19,18,35,51,0.6862745098039216,1
45,93,0.484,19,45,0.422,9,13,0.692,5,37,42,32,10,8,14,27,26,48,0.5416666666666666,1
44,101,0.436,9,27,0.333,19,24,0.792,16,41,57,26,5,4,18,20,35,74,0.47297297297297297,0
33,85,0.388,10,28,0.357,7,12,0.583,9,26,35,20,12,4,16,14,23,57,0.40350877192982454,0
38,88,0.432,15,34,0.441,12,13,0.923,18,36,54,22,9,7,21,15,23,54,0.42592592592592593,1
36,86,0.419,13,39,0.333,16,22,0.727,8,39,47,30,4,4,17,24,23,47,0.48936170212765956,0
46,95,0.484,11,32,0.344,15,23,0.652,14,41,55,34,7,5,10,21,35,63,0.5555555555555556,1
41,84,0.488,15,29,0.517,29,34,0.853,12,44,56,19,3,9,20,29,26,55,0.4727272727272727,1
36,90,0.4,13,37,0.351,29,38,0.763,8,29,37,20,13,4,10,26,23,53,0.4339622641509434,0
33,86,0.384,11,34,0.324,19,27,0.704,9,32,41,17,6,3,15,18,22,52,0.4230769230769231,0
52,93,0.559,14,36,0.389,12,16,0.75,8,43,51,31,11,5,13,22,38,57,0.6666666666666666,1
42,91,0.462,11,34,0.324,21,27,0.778,10,32,42,24,8,4,14,31,31,57,0.543859649122807,0
41,79,0.519,8,25,0.32,33,45,0.733,10,32,42,22,9,2,16,27,33,54,0.6111111111111112,1
44,96,0.458,20,40,0.5,8,11,0.727,11,33,44,23,9,3,11,13,24,56,0.42857142857142855,1
43,86,0.5,15,35,0.429,12,13,0.923,7,38,45,29,6,7,13,16,28,51,0.5490196078431373,0
38,87,0.437,9,31,0.29,9,11,0.818,9,43,52,24,7,8,17,14,29,56,0.5178571428571429,1
36,87,0.414,10,26,0.385,10,13,0.769,5,33,38,24,14,4,13,14,26,61,0.4262295081967213,0
40,91,0.44,16,41,0.39,15,18,0.833,11,41,52,27,5,5,15,19,24,50,0.48,1
39,94,0.415,19,51,0.373,11,17,0.647,10,36,46,23,8,3,11,16,20,43,0.46511627906976744,0
32,85,0.376,11,36,0.306,27,33,0.818,8,41,49,22,11,7,10,14,21,49,0.42857142857142855,1
36,96,0.375,7,40,0.175,15,18,0.833,12,45,57,25,6,1,13,25,29,56,0.5178571428571429,0
36,81,0.444,11,34,0.324,25,25,1.0,12,36,48,19,6,3,20,26,25,47,0.5319148936170213,1
39,86,0.453,8,30,0.267,15,19,0.789,8,27,35,25,10,2,13,21,31,56,0.5535714285714286,0
39,81,0.481,8,30,0.267,21,26,0.808,5,34,39,19,7,12,16,22,31,51,0.6078431372549019,0
42,89,0.472,9,23,0.391,21,26,0.808,7,31,38,21,10,9,14,21,33,66,0.5,1
42,99,0.424,12,35,0.343,11,12,0.917,16,37,53,22,7,5,7,23,30,64,0.46875,1
35,81,0.432,13,36,0.361,22,26,0.846,6,36,42,26,2,7,9,15,22,45,0.4888888888888889,0
38,97,0.392,13,41,0.317,26,30,0.867,15,32,47,20,6,3,9,20,25,56,0.44642857142857145,0
49,90,0.544,19,43,0.442,13,21,0.619,9,38,47,35,5,4,14,22,30,47,0.6382978723404256,1
40,87,0.46,19,46,0.413,12,16,0.75,4,34,38,28,10,5,14,18,21,41,0.5121951219512195,1
44,89,0.494,4,22,0.182,18,23,0.783,9,43,52,25,11,0,15,18,40,67,0.5970149253731343,0
40,91,0.44,14,44,0.318,6,11,0.545,10,32,42,20,5,9,15,15,26,47,0.5531914893617021,0
45,87,0.517,8,22,0.364,14,19,0.737,11,37,48,22,10,5,13,17,37,65,0.5692307692307692,1
36,85,0.424,4,26,0.154,18,26,0.692,13,32,45,24,9,4,10,19,32,59,0.5423728813559322,0
40,81,0.494,12,29,0.414,13,18,0.722,8,35,43,20,4,4,16,22,28,52,0.5384615384615384,1
47,94,0.5,16,37,0.432,26,35,0.743,9,26,35,27,9,2,13,27,31,57,0.543859649122807,0
50,81,0.617,18,29,0.621,23,33,0.697,1,34,35,33,9,6,18,21,32,52,0.6153846153846154,1
39,79,0.494,14,35,0.4,23,32,0.719,10,32,42,18,6,5,12,19,25,44,0.5681818181818182,0
40,83,0.482,21,40,0.525,22,24,0.917,8,33,41,30,4,3,12,23,19,43,0.4418604651162791,1
49,93,0.527,14,40,0.35,12,15,0.8,10,33,43,27,3,2,16,21,35,53,0.660377358490566,0
47,91,0.516,14,37,0.378,20,27,0.741,12,27,39,30,8,3,7,16,33,54,0.6111111111111112,1
41,87,0.471,9,26,0.346,18,20,0.9,4,43,47,23,6,6,20,25,32,61,0.5245901639344263,0
44,97,0.454,15,37,0.405,19,29,0.655,11,37,48,30,11,7,13,17,29,60,0.48333333333333334,1
42,87,0.483,16,40,0.4,24,31,0.774,7,37,44,27,12,7,13,21,26,47,0.5531914893617021,1
43,97,0.443,15,44,0.341,16,21,0.762,9,38,47,25,8,1,14,27,28,53,0.5283018867924528,0
43,92,0.467,16,35,0.457,16,17,0.941,6,34,40,28,4,3,8,15,27,57,0.47368421052631576,1
43,86,0.5,10,30,0.333,13,21,0.619,9,39,48,21,2,4,13,20,33,56,0.5892857142857143,0
36,79,0.456,13,30,0.433,9,16,0.563,7,30,37,24,11,3,16,14,23,49,0.46938775510204084,1
36,83,0.434,11,31,0.355,7,8,0.875,11,37,48,27,13,6,18,17,25,52,0.4807692307692308,0
39,93,0.419,14,41,0.341,25,33,0.758,15,33,48,24,11,4,16,19,25,52,0.4807692307692308,0
49,90,0.544,18,41,0.439,19,23,0.826,6,38,44,25,10,6,15,23,31,49,0.6326530612244898,1
41,88,0.466,11,29,0.379,14,16,0.875,7,31,38,22,9,4,17,24,30,59,0.5084745762711864,0
41,86,0.477,12,32,0.375,22,30,0.733,11,38,49,21,11,4,21,22,29,54,0.5370370370370371,1
41,91,0.451,17,52,0.327,6,13,0.462,9,41,50,24,10,7,21,25,24,39,0.6153846153846154,0
37,90,0.411,11,34,0.324,25,29,0.862,9,37,46,23,13,4,17,14,26,56,0.4642857142857143,1
40,83,0.482,14,31,0.452,11,13,0.846,10,27,37,23,6,5,19,16,26,52,0.5,0
40,82,0.488,20,41,0.488,15,18,0.833,9,29,38,25,13,3,16,19,20,41,0.4878048780487805,1
34,89,0.382,8,29,0.276,14,16,0.875,9,33,42,17,5,2,13,13,26,60,0.43333333333333335,0
51,91,0.56,22,47,0.468,8,11,0.727,7,42,49,34,6,8,8,18,29,44,0.6590909090909091,1
46,91,0.505,10,26,0.385,13,14,0.929,9,32,41,26,10,3,13,23,36,65,0.5538461538461539,0
41,81,0.506,12,29,0.414,23,27,0.852,10,32,42,21,3,8,15,15,29,52,0.5576923076923077,1
38,81,0.469,14,31,0.452,20,21,0.952,4,38,42,26,6,4,21,13,24,50,0.48,0
45,98,0.459,13,32,0.406,12,14,0.857,12,34,46,29,14,6,14,18,32,66,0.48484848484848486,1
49,97,0.505,25,53,0.472,8,13,0.615,10,40,50,31,6,8,10,18,24,44,0.5454545454545454,1
44,98,0.449,13,42,0.31,17,21,0.81,9,36,45,18,5,5,12,19,31,56,0.5535714285714286,0
41,87,0.471,16,42,0.381,20,25,0.8,16,29,45,33,10,4,15,20,25,45,0.5555555555555556,1
38,77,0.494,15,38,0.395,19,26,0.731,10,26,36,29,6,4,19,17,23,39,0.5897435897435898,0
38,87,0.437,11,34,0.324,14,21,0.667,11,51,62,16,2,7,11,19,27,53,0.5094339622641509,1
34,96,0.354,9,27,0.333,12,20,0.6,11,38,49,19,8,7,5,19,25,69,0.36231884057971014,0
53,91,0.582,20,39,0.513,18,22,0.818,12,32,44,30,8,5,13,20,33,52,0.6346153846153846,1
46,81,0.568,15,34,0.441,16,28,0.571,3,23,26,36,9,8,12,18,31,47,0.6595744680851063,0
34,89,0.382,14,45,0.311,23,28,0.821,17,30,47,25,10,4,14,22,20,44,0.45454545454545453,0
40,77,0.519,15,33,0.455,18,24,0.75,6,35,41,27,11,7,15,19,25,44,0.5681818181818182,1
38,89,0.427,6,31,0.194,16,22,0.727,10,33,43,17,11,2,10,16,32,58,0.5517241379310345,0
39,79,0.494,20,40,0.5,14,18,0.778,6,38,44,25,5,8,18,17,19,39,0.48717948717948717,1
46,94,0.489,16,41,0.39,17,17,1.0,4,36,40,33,6,2,3,17,30,53,0.5660377358490566,1
44,92,0.478,12,29,0.414,17,24,0.708,13,39,52,23,2,4,10,19,32,63,0.5079365079365079,0
36,87,0.414,7,26,0.269,11,16,0.688,14,33,47,16,6,4,18,18,29,61,0.47540983606557374,0
37,84,0.44,12,36,0.333,14,18,0.778,11,34,45,25,11,4,16,14,25,48,0.5208333333333334,1
44,101,0.436,13,32,0.406,24,29,0.828,12,36,48,22,8,3,6,19,31,69,0.4492753623188406,1
48,96,0.5,15,30,0.5,11,17,0.647,11,42,53,29,1,7,17,20,33,66,0.5,0
45,90,0.5,12,33,0.364,13,15,0.867,15,30,45,28,11,7,17,12,33,57,0.5789473684210527,1
43,103,0.417,11,35,0.314,6,10,0.6,20,28,48,23,8,4,17,19,32,68,0.47058823529411764,0
44,100,0.44,17,41,0.415,20,23,0.87,9,41,50,26,10,5,8,27,27,59,0.4576271186440678,1
33,81,0.407,8,30,0.267,25,35,0.714,6,41,47,21,4,5,15,20,25,51,0.49019607843137253,0
46,93,0.495,16,43,0.372,20,26,0.769,10,51,61,32,3,5,16,24,30,50,0.6,1
44,99,0.444,15,40,0.375,21,28,0.75,7,32,39,25,9,2,6,24,29,59,0.4915254237288136,0
49,90,0.544,15,39,0.385,16,17,0.941,3,31,34,24,12,4,11,22,34,51,0.6666666666666666,1
43,85,0.506,10,34,0.294,20,24,0.833,6,37,43,23,3,2,17,18,33,51,0.6470588235294118,0
35,82,0.427,11,35,0.314,15,22,0.682,16,47,63,17,3,5,16,17,24,47,0.5106382978723404,1
29,87,0.333,10,42,0.238,18,21,0.857,11,28,39,21,10,7,8,23,19,45,0.4222222222222222,0
39,96,0.406,13,38,0.342,14,22,0.636,13,35,48,20,8,10,12,22,26,58,0.4482758620689655,0
38,93,0.409,13,46,0.283,17,19,0.895,12,39,51,30,2,10,15,18,25,47,0.5319148936170213,1
46,91,0.505,10,29,0.345,18,24,0.75,10,39,49,28,13,8,17,23,36,62,0.5806451612903226,1
37,90,0.411,12,41,0.293,16,23,0.696,13,30,43,22,7,8,21,22,25,49,0.5102040816326531,0
47,77,0.61,18,33,0.545,15,17,0.882,3,35,38,30,6,2,23,19,29,44,0.6590909090909091,0
45,92,0.489,20,38,0.526,20,25,0.8,12,23,35,28,13,5,10,19,25,54,0.46296296296296297,1
36,94,0.383,8,30,0.267,8,14,0.571,9,36,45,21,4,5,10,16,28,64,0.4375,0
34,81,0.42,9,26,0.346,19,23,0.826,9,43,52,19,6,3,14,17,25,55,0.45454545454545453,1
45,84,0.536,15,35,0.429,9,12,0.75,8,35,43,23,11,4,12,25,30,49,0.6122448979591837,1
32,74,0.432,6,21,0.286,19,25,0.76,8,28,36,19,4,1,16,15,26,53,0.49056603773584906,0
37,92,0.402,8,36,0.222,12,13,0.923,9,41,50,20,2,12,9,17,29,56,0.5178571428571429,0
37,99,0.374,17,44,0.386,21,27,0.778,14,44,58,20,7,3,8,13,20,55,0.36363636363636365,1
34,87,0.391,9,37,0.243,11,17,0.647,17,32,49,20,6,6,17,23,25,50,0.5,0
38,78,0.487,13,32,0.406,20,23,0.87,5,32,37,28,8,8,10,13,25,46,0.5434782608695652,1
40,78,0.513,5,20,0.25,16,21,0.762,7,33,40,32,10,6,15,17,35,58,0.603448275862069,1
37,82,0.451,11,26,0.423,6,14,0.429,10,30,40,20,11,7,21,21,26,56,0.4642857142857143,0
46,91,0.505,13,35,0.371,16,20,0.8,11,32,43,25,15,7,15,17,33,56,0.5892857142857143,1
39,91,0.429,11,31,0.355,10,13,0.769,15,29,44,24,5,4,19,13,28,60,0.4666666666666667,0
40,89,0.449,19,47,0.404,12,12,1.0,7,36,43,27,6,5,15,22,21,42,0.5,0
38,83,0.458,14,42,0.333,22,25,0.88,8,34,42,18,9,6,13,14,24,41,0.5853658536585366,1
47,97,0.485,13,39,0.333,15,18,0.833,10,27,37,26,14,3,13,21,34,58,0.5862068965517241,0
47,84,0.56,15,32,0.469,18,23,0.783,7,37,44,29,6,9,19,17,32,52,0.6153846153846154,1
39,87,0.448,4,27,0.148,25,30,0.833,8,34,42,21,3,6,6,22,35,60,0.5833333333333334,0
48,92,0.522,15,34,0.441,17,28,0.607,14,39,53,29,3,3,8,23,33,58,0.5689655172413793,1
44,88,0.5,18,37,0.486,10,16,0.625,9,23,32,28,12,5,13,18,26,51,0.5098039215686274,0
48,79,0.608,16,32,0.5,10,15,0.667,8,33,41,31,6,6,19,18,32,47,0.6808510638297872,1
42,84,0.5,24,45,0.533,9,12,0.75,10,38,48,26,8,8,18,16,18,39,0.46153846153846156,1
35,90,0.389,8,31,0.258,9,14,0.643,12,28,40,23,7,4,14,13,27,59,0.4576271186440678,0
39,88,0.443,9,28,0.321,17,25,0.68,10,40,50,26,9,9,15,17,30,60,0.5,1
34,89,0.382,13,38,0.342,14,22,0.636,10,36,46,25,8,8,16,21,21,51,0.4117647058823529,0
42,84,0.5,14,32,0.438,19,27,0.704,11,44,55,26,10,12,21,18,28,52,0.5384615384615384,1
38,97,0.392,12,40,0.3,12,16,0.75,10,32,42,23,14,5,15,19,26,57,0.45614035087719296,0
41,95,0.432,10,35,0.286,20,22,0.909,7,39,46,26,8,5,4,20,31,60,0.5166666666666667,1
36,83,0.434,7,26,0.269,23,29,0.793,7,45,52,18,1,5,13,20,29,57,0.5087719298245614,0
48,104,0.462,19,56,0.339,19,24,0.792,14,32,46,27,6,4,18,21,29,48,0.6041666666666666,0
50,102,0.49,19,55,0.345,18,25,0.72,16,36,52,32,10,6,19,21,31,47,0.6595744680851063,1
40,96,0.417,15,46,0.326,9,16,0.563,13,41,54,22,8,12,10,15,25,50,0.5,1
38,100,0.38,10,38,0.263,7,14,0.5,15,38,53,26,8,7,14,17,28,62,0.45161290322580644,0
41,85,0.482,19,43,0.442,9,14,0.643,10,38,48,31,10,9,14,20,22,42,0.5238095238095238,1
36,92,0.391,14,35,0.4,15,22,0.682,13,34,47,25,8,3,16,19,22,57,0.38596491228070173,0
42,88,0.477,10,28,0.357,12,16,0.75,12,36,48,18,4,4,11,19,32,60,0.5333333333333333,0
35,74,0.473,18,37,0.486,23,27,0.852,3,33,36,26,4,6,10,16,17,37,0.4594594594594595,1
50,106,0.472,8,25,0.32,10,13,0.769,15,32,47,33,11,5,7,24,42,81,0.5185185185185185,1
39,90,0.433,9,37,0.243,20,24,0.833,11,37,48,27,3,6,13,18,30,53,0.5660377358490566,0
44,91,0.484,16,40,0.4,12,17,0.706,12,34,46,29,3,5,6,12,28,51,0.5490196078431373,1
44,92,0.478,11,28,0.393,10,12,0.833,12,31,43,22,4,3,9,16,33,64,0.515625,0
47,95,0.495,17,37,0.459,17,22,0.773,12,38,50,26,6,6,10,16,30,58,0.5172413793103449,1
37,86,0.43,10,31,0.323,15,19,0.789,9,33,42,23,4,6,12,21,27,55,0.4909090909090909,0
44,90,0.489,23,48,0.479,21,27,0.778,12,26,38,28,9,8,8,24,21,42,0.5,1
44,84,0.524,19,38,0.5,19,26,0.731,8,34,42,35,4,2,13,18,25,46,0.5434782608695652,0
38,81,0.469,11,29,0.379,17,24,0.708,5,38,43,29,9,4,19,25,27,52,0.5192307692307693,0
41,90,0.456,11,37,0.297,21,27,0.778,10,40,50,29,11,5,14,23,30,53,0.5660377358490566,1
40,81,0.494,12,34,0.353,16,26,0.615,9,32,41,28,4,1,20,19,28,47,0.5957446808510638,0
44,82,0.537,17,37,0.459,20,24,0.833,5,30,35,27,15,3,18,22,27,45,0.6,1
44,92,0.478,9,30,0.3,14,18,0.778,13,37,50,29,11,5,14,13,35,62,0.5645161290322581,1
32,87,0.368,13,43,0.302,10,10,1.0,14,29,43,16,8,5,18,22,19,44,0.4318181818181818,0
42,86,0.488,13,33,0.394,12,19,0.632,10,39,49,25,6,6,18,16,29,53,0.5471698113207547,1
42,92,0.457,9,31,0.29,12,16,0.75,10,31,41,26,10,4,10,17,33,61,0.5409836065573771,0
42,87,0.483,15,35,0.429,9,12,0.75,14,30,44,32,11,5,20,15,27,52,0.5192307692307693,0
40,88,0.455,20,50,0.4,11,13,0.846,13,27,40,33,13,6,18,16,20,38,0.5263157894736842,1
38,94,0.404,7,28,0.25,14,22,0.636,15,31,46,14,5,1,13,16,31,66,0.4696969696969697,0
45,88,0.511,17,42,0.405,17,19,0.895,6,39,45,25,7,4,11,18,28,46,0.6086956521739131,1
40,82,0.488,9,25,0.36,14,16,0.875,7,32,39,20,9,10,13,21,31,57,0.543859649122807,0
36,79,0.456,9,27,0.333,25,34,0.735,14,34,48,26,9,6,16,18,27,52,0.5192307692307693,1
41,86,0.477,9,29,0.31,4,8,0.5,10,37,47,22,3,5,20,21,32,57,0.5614035087719298,0
39,93,0.419,15,37,0.405,19,26,0.731,13,31,44,31,11,6,8,16,24,56,0.42857142857142855,1
45,97,0.464,13,36,0.361,6,13,0.462,11,40,51,22,5,6,9,23,32,61,0.5245901639344263,0
43,96,0.448,14,37,0.378,12,25,0.48,16,41,57,22,5,3,11,14,29,59,0.4915254237288136,1
43,91,0.473,21,46,0.457,18,25,0.72,9,47,56,27,5,8,24,25,22,45,0.4888888888888889,0
48,105,0.457,15,45,0.333,16,24,0.667,7,37,44,26,12,2,13,23,33,60,0.55,1
52,89,0.584,18,35,0.514,16,20,0.8,12,35,47,29,10,3,11,19,34,54,0.6296296296296297,1
40,85,0.471,8,26,0.308,12,17,0.706,9,23,32,23,4,2,14,16,32,59,0.5423728813559322,0
38,92,0.413,5,28,0.179,11,15,0.733,8,33,41,21,6,1,15,16,33,64,0.515625,0
43,92,0.467,20,44,0.455,10,14,0.714,12,41,53,27,7,6,19,18,23,48,0.4791666666666667,1
44,95,0.463,14,46,0.304,13,16,0.813,9,29,38,28,13,4,12,19,30,49,0.6122448979591837,0
42,78,0.538,16,35,0.457,22,25,0.88,4,37,41,24,9,5,19,14,26,43,0.6046511627906976,1
37,84,0.44,7,25,0.28,23,32,0.719,15,38,53,23,5,11,23,17,30,59,0.5084745762711864,0
43,99,0.434,8,29,0.276,12,18,0.667,11,32,43,27,15,3,11,25,35,70,0.5,1
46,91,0.505,18,46,0.391,10,15,0.667,10,29,39,34,9,8,13,28,28,45,0.6222222222222222,1
32,67,0.478,12,29,0.414,24,27,0.889,5,26,31,25,1,5,23,21,20,38,0.5263157894736842,0
38,87,0.437,6,30,0.2,24,28,0.857,7,41,48,24,4,6,13,22,32,57,0.5614035087719298,0
40,103,0.388,15,44,0.341,17,20,0.85,17,38,55,18,6,8,8,20,25,59,0.423728813559322,1
31,84,0.369,12,32,0.375,17,27,0.63,12,39,51,20,6,9,23,20,19,52,0.36538461538461536,0
40,100,0.4,5,24,0.208,18,23,0.783,17,41,58,19,10,7,12,21,35,76,0.4605263157894737,1
38,87,0.437,15,36,0.417,22,29,0.759,12,36,48,26,6,5,15,20,23,51,0.45098039215686275,0
36,86,0.419,21,49,0.429,23,26,0.885,7,36,43,28,5,8,15,22,15,37,0.40540540540540543,1
38,80,0.475,12,31,0.387,17,21,0.81,10,43,53,22,11,7,17,28,26,49,0.5306122448979592,1
25,84,0.298,7,46,0.152,18,29,0.621,14,29,43,15,10,2,18,22,18,38,0.47368421052631576,0
43,85,0.506,7,25,0.28,24,33,0.727,5,42,47,32,14,6,14,23,36,60,0.6,1
41,93,0.441,8,31,0.258,11,19,0.579,12,35,47,18,6,2,17,23,33,62,0.532258064516129,0
39,76,0.513,15,37,0.405,16,28,0.571,7,29,36,24,7,6,13,21,24,39,0.6153846153846154,1
40,100,0.4,14,37,0.378,11,15,0.733,23,29,52,25,6,6,10,23,26,63,0.4126984126984127,0
37,89,0.416,11,38,0.289,11,16,0.688,6,27,33,28,13,2,16,19,26,51,0.5098039215686274,0
48,87,0.552,19,39,0.487,14,20,0.7,9,43,52,27,4,3,18,19,29,48,0.6041666666666666,1
45,85,0.529,11,22,0.5,27,34,0.794,14,34,48,24,5,1,14,15,34,63,0.5396825396825397,1
47,91,0.516,13,39,0.333,16,18,0.889,8,25,33,23,7,7,11,24,34,52,0.6538461538461539,0
36,91,0.396,14,37,0.378,11,16,0.688,9,30,39,22,16,6,18,21,22,54,0.4074074074074074,0
37,79,0.468,11,28,0.393,23,25,0.92,7,41,48,32,15,8,26,17,26,51,0.5098039215686274,1
46,105,0.438,11,38,0.289,20,24,0.833,11,30,41,21,9,2,6,15,35,67,0.5223880597014925,0
46,84,0.548,15,31,0.484,18,21,0.857,7,42,49,26,2,5,17,19,31,53,0.5849056603773585,1
46,88,0.523,17,40,0.425,11,17,0.647,2,34,36,25,8,1,17,20,29,48,0.6041666666666666,0
43,92,0.467,20,45,0.444,19,21,0.905,10,37,47,23,10,3,19,19,23,47,0.48936170212765956,1
44,87,0.506,12,37,0.324,15,20,0.75,5,27,32,31,8,3,13,27,32,50,0.64,1
40,83,0.482,9,29,0.31,24,33,0.727,12,38,50,23,6,5,19,22,31,54,0.5740740740740741,0
40,88,0.455,15,36,0.417,9,16,0.563,12,32,44,30,8,4,18,20,25,52,0.4807692307692308,0
41,83,0.494,11,26,0.423,15,20,0.75,9,31,40,31,13,3,15,15,30,57,0.5263157894736842,1
38,82,0.463,13,37,0.351,18,24,0.75,10,22,32,24,8,3,18,23,25,45,0.5555555555555556,0
43,75,0.573,12,30,0.4,15,19,0.789,5,31,36,23,8,6,18,27,31,45,0.6888888888888889,1
29,86,0.337,12,38,0.316,14,16,0.875,10,41,51,18,4,9,12,24,17,48,0.3541666666666667,0
31,87,0.356,5,27,0.185,24,34,0.706,13,40,53,15,6,4,8,16,26,60,0.43333333333333335,1
48,90,0.533,15,33,0.455,14,16,0.875,12,36,48,33,6,6,13,17,33,57,0.5789473684210527,1
39,90,0.433,10,35,0.286,16,19,0.842,8,26,34,20,9,6,13,15,29,55,0.5272727272727272,0
31,82,0.378,9,36,0.25,22,27,0.815,8,30,38,21,6,4,17,16,22,46,0.4782608695652174,0
44,88,0.5,12,33,0.364,16,18,0.889,9,37,46,23,9,6,15,23,32,55,0.5818181818181818,1
36,86,0.419,14,43,0.326,15,23,0.652,9,32,41,22,8,4,19,15,22,43,0.5116279069767442,0
46,105,0.438,14,42,0.333,13,14,0.929,18,40,58,29,11,3,15,22,32,63,0.5079365079365079,1
43,95,0.453,6,26,0.231,10,15,0.667,10,28,38,17,8,3,8,15,37,69,0.5362318840579711,0
43,85,0.506,21,47,0.447,11,17,0.647,11,43,54,28,4,7,16,17,22,38,0.5789473684210527,1
44,97,0.454,10,31,0.323,17,19,0.895,7,35,42,22,9,3,13,28,34,66,0.5151515151515151,0
44,100,0.44,9,23,0.391,26,38,0.684,23,40,63,21,6,10,14,15,35,77,0.45454545454545453,1
48,106,0.453,15,41,0.366,24,27,0.889,13,39,52,30,8,11,16,24,33,65,0.5076923076923077,0
56,109,0.514,20,40,0.5,15,21,0.714,12,38,50,29,10,6,15,21,36,69,0.5217391304347826,1
35,94,0.372,4,33,0.121,25,31,0.806,12,31,43,17,7,2,10,15,31,61,0.5081967213114754,0
46,91,0.505,15,38,0.395,14,20,0.7,10,44,54,31,6,2,15,22,31,53,0.5849056603773585,1
42,89,0.472,8,34,0.235,17,19,0.895,8,37,45,25,6,11,17,21,34,55,0.6181818181818182,1
37,88,0.42,10,31,0.323,19,22,0.864,7,32,39,17,11,5,16,19,27,57,0.47368421052631576,0
51,97,0.526,8,27,0.296,14,17,0.824,9,40,49,32,5,6,8,17,43,70,0.6142857142857143,1
41,92,0.446,16,39,0.41,14,21,0.667,8,30,38,21,6,3,10,20,25,53,0.4716981132075472,0
39,86,0.453,13,28,0.464,5,12,0.417,4,35,39,25,11,4,18,15,26,58,0.4482758620689655,0
41,86,0.477,16,35,0.457,17,18,0.944,6,42,48,24,14,6,17,15,25,51,0.49019607843137253,1
36,92,0.391,10,31,0.323,15,21,0.714,13,35,48,26,5,8,12,17,26,61,0.4262295081967213,1
36,85,0.424,15,35,0.429,9,14,0.643,8,35,43,25,5,12,16,20,21,50,0.42,0
42,89,0.472,12,33,0.364,13,20,0.65,10,35,45,22,3,0,16,29,30,56,0.5357142857142857,0
36,78,0.462,9,27,0.333,36,45,0.8,11,30,41,20,12,3,9,20,27,51,0.5294117647058824,1
39,80,0.488,18,40,0.45,15,17,0.882,8,38,46,29,4,5,19,19,21,40,0.525,1
35,88,0.398,16,49,0.327,16,18,0.889,12,29,41,27,8,3,13,21,19,39,0.48717948717948717,0
38,82,0.463,11,24,0.458,32,41,0.78,11,44,55,24,5,9,11,29,27,58,0.46551724137931033,1
33,86,0.384,9,38,0.237,29,39,0.744,9,37,46,27,5,3,10,26,24,48,0.5,0
41,88,0.466,19,37,0.514,12,15,0.8,6,32,38,25,8,8,10,14,22,51,0.43137254901960786,1
44,87,0.506,9,28,0.321,9,12,0.75,5,41,46,27,5,5,15,18,35,59,0.5932203389830508,0
42,85,0.494,11,25,0.44,23,30,0.767,10,31,41,27,9,2,18,19,31,60,0.5166666666666667,0
44,88,0.5,17,39,0.436,24,25,0.96,8,31,39,27,8,8,15,27,27,49,0.5510204081632653,1
49,96,0.51,15,43,0.349,10,12,0.833,15,28,43,33,11,4,16,21,34,53,0.6415094339622641,1
42,85,0.494,7,32,0.219,19,25,0.76,12,34,46,22,8,1,21,12,35,53,0.660377358490566,0
42,87,0.483,14,43,0.326,15,17,0.882,6,23,29,23,5,8,11,25,28,44,0.6363636363636364,0
45,87,0.517,8,25,0.32,27,32,0.844,13,37,50,24,7,3,15,18,37,62,0.5967741935483871,1
37,95,0.389,14,41,0.341,15,20,0.75,14,37,51,24,7,11,14,28,23,54,0.42592592592592593,1
31,82,0.378,15,32,0.469,25,37,0.676,14,41,55,17,5,8,19,21,16,50,0.32,0
43,94,0.457,17,37,0.459,15,24,0.625,13,36,49,29,7,3,14,14,26,57,0.45614035087719296,0
46,93,0.495,12,34,0.353,16,18,0.889,8,36,44,28,9,5,10,19,34,59,0.576271186440678,1
41,87,0.471,14,42,0.333,10,13,0.769,4,25,29,24,8,1,11,21,27,45,0.6,0
43,84,0.512,10,33,0.303,24,25,0.96,9,39,48,21,8,7,13,19,33,51,0.6470588235294118,1
38,83,0.458,15,35,0.429,25,30,0.833,13,42,55,21,9,12,17,16,23,48,0.4791666666666667,1
40,93,0.43,8,32,0.25,10,12,0.833,10,30,40,30,14,8,13,21,32,61,0.5245901639344263,0
41,90,0.456,12,30,0.4,16,20,0.8,10,22,32,23,10,5,13,21,29,60,0.48333333333333334,0
45,81,0.556,12,28,0.429,20,24,0.833,10,35,45,23,9,7,20,23,33,53,0.6226415094339622,1
53,103,0.515,6,26,0.231,18,19,0.947,10,33,43,32,12,1,9,15,47,77,0.6103896103896104,1
47,94,0.5,17,44,0.386,15,15,1.0,9,36,45,30,7,4,16,23,30,50,0.6,0
36,94,0.383,5,22,0.227,17,25,0.68,16,41,57,19,2,6,12,21,31,72,0.4305555555555556,0
38,91,0.418,12,34,0.353,15,21,0.714,12,43,55,21,6,14,6,25,26,57,0.45614035087719296,1
45,93,0.484,14,39,0.359,18,20,0.9,7,35,42,23,3,2,6,21,31,54,0.5740740740740741,1
41,89,0.461,12,28,0.429,23,30,0.767,9,40,49,21,3,5,7,18,29,61,0.47540983606557374,0
33,77,0.429,7,31,0.226,8,10,0.8,4,28,32,19,13,4,19,14,26,46,0.5652173913043478,0
39,84,0.464,17,40,0.425,6,9,0.667,12,33,45,22,11,3,22,16,22,44,0.5,1
42,89,0.472,13,46,0.283,27,32,0.844,2,29,31,29,7,1,8,23,29,43,0.6744186046511628,0
44,83,0.53,19,37,0.514,21,26,0.808,9,38,47,34,0,6,17,26,25,46,0.5434782608695652,1
36,79,0.456,4,19,0.211,25,31,0.806,5,37,42,20,7,4,19,18,32,60,0.5333333333333333,1
33,84,0.393,8,25,0.32,16,22,0.727,10,35,45,18,8,1,19,28,25,59,0.423728813559322,0
47,86,0.547,16,37,0.432,23,29,0.793,13,39,52,28,5,5,14,28,31,49,0.6326530612244898,1
37,83,0.446,5,25,0.2,29,40,0.725,10,26,36,15,7,4,10,23,32,58,0.5517241379310345,0
38,83,0.458,8,23,0.348,30,38,0.789,12,37,49,14,10,7,15,24,30,60,0.5,1
37,86,0.43,14,33,0.424,22,30,0.733,8,35,43,25,9,8,16,28,23,53,0.4339622641509434,0
40,87,0.46,10,33,0.303,20,28,0.714,10,32,42,21,5,4,21,24,30,54,0.5555555555555556,0
39,91,0.429,12,34,0.353,30,37,0.811,14,36,50,23,14,4,13,22,27,57,0.47368421052631576,1
40,97,0.412,15,36,0.417,25,32,0.781,12,53,65,22,4,3,18,20,25,61,0.4098360655737705,1
41,102,0.402,16,53,0.302,14,18,0.778,7,43,50,26,8,4,10,31,25,49,0.5102040816326531,0
42,93,0.452,14,39,0.359,10,15,0.667,4,31,35,30,6,8,11,21,28,54,0.5185185185185185,0
45,94,0.479,20,50,0.4,17,22,0.773,14,43,57,28,6,4,16,20,25,44,0.5681818181818182,1
34,85,0.4,10,33,0.303,25,34,0.735,11,23,34,24,10,8,17,23,24,52,0.46153846153846156,0
52,93,0.559,14,28,0.5,23,27,0.852,13,42,55,26,14,8,16,23,38,65,0.5846153846153846,1
37,90,0.411,15,35,0.429,18,26,0.692,12,33,45,24,12,8,17,18,22,55,0.4,1
35,87,0.402,13,39,0.333,19,22,0.864,12,35,47,23,10,8,19,23,22,48,0.4583333333333333,0
42,95,0.442,7,35,0.2,9,14,0.643,12,39,51,22,7,2,13,19,35,60,0.5833333333333334,0
41,92,0.446,14,46,0.304,12,16,0.75,8,38,46,26,4,2,10,10,27,46,0.5869565217391305,1
42,83,0.506,14,39,0.359,17,22,0.773,5,22,27,27,8,4,9,23,28,44,0.6363636363636364,0
50,91,0.549,10,31,0.323,19,27,0.704,16,36,52,32,4,2,17,16,40,60,0.6666666666666666,1
42,88,0.477,14,36,0.389,9,16,0.563,9,34,43,28,10,5,12,17,28,52,0.5384615384615384,1
39,87,0.448,17,38,0.447,9,13,0.692,11,32,43,27,4,4,16,18,22,49,0.4489795918367347,0
39,86,0.453,12,29,0.414,23,25,0.92,13,34,47,20,9,0,12,20,27,57,0.47368421052631576,0
39,83,0.47,17,46,0.37,21,23,0.913,9,30,39,19,5,8,11,16,22,37,0.5945945945945946,1
39,92,0.424,14,42,0.333,9,14,0.643,12,38,50,23,5,5,14,14,25,50,0.5,0
48,96,0.5,15,31,0.484,10,11,0.909,5,39,44,27,11,5,9,14,33,65,0.5076923076923077,1
31,84,0.369,11,43,0.256,12,17,0.706,8,37,45,20,3,7,14,21,20,41,0.4878048780487805,0
34,85,0.4,11,38,0.289,19,22,0.864,6,43,49,24,6,5,9,18,23,47,0.48936170212765956,1
44,87,0.506,15,29,0.517,16,20,0.8,6,38,44,28,9,6,13,18,29,58,0.5,1
41,88,0.466,17,39,0.436,4,10,0.4,9,32,41,28,4,7,19,16,24,49,0.4897959183673469,0
42,87,0.483,10,32,0.313,21,28,0.75,15,25,40,21,7,7,14,23,32,55,0.5818181818181818,1
40,86,0.465,9,21,0.429,19,22,0.864,15,29,44,19,8,3,17,25,31,65,0.47692307692307695,0
40,79,0.506,15,35,0.429,22,28,0.786,14,35,49,25,9,4,18,20,25,44,0.5681818181818182,1
41,84,0.488,11,32,0.344,20,24,0.833,8,26,34,26,11,4,11,22,30,52,0.5769230769230769,0
40,94,0.426,9,28,0.321,15,20,0.75,13,23,36,15,12,3,9,26,31,66,0.4696969696969697,0
35,70,0.5,17,38,0.447,32,38,0.842,11,36,47,22,6,6,19,20,18,32,0.5625,1
39,94,0.415,8,24,0.333,22,25,0.88,16,31,47,26,8,5,18,28,31,70,0.44285714285714284,0
44,89,0.494,14,30,0.467,28,37,0.757,15,31,46,21,13,10,15,19,30,59,0.5084745762711864,1
38,93,0.409,14,38,0.368,24,27,0.889,13,26,39,24,9,6,12,25,24,55,0.43636363636363634,0
40,78,0.513,12,29,0.414,37,45,0.822,7,38,45,26,5,8,15,25,28,49,0.5714285714285714,1
39,89,0.438,11,38,0.289,19,27,0.704,11,30,41,22,5,6,14,20,28,51,0.5490196078431373,0
42,88,0.477,19,37,0.514,14,22,0.636,10,39,49,31,10,3,16,21,23,51,0.45098039215686275,1
43,84,0.512,18,40,0.45,21,35,0.6,9,34,43,25,5,6,8,19,25,44,0.5681818181818182,1
46,98,0.469,14,41,0.341,16,21,0.762,15,35,50,17,6,3,9,23,32,57,0.5614035087719298,0
36,89,0.404,8,26,0.308,19,22,0.864,13,33,46,23,11,4,12,19,28,63,0.4444444444444444,0
37,80,0.463,10,26,0.385,24,25,0.96,9,37,46,20,7,9,14,17,27,54,0.5,1
33,85,0.388,5,26,0.192,17,23,0.739,12,38,50,19,7,3,21,22,28,59,0.4745762711864407,0
37,88,0.42,12,37,0.324,21,29,0.724,8,36,44,16,13,4,14,17,25,51,0.49019607843137253,1
36,83,0.434,10,27,0.37,12,17,0.706,9,35,44,15,6,4,12,21,26,56,0.4642857142857143,0
37,92,0.402,15,48,0.313,19,22,0.864,17,36,53,24,6,5,6,14,22,44,0.5,1
52,98,0.531,11,32,0.344,17,20,0.85,11,25,36,29,7,10,11,25,41,66,0.6212121212121212,1
45,94,0.479,13,33,0.394,25,28,0.893,12,25,37,29,3,7,11,18,32,61,0.5245901639344263,0
45,88,0.511,16,40,0.4,10,12,0.833,11,36,47,34,1,9,12,19,29,48,0.6041666666666666,1
37,90,0.411,13,38,0.342,19,21,0.905,11,28,39,28,3,3,11,14,24,52,0.46153846153846156,0
37,82,0.451,11,27,0.407,22,29,0.759,13,27,40,29,7,5,22,21,26,55,0.4727272727272727,0
47,87,0.54,11,21,0.524,17,23,0.739,8,29,37,24,14,7,17,22,36,66,0.5454545454545454,1
37,87,0.425,14,36,0.389,23,33,0.697,11,28,39,23,12,7,17,22,23,51,0.45098039215686275,0
45,85,0.529,15,34,0.441,18,23,0.783,11,35,46,32,11,5,21,28,30,51,0.5882352941176471,1
42,92,0.457,14,43,0.326,11,11,1.0,12,37,49,29,14,4,14,12,28,49,0.5714285714285714,1
30,80,0.375,13,45,0.289,9,11,0.818,6,32,38,24,6,3,17,13,17,35,0.4857142857142857,0
37,92,0.402,13,38,0.342,19,21,0.905,11,28,39,29,11,2,11,20,24,54,0.4444444444444444,0
46,89,0.517,17,43,0.395,15,24,0.625,12,38,50,27,7,4,15,17,29,46,0.6304347826086957,1
45,92,0.489,14,33,0.424,17,26,0.654,17,33,50,30,8,3,15,18,31,59,0.5254237288135594,1
40,96,0.417,10,26,0.385,17,18,0.944,17,30,47,25,8,8,14,23,30,70,0.42857142857142855,0
41,86,0.477,8,24,0.333,16,25,0.64,6,31,37,20,5,2,12,20,33,62,0.532258064516129,0
41,85,0.482,9,25,0.36,16,26,0.615,7,31,38,24,10,7,14,24,32,60,0.5333333333333333,1
38,85,0.447,16,40,0.4,10,14,0.714,5,43,48,21,7,8,14,19,22,45,0.4888888888888889,1
36,95,0.379,15,43,0.349,10,12,0.833,9,40,49,19,7,3,15,16,21,52,0.40384615384615385,0
42,98,0.429,10,30,0.333,12,14,0.857,13,26,39,15,10,4,12,14,32,68,0.47058823529411764,0
46,82,0.561,8,28,0.286,10,16,0.625,9,37,46,22,5,4,20,16,38,54,0.7037037037037037,1
40,93,0.43,16,44,0.364,19,26,0.731,14,45,59,30,9,3,15,14,24,49,0.4897959183673469,1
38,94,0.404,22,55,0.4,10,12,0.833,10,36,46,26,8,8,12,20,16,39,0.41025641025641024,0
42,91,0.462,12,35,0.343,8,9,0.889,4,32,36,22,4,7,8,12,30,56,0.5357142857142857,0
42,91,0.462,16,41,0.39,16,21,0.762,11,39,50,20,7,7,10,18,26,50,0.52,1
36,88,0.409,12,28,0.429,8,12,0.667,12,32,44,25,2,3,11,16,24,60,0.4,0
40,87,0.46,14,36,0.389,13,13,1.0,5,33,38,27,4,2,9,18,26,51,0.5098039215686274,1
39,93,0.419,17,41,0.415,6,8,0.75,10,39,49,16,6,7,15,16,22,52,0.4230769230769231,0
38,90,0.422,13,47,0.277,15,18,0.833,10,37,47,19,8,7,14,12,25,43,0.5813953488372093,1
36,87,0.414,17,42,0.405,20,22,0.909,13,42,55,22,11,4,13,20,19,45,0.4222222222222222,1
40,90,0.444,13,33,0.394,12,15,0.8,8,37,45,24,5,1,14,18,27,57,0.47368421052631576,0
38,99,0.384,11,38,0.289,6,8,0.75,12,36,48,21,8,1,13,19,27,61,0.4426229508196721,0
41,88,0.466,11,32,0.344,21,23,0.913,9,48,57,34,7,1,14,14,30,56,0.5357142857142857,1
42,87,0.483,11,35,0.314,10,13,0.769,9,30,39,30,7,4,16,13,31,52,0.5961538461538461,0
43,85,0.506,16,37,0.432,6,9,0.667,9,33,42,35,7,5,17,13,27,48,0.5625,1
39,87,0.448,8,16,0.5,32,38,0.842,12,39,51,20,11,6,10,17,31,71,0.43661971830985913,1
35,82,0.427,10,33,0.303,14,18,0.778,4,34,38,20,3,4,18,29,25,49,0.5102040816326531,0
48,96,0.5,13,35,0.371,17,22,0.773,12,37,49,29,5,5,12,19,35,61,0.5737704918032787,0
45,96,0.469,21,48,0.438,20,28,0.714,12,33,45,32,7,3,9,16,24,48,0.5,1
29,84,0.345,8,26,0.308,15,18,0.833,14,29,43,15,8,5,14,20,21,58,0.3620689655172414,0
39,80,0.488,10,27,0.37,14,16,0.875,8,33,41,20,8,6,14,24,29,53,0.5471698113207547,1
57,100,0.57,19,45,0.422,14,16,0.875,10,40,50,33,7,4,11,25,38,55,0.6909090909090909,1
40,86,0.465,16,38,0.421,29,34,0.853,6,30,36,23,4,4,12,12,24,48,0.5,0
46,94,0.489,13,37,0.351,11,11,1.0,9,40,49,25,8,5,11,15,33,57,0.5789473684210527,1
32,89,0.36,10,33,0.303,16,18,0.889,12,37,49,20,6,2,17,12,22,56,0.39285714285714285,0
41,78,0.526,14,31,0.452,13,20,0.65,7,30,37,25,8,5,16,15,27,47,0.574468085106383,0
44,81,0.543,10,23,0.435,21,26,0.808,9,32,41,29,8,1,13,18,34,58,0.5862068965517241,1
43,78,0.551,16,36,0.444,24,31,0.774,11,27,38,31,7,5,22,25,27,42,0.6428571428571429,1
42,86,0.488,13,32,0.406,27,33,0.818,12,23,35,20,14,2,15,27,29,54,0.5370370370370371,0
37,86,0.43,9,33,0.273,18,27,0.667,8,32,40,20,6,4,11,27,28,53,0.5283018867924528,0
38,87,0.437,20,48,0.417,24,26,0.923,17,39,56,21,8,5,15,25,18,39,0.46153846153846156,1
39,87,0.448,12,37,0.324,26,34,0.765,12,35,47,16,5,4,13,30,27,50,0.54,1
31,85,0.365,7,28,0.25,31,38,0.816,13,34,47,13,6,4,13,27,24,57,0.42105263157894735,0
37,84,0.44,9,31,0.29,13,19,0.684,13,32,45,20,8,4,14,15,28,53,0.5283018867924528,1
40,82,0.488,6,21,0.286,9,14,0.643,9,33,42,24,10,6,15,16,34,61,0.5573770491803278,0
45,88,0.511,17,42,0.405,16,19,0.842,9,26,35,20,11,1,8,17,28,46,0.6086956521739131,1
43,85,0.506,21,45,0.467,15,15,1.0,11,32,43,31,5,2,15,14,22,40,0.55,0
40,82,0.488,18,45,0.4,16,24,0.667,8,38,46,22,6,6,16,17,22,37,0.5945945945945946,0
44,92,0.478,21,44,0.477,17,20,0.85,7,34,41,32,8,5,9,20,23,48,0.4791666666666667,1
37,81,0.457,10,22,0.455,27,31,0.871,9,33,42,22,9,0,13,19,27,59,0.4576271186440678,1
44,83,0.53,9,29,0.31,8,14,0.571,5,32,37,22,5,4,16,26,35,54,0.6481481481481481,0
29,77,0.377,9,36,0.25,24,32,0.75,7,31,38,17,7,4,16,14,20,41,0.4878048780487805,0
47,89,0.528,17,36,0.472,7,10,0.7,8,39,47,34,6,5,14,23,30,53,0.5660377358490566,1
41,85,0.482,17,45,0.378,5,11,0.455,12,29,41,22,12,3,17,21,24,40,0.6,0
36,77,0.468,11,32,0.344,22,26,0.846,9,30,39,25,5,4,16,14,25,45,0.5555555555555556,1
45,92,0.489,20,46,0.435,16,20,0.8,7,38,45,32,8,5,16,24,25,46,0.5434782608695652,1
41,91,0.451,12,41,0.293,18,29,0.621,10,38,48,27,11,7,15,14,29,50,0.58,0
51,91,0.56,17,35,0.486,10,15,0.667,10,35,45,34,7,7,15,23,34,56,0.6071428571428571,1
39,83,0.47,13,29,0.448,21,26,0.808,8,30,38,25,7,5,14,16,26,54,0.48148148148148145,0
32,75,0.427,20,47,0.426,33,39,0.846,10,28,38,28,3,4,15,21,12,28,0.42857142857142855,0
47,87,0.54,18,28,0.643,16,19,0.842,7,32,39,28,8,2,8,27,29,59,0.4915254237288136,1
45,92,0.489,8,26,0.308,21,31,0.677,14,30,44,20,9,8,12,21,37,66,0.5606060606060606,1
41,84,0.488,10,28,0.357,18,22,0.818,9,32,41,21,6,7,18,25,31,56,0.5535714285714286,0
41,84,0.488,4,16,0.25,18,23,0.783,10,45,55,20,3,3,19,14,37,68,0.5441176470588235,0
41,91,0.451,16,40,0.4,11,15,0.733,7,27,34,24,10,11,10,25,25,51,0.49019607843137253,1
44,81,0.543,17,38,0.447,24,28,0.857,7,31,38,26,2,4,7,14,27,43,0.627906976744186,1
41,85,0.482,10,27,0.37,23,28,0.821,10,26,36,21,5,5,8,20,31,58,0.5344827586206896,0
33,82,0.402,13,36,0.361,23,28,0.821,6,36,42,22,8,5,11,18,20,46,0.43478260869565216,0
41,90,0.456,12,39,0.308,21,22,0.955,9,39,48,27,8,5,11,22,29,51,0.5686274509803921,1
50,88,0.568,19,36,0.528,27,33,0.818,7,38,45,33,6,5,17,24,31,52,0.5961538461538461,0
56,108,0.519,12,39,0.308,25,32,0.781,11,28,39,24,10,2,7,22,44,69,0.6376811594202898,1
40,77,0.519,7,23,0.304,20,24,0.833,4,27,31,24,10,7,13,20,33,54,0.6111111111111112,1
37,78,0.474,11,29,0.379,14,17,0.824,6,30,36,27,8,3,19,21,26,49,0.5306122448979592,0
37,87,0.425,6,29,0.207,22,26,0.846,11,34,45,21,6,6,12,19,31,58,0.5344827586206896,0
42,88,0.477,11,34,0.324,15,20,0.75,7,33,40,30,3,1,12,19,31,54,0.5740740740740741,1
40,102,0.392,11,38,0.289,7,11,0.636,15,30,45,20,4,1,8,21,29,64,0.453125,0
35,84,0.417,7,22,0.318,23,31,0.742,15,37,52,26,4,12,15,12,28,62,0.45161290322580644,1
43,92,0.467,13,35,0.371,10,12,0.833,11,34,45,19,7,3,16,24,30,57,0.5263157894736842,1
37,86,0.43,10,32,0.313,24,25,0.96,7,35,42,16,9,7,14,17,27,54,0.5,0
43,95,0.453,21,41,0.512,22,26,0.846,13,31,44,31,6,4,12,22,22,54,0.4074074074074074,1
43,91,0.473,19,46,0.413,16,25,0.64,10,38,48,28,8,7,17,26,24,45,0.5333333333333333,0
39,104,0.375,15,42,0.357,13,13,1.0,14,31,45,19,8,6,11,10,24,62,0.3870967741935484,0
53,96,0.552,21,42,0.5,7,12,0.583,9,44,53,38,10,7,13,13,32,54,0.5925925925925926,1
42,88,0.477,14,43,0.326,20,26,0.769,13,39,52,31,3,8,20,18,28,45,0.6222222222222222,1
40,101,0.396,9,30,0.3,20,24,0.833,17,29,46,22,11,5,10,22,31,71,0.43661971830985913,0
49,102,0.48,28,52,0.538,10,11,0.909,10,40,50,30,8,6,13,20,21,50,0.42,1
39,89,0.438,13,34,0.382,15,19,0.789,8,37,45,21,8,8,17,13,26,55,0.4727272727272727,0
52,93,0.559,15,30,0.5,14,18,0.778,10,43,53,37,11,11,11,16,37,63,0.5873015873015873,1
37,89,0.416,13,37,0.351,15,22,0.682,10,32,42,28,8,7,15,13,24,52,0.46153846153846156,0
45,99,0.455,15,36,0.417,15,17,0.882,11,28,39,21,12,5,8,18,30,63,0.47619047619047616,0
45,79,0.57,13,31,0.419,21,26,0.808,6,38,44,25,6,4,17,17,32,48,0.6666666666666666,1
39,84,0.464,13,34,0.382,20,27,0.741,12,39,51,16,3,4,16,20,26,50,0.52,1
38,83,0.458,15,37,0.405,16,23,0.696,6,30,36,30,9,4,11,23,23,46,0.5,0
42,93,0.452,9,25,0.36,23,24,0.958,10,26,36,27,11,7,16,22,33,68,0.4852941176470588,0
49,82,0.598,16,29,0.552,20,29,0.69,9,33,42,30,8,8,18,19,33,53,0.6226415094339622,1
40,83,0.482,20,45,0.444,23,25,0.92,6,34,40,32,14,4,11,18,20,38,0.5263157894736842,1
41,89,0.461,14,38,0.368,12,14,0.857,9,37,46,24,4,4,17,22,27,51,0.5294117647058824,0
39,93,0.419,9,27,0.333,18,20,0.9,12,34,46,18,7,5,15,21,30,66,0.45454545454545453,0
38,82,0.463,16,42,0.381,25,29,0.862,8,36,44,23,9,6,13,17,22,40,0.55,1
44,95,0.463,21,46,0.457,23,23,1.0,14,30,44,19,6,1,9,19,23,49,0.46938775510204084,1
46,83,0.554,16,40,0.4,13,17,0.765,6,33,39,32,2,5,14,21,30,43,0.6976744186046512,0
43,93,0.462,13,40,0.325,23,25,0.92,13,32,45,27,8,7,10,19,30,53,0.5660377358490566,1
45,90,0.5,14,38,0.368,12,17,0.706,13,33,46,31,6,4,16,20,31,52,0.5961538461538461,0
43,89,0.483,11,22,0.5,10,15,0.667,11,36,47,19,5,4,17,18,32,67,0.47761194029850745,1
43,88,0.489,6,36,0.167,11,16,0.688,6,32,38,25,11,3,9,14,37,52,0.7115384615384616,0
41,79,0.519,10,24,0.417,26,32,0.813,10,30,40,23,9,6,19,21,31,55,0.5636363636363636,1
39,87,0.448,14,37,0.378,19,23,0.826,10,27,37,28,5,4,19,22,25,50,0.5,0
44,79,0.557,20,34,0.588,13,17,0.765,8,38,46,22,4,6,16,20,24,45,0.5333333333333333,1
41,92,0.446,4,10,0.4,13,17,0.765,11,26,37,21,8,6,8,14,37,82,0.45121951219512196,0
35,84,0.417,15,37,0.405,18,25,0.72,14,35,49,20,6,5,17,17,20,47,0.425531914893617,1
36,83,0.434,12,35,0.343,16,22,0.727,9,35,44,24,11,2,16,21,24,48,0.5,0
43,95,0.453,11,34,0.324,13,15,0.867,8,38,46,28,7,6,14,13,32,61,0.5245901639344263,0
48,102,0.471,21,48,0.438,13,14,0.929,11,42,53,33,13,7,13,11,27,54,0.5,1
38,82,0.463,8,35,0.229,17,20,0.85,11,28,39,26,3,6,15,18,30,47,0.6382978723404256,0
46,90,0.511,14,33,0.424,17,21,0.81,12,32,44,30,7,3,7,20,32,57,0.5614035087719298,1
33,86,0.384,12,46,0.261,9,13,0.692,5,36,41,21,11,4,21,18,21,40,0.525,0
36,83,0.434,10,33,0.303,22,26,0.846,5,46,51,19,13,5,21,14,26,50,0.52,1
39,86,0.453,11,33,0.333,22,29,0.759,11,34,45,28,9,3,13,21,28,53,0.5283018867924528,0
42,92,0.457,13,37,0.351,19,23,0.826,12,32,44,23,7,2,11,19,29,55,0.5272727272727272,1
43,94,0.457,13,33,0.394,9,11,0.818,9,40,49,22,6,9,10,21,30,61,0.4918032786885246,0
43,96,0.448,7,26,0.269,18,24,0.75,7,38,45,28,5,6,7,13,36,70,0.5142857142857142,1
44,91,0.484,13,27,0.481,11,13,0.846,12,40,52,19,7,4,14,20,31,64,0.484375,1
32,98,0.327,9,31,0.29,18,19,0.947,18,31,49,19,8,1,11,15,23,67,0.34328358208955223,0
51,89,0.573,22,43,0.512,23,27,0.852,4,41,45,37,6,6,10,19,29,46,0.6304347826086957,1
38,92,0.413,20,50,0.4,20,23,0.87,10,32,42,26,2,3,10,24,18,42,0.42857142857142855,0
36,92,0.391,8,28,0.286,13,15,0.867,16,26,42,19,9,2,17,23,28,64,0.4375,0
46,81,0.568,8,24,0.333,14,22,0.636,8,32,40,29,10,7,16,19,38,57,0.6666666666666666,1
41,87,0.471,19,45,0.422,14,17,0.824,8,36,44,26,8,3,15,19,22,42,0.5238095238095238,1
37,87,0.425,12,35,0.343,17,24,0.708,11,32,43,28,10,6,13,15,25,52,0.4807692307692308,0
45,98,0.459,13,31,0.419,18,23,0.783,19,34,53,17,8,5,12,18,32,67,0.47761194029850745,1
39,81,0.481,7,27,0.259,20,24,0.833,8,29,37,19,6,3,18,15,32,54,0.5925925925925926,0
49,97,0.505,13,32,0.406,12,14,0.857,12,29,41,22,10,6,10,25,36,65,0.5538461538461539,1
39,80,0.488,17,42,0.405,22,29,0.759,8,32,40,29,5,6,18,19,22,38,0.5789473684210527,0
48,87,0.552,26,50,0.52,16,18,0.889,6,38,44,32,5,9,16,19,22,37,0.5945945945945946,1
48,104,0.462,11,35,0.314,14,17,0.824,14,26,40,26,9,2,7,17,37,69,0.5362318840579711,0
50,97,0.515,7,22,0.318,16,22,0.727,13,41,54,28,6,7,13,18,43,75,0.5733333333333334,1
41,92,0.446,11,32,0.344,12,16,0.75,6,30,36,23,7,9,11,19,30,60,0.5,0
41,76,0.539,13,25,0.52,19,26,0.731,11,39,50,23,5,6,20,17,28,51,0.5490196078431373,1
41,93,0.441,20,42,0.476,11,16,0.688,10,27,37,31,9,6,10,21,21,51,0.4117647058823529,0
43,90,0.478,16,38,0.421,17,21,0.81,9,25,34,21,8,1,7,16,27,52,0.5192307692307693,1
42,81,0.519,14,32,0.438,17,21,0.81,10,37,47,26,5,4,16,17,28,49,0.5714285714285714,0
33,89,0.371,8,33,0.242,21,24,0.875,12,28,40,19,7,9,18,20,25,56,0.44642857142857145,0
43,86,0.5,16,36,0.444,20,23,0.87,9,39,48,27,9,7,17,20,27,50,0.54,1
41,94,0.436,16,40,0.4,8,9,0.889,10,33,43,27,10,4,17,15,25,54,0.46296296296296297,1
39,85,0.459,13,34,0.382,12,17,0.706,8,36,44,28,10,7,17,7,26,51,0.5098039215686274,0
46,96,0.479,9,30,0.3,18,20,0.9,10,30,40,27,9,5,8,22,37,66,0.5606060606060606,0
42,81,0.519,11,27,0.407,28,37,0.757,10,39,49,27,5,2,16,22,31,54,0.5740740740740741,1
34,91,0.374,7,36,0.194,17,28,0.607,17,28,45,20,8,6,13,16,27,55,0.4909090909090909,0
42,85,0.494,12,32,0.375,13,16,0.813,10,40,50,26,7,3,22,26,30,53,0.5660377358490566,1
41,97,0.423,13,38,0.342,26,34,0.765,14,24,38,24,9,5,7,27,28,59,0.4745762711864407,0
42,74,0.568,19,36,0.528,29,33,0.879,4,39,43,31,1,10,19,25,23,38,0.6052631578947368,1
47,86,0.547,16,34,0.471,14,23,0.609,6,37,43,25,10,2,9,20,31,52,0.5961538461538461,1
39,86,0.453,6,28,0.214,15,21,0.714,8,32,40,21,4,1,15,19,33,58,0.5689655172413793,0
46,86,0.535,20,45,0.444,20,23,0.87,6,34,40,27,11,4,16,24,26,41,0.6341463414634146,0
44,96,0.458,21,47,0.447,25,30,0.833,15,32,47,27,5,0,14,19,23,49,0.46938775510204084,1
37,87,0.425,8,25,0.32,29,36,0.806,7,37,44,22,6,7,10,18,29,62,0.46774193548387094,1
38,88,0.432,12,38,0.316,18,25,0.72,6,40,46,21,5,6,14,25,26,50,0.52,0
45,94,0.479,16,42,0.381,23,28,0.821,9,26,35,31,13,4,23,31,29,52,0.5576923076923077,0
51,91,0.56,9,19,0.474,24,28,0.857,9,32,41,32,12,5,24,24,42,72,0.5833333333333334,1
40,90,0.444,13,39,0.333,16,19,0.842,11,34,45,27,5,5,10,17,27,51,0.5294117647058824,0
45,87,0.517,15,33,0.455,13,21,0.619,8,34,42,27,3,9,10,15,30,54,0.5555555555555556,1
37,89,0.416,17,47,0.362,8,16,0.5,11,30,41,15,7,7,11,15,20,42,0.47619047619047616,0
44,88,0.5,13,30,0.433,9,13,0.692,8,43,51,20,5,5,14,19,31,58,0.5344827586206896,1
47,93,0.505,12,36,0.333,12,22,0.545,13,27,40,27,12,3,14,15,35,57,0.6140350877192983,0
46,90,0.511,12,33,0.364,16,20,0.8,8,35,43,25,8,1,16,19,34,57,0.5964912280701754,1
47,91,0.516,15,30,0.5,9,13,0.692,11,36,47,28,6,10,12,12,32,61,0.5245901639344263,1
37,95,0.389,6,27,0.222,12,12,1.0,15,32,47,17,5,10,13,10,31,68,0.45588235294117646,0
39,88,0.443,15,41,0.366,15,17,0.882,8,26,34,21,6,3,17,18,24,47,0.5106382978723404,0
48,94,0.511,10,27,0.37,18,22,0.818,13,38,51,27,12,4,16,15,38,67,0.5671641791044776,1
45,97,0.464,13,35,0.371,11,14,0.786,13,34,47,30,3,9,10,18,32,62,0.5161290322580645,0
44,91,0.484,14,35,0.4,17,24,0.708,10,35,45,30,5,7,7,11,30,56,0.5357142857142857,1
34,90,0.378,9,40,0.225,20,28,0.714,12,36,48,22,6,5,15,18,25,50,0.5,0
42,99,0.424,15,36,0.417,20,26,0.769,18,41,59,21,6,6,11,25,27,63,0.42857142857142855,1
38,92,0.413,13,42,0.31,14,21,0.667,16,44,60,22,2,4,14,17,25,50,0.5,1
37,93,0.398,8,29,0.276,13,18,0.722,8,37,45,23,9,6,9,22,29,64,0.453125,0
46,94,0.489,10,29,0.345,11,15,0.733,11,41,52,25,5,4,12,18,36,65,0.5538461538461539,1
41,99,0.414,8,28,0.286,20,23,0.87,16,37,53,19,8,5,10,16,33,71,0.4647887323943662,0
40,83,0.482,13,35,0.371,16,20,0.8,6,38,44,25,6,1,11,15,27,48,0.5625,1
38,85,0.447,16,42,0.381,11,15,0.733,10,34,44,23,8,2,13,20,22,43,0.5116279069767442,0
33,93,0.355,17,44,0.386,8,12,0.667,13,28,41,19,6,2,6,11,16,49,0.32653061224489793,0
40,82,0.488,8,29,0.276,12,12,1.0,9,41,50,25,4,5,10,15,32,53,0.6037735849056604,1
36,86,0.419,6,26,0.231,27,36,0.75,10,37,47,23,8,4,13,21,30,60,0.5,1
36,85,0.424,9,30,0.3,20,24,0.833,10,40,50,23,6,3,16,26,27,55,0.4909090909090909,0
35,86,0.407,13,47,0.277,11,16,0.688,8,31,39,20,9,4,12,18,22,39,0.5641025641025641,0
44,90,0.489,19,41,0.463,12,13,0.923,11,40,51,28,5,6,15,15,25,49,0.5102040816326531,1
42,91,0.462,18,42,0.429,20,28,0.714,7,34,41,27,9,5,9,27,24,49,0.4897959183673469,0
45,87,0.517,12,34,0.353,25,30,0.833,10,38,48,30,4,6,14,22,33,53,0.6226415094339622,1
45,89,0.506,16,40,0.4,19,22,0.864,11,39,50,24,7,7,11,19,29,49,0.5918367346938775,1
41,94,0.436,15,36,0.417,15,16,0.938,8,30,38,22,5,4,9,15,26,58,0.4482758620689655,0
43,110,0.391,12,38,0.316,14,19,0.737,15,40,55,23,6,4,13,23,31,72,0.4305555555555556,0
44,95,0.463,9,38,0.237,22,29,0.759,10,49,59,28,7,12,15,19,35,57,0.6140350877192983,1
42,77,0.545,20,37,0.541,24,26,0.923,7,30,37,28,11,2,16,24,22,40,0.55,1
37,87,0.425,13,39,0.333,26,29,0.897,19,23,42,27,7,4,15,18,24,48,0.5,0
44,86,0.512,8,24,0.333,17,25,0.68,9,30,39,23,5,5,10,20,36,62,0.5806451612903226,0
47,90,0.522,11,24,0.458,14,19,0.737,14,27,41,29,7,6,11,20,36,66,0.5454545454545454,1
38,86,0.442,13,37,0.351,11,15,0.733,6,43,49,29,4,6,20,19,25,49,0.5102040816326531,0
39,96,0.406,11,31,0.355,16,19,0.842,10,36,46,24,12,6,11,16,28,65,0.4307692307692308,1
43,86,0.5,11,30,0.367,14,16,0.875,8,26,34,30,8,6,15,22,32,56,0.5714285714285714,0
47,84,0.56,13,29,0.448,15,21,0.714,7,30,37,28,10,6,13,16,34,55,0.6181818181818182,1
37,87,0.425,10,28,0.357,12,16,0.75,11,35,46,22,8,5,14,25,27,59,0.4576271186440678,0
26,70,0.371,14,33,0.424,32,39,0.821,6,32,38,21,5,6,11,14,12,37,0.32432432432432434,1
38,91,0.418,13,43,0.302,12,21,0.571,12,25,37,24,5,4,12,23,25,48,0.5208333333333334,0
47,92,0.511,12,31,0.387,24,28,0.857,15,40,55,31,7,6,12,20,35,61,0.5737704918032787,1
37,88,0.42,11,35,0.314,12,22,0.545,10,43,53,22,7,3,11,11,26,53,0.49056603773584906,0
35,90,0.389,18,46,0.391,18,19,0.947,9,45,54,18,6,6,9,17,17,44,0.38636363636363635,1
41,85,0.482,9,20,0.45,28,35,0.8,12,47,59,24,4,5,17,22,32,65,0.49230769230769234,1
43,99,0.434,14,42,0.333,11,19,0.579,8,31,39,24,6,8,11,28,29,57,0.5087719298245614,0
42,91,0.462,17,40,0.425,13,19,0.684,10,40,50,26,8,4,11,19,25,51,0.49019607843137253,1
32,86,0.372,8,24,0.333,19,21,0.905,8,37,45,20,2,5,14,16,24,62,0.3870967741935484,0
38,86,0.442,13,29,0.448,19,23,0.826,11,24,35,18,2,2,9,25,25,57,0.43859649122807015,0
40,84,0.476,18,48,0.375,24,27,0.889,10,31,41,28,4,7,11,22,22,36,0.6111111111111112,1
36,92,0.391,15,38,0.395,7,11,0.636,10,33,43,26,4,5,10,21,21,54,0.3888888888888889,0
32,76,0.421,9,31,0.29,31,35,0.886,9,37,46,20,2,5,13,20,23,45,0.5111111111111111,1
41,81,0.506,13,36,0.361,21,26,0.808,9,26,35,27,11,1,12,12,28,45,0.6222222222222222,0
48,81,0.593,25,47,0.532,8,11,0.727,7,28,35,36,4,6,17,20,23,34,0.6764705882352942,1
40,88,0.455,14,39,0.359,23,28,0.821,9,33,42,27,7,4,9,20,26,49,0.5306122448979592,0
43,84,0.512,14,35,0.4,18,20,0.9,4,33,37,25,3,3,11,24,29,49,0.5918367346938775,1
36,94,0.383,8,37,0.216,15,20,0.75,18,31,49,25,7,7,17,18,28,57,0.49122807017543857,0
51,85,0.6,16,36,0.444,15,21,0.714,4,35,39,31,12,9,12,18,35,49,0.7142857142857143,1
47,100,0.47,7,31,0.226,12,14,0.857,7,39,46,32,11,4,13,23,40,69,0.5797101449275363,0
42,89,0.472,10,35,0.286,20,24,0.833,6,37,43,22,6,6,17,15,32,54,0.5925925925925926,1
45,82,0.549,14,29,0.483,10,12,0.833,8,27,35,23,11,4,19,14,31,53,0.5849056603773585,0
47,94,0.5,23,49,0.469,13,18,0.722,19,27,46,34,10,2,17,18,24,45,0.5333333333333333,1
41,82,0.5,12,23,0.522,25,29,0.862,11,37,48,23,9,4,16,20,29,59,0.4915254237288136,1
41,95,0.432,15,41,0.366,15,19,0.789,16,27,43,29,8,8,15,24,26,54,0.48148148148148145,0
43,85,0.506,16,37,0.432,22,30,0.733,10,29,39,23,6,0,10,21,27,48,0.5625,0
46,87,0.529,15,31,0.484,18,25,0.72,12,35,47,25,7,2,11,19,31,56,0.5535714285714286,1
49,93,0.527,19,32,0.594,20,23,0.87,9,37,46,28,5,5,12,17,30,61,0.4918032786885246,1
42,93,0.452,12,41,0.293,19,23,0.826,12,34,46,26,7,3,14,20,30,52,0.5769230769230769,0
41,83,0.494,9,28,0.321,15,19,0.789,3,29,32,26,7,8,13,26,32,55,0.5818181818181818,0
39,86,0.453,20,39,0.513,22,28,0.786,14,35,49,30,8,6,19,22,19,47,0.40425531914893614,1
44,86,0.512,14,31,0.452,9,10,0.9,10,31,41,26,10,5,9,18,30,55,0.5454545454545454,1
38,85,0.447,5,28,0.179,14,19,0.737,15,28,43,21,5,5,12,13,33,57,0.5789473684210527,0
38,97,0.392,15,33,0.455,14,18,0.778,13,36,49,19,7,6,15,17,23,64,0.359375,0
41,88,0.466,20,50,0.4,9,12,0.75,9,37,46,29,6,6,17,20,21,38,0.5526315789473685,1
34,79,0.43,15,42,0.357,18,20,0.9,8,41,49,24,6,3,21,21,19,37,0.5135135135135135,1
32,83,0.386,15,50,0.3,15,20,0.75,8,34,42,24,7,1,15,20,17,33,0.5151515151515151,0
42,86,0.488,6,27,0.222,24,29,0.828,11,35,46,20,6,5,9,20,36,59,0.6101694915254238,0
40,93,0.43,17,38,0.447,21,23,0.913,15,32,47,15,5,2,8,21,23,55,0.41818181818181815,1
45,85,0.529,12,31,0.387,23,28,0.821,8,38,46,27,6,6,14,25,33,54,0.6111111111111112,1
39,90,0.433,11,32,0.344,25,33,0.758,10,31,41,22,10,4,12,17,28,58,0.4827586206896552,0
34,79,0.43,15,38,0.395,25,30,0.833,6,38,44,25,3,6,13,20,19,41,0.4634146341463415,1
36,82,0.439,8,27,0.296,22,30,0.733,7,37,44,15,9,2,10,25,28,55,0.509090909090909,0
50,86,0.581,13,30,0.433,12,15,0.8,4,33,37,20,11,7,9,13,37,56,0.6607142857142857,1
40,85,0.471,12,32,0.375,14,15,0.933,8,33,41,23,4,3,13,16,28,53,0.5283018867924528,0
45,99,0.455,16,41,0.39,8,14,0.571,9,31,40,28,10,4,8,18,29,58,0.5,0
44,90,0.489,13,36,0.361,19,19,1.0,12,43,55,20,4,3,20,17,31,54,0.5740740740740741,1
48,90,0.533,17,37,0.459,17,23,0.739,9,29,38,31,5,3,10,19,31,53,0.5849056603773585,0
51,88,0.58,25,45,0.556,16,21,0.762,5,32,37,30,4,2,6,22,26,43,0.6046511627906976,1
36,90,0.4,10,32,0.313,13,17,0.765,12,38,50,26,8,3,14,19,26,58,0.4482758620689655,0
40,87,0.46,10,40,0.25,7,10,0.7,7,34,41,24,6,6,13,14,30,47,0.6382978723404256,1
39,80,0.488,12,29,0.414,15,19,0.789,6,27,33,31,9,2,17,25,27,51,0.5294117647058824,0
43,85,0.506,6,30,0.2,23,33,0.697,13,34,47,26,9,4,18,16,37,55,0.6727272727272727,1
38,87,0.437,8,23,0.348,26,37,0.703,10,31,41,20,6,3,11,21,30,64,0.46875,0
43,83,0.518,13,35,0.371,30,33,0.909,9,36,45,16,3,4,14,29,30,48,0.625,1
46,91,0.505,15,34,0.441,16,20,0.8,10,32,42,25,8,2,10,15,31,57,0.543859649122807,1
43,83,0.518,12,33,0.364,14,19,0.737,8,34,42,33,8,1,18,18,31,50,0.62,0
42,92,0.457,12,33,0.364,19,27,0.704,6,27,33,19,8,6,10,28,30,59,0.5084745762711864,0
43,82,0.524,14,38,0.368,29,34,0.853,7,39,46,22,4,5,17,22,29,44,0.6590909090909091,1
44,98,0.449,6,24,0.25,15,22,0.682,15,50,65,22,11,4,12,22,38,74,0.5135135135135135,1
34,89,0.382,9,34,0.265,14,20,0.7,9,37,46,20,5,5,14,18,25,55,0.45454545454545453,0
45,89,0.506,12,31,0.387,23,27,0.852,7,36,43,34,8,6,9,21,33,58,0.5689655172413793,1
43,90,0.478,9,31,0.29,18,23,0.783,7,31,38,35,5,4,11,24,34,59,0.576271186440678,0
50,93,0.538,16,39,0.41,18,20,0.9,8,37,45,35,9,5,13,15,34,54,0.6296296296296297,1
44,90,0.489,9,34,0.265,20,25,0.8,5,32,37,25,6,6,13,15,35,56,0.625,0
33,88,0.375,8,43,0.186,25,30,0.833,12,34,46,17,5,5,9,17,25,45,0.5555555555555556,0
45,86,0.523,12,28,0.429,19,23,0.826,4,40,44,21,4,4,8,21,33,58,0.5689655172413793,1
38,73,0.521,7,17,0.412,28,33,0.848,8,27,35,19,7,1,13,15,31,56,0.5535714285714286,0
48,79,0.608,10,25,0.4,14,17,0.824,4,28,32,25,8,3,14,24,38,54,0.7037037037037037,1
35,86,0.407,12,36,0.333,12,17,0.706,8,35,43,24,11,3,17,21,23,50,0.46,0
39,85,0.459,12,46,0.261,22,29,0.759,10,38,48,26,11,7,16,21,27,39,0.6923076923076923,1
48,96,0.5,10,34,0.294,16,19,0.842,10,33,43,31,13,4,9,13,38,62,0.6129032258064516,1
45,95,0.474,12,34,0.353,8,11,0.727,12,37,49,23,6,6,17,20,33,61,0.5409836065573771,0
45,85,0.529,18,40,0.45,13,19,0.684,10,26,36,15,7,2,15,23,27,45,0.6,1
40,81,0.494,14,41,0.341,24,25,0.96,10,25,35,19,5,6,14,21,26,40,0.65,0
40,87,0.46,6,28,0.214,19,29,0.655,8,38,46,27,4,4,10,26,34,59,0.576271186440678,0
39,85,0.459,19,47,0.404,25,34,0.735,9,38,47,28,6,4,10,24,20,38,0.5263157894736842,1
40,90,0.444,9,35,0.257,23,28,0.821,18,26,44,23,5,2,11,17,31,55,0.5636363636363636,0
45,84,0.536,17,35,0.486,16,20,0.8,9,28,37,34,3,8,14,23,28,49,0.5714285714285714,1
43,93,0.462,7,25,0.28,18,25,0.72,11,29,40,25,4,4,15,27,36,68,0.5294117647058824,0
42,88,0.477,13,30,0.433,31,36,0.861,12,35,47,31,8,5,14,21,29,58,0.5,1
45,97,0.464,13,38,0.342,6,9,0.667,12,35,47,24,9,5,15,16,32,59,0.5423728813559322,0
45,95,0.474,15,36,0.417,9,16,0.563,12,37,49,32,8,1,15,14,30,59,0.5084745762711864,1
33,89,0.371,6,35,0.171,18,22,0.818,9,39,48,13,4,6,10,12,27,54,0.5,0
41,92,0.446,12,37,0.324,15,16,0.938,11,48,59,24,6,2,8,17,29,55,0.5272727272727272,1
50,94,0.532,9,21,0.429,15,19,0.789,9,34,43,31,10,2,11,20,41,73,0.5616438356164384,1
41,82,0.5,8,33,0.242,20,26,0.769,5,28,33,22,8,5,16,19,33,49,0.673469387755102,0
43,82,0.524,16,39,0.41,14,19,0.737,5,35,40,28,6,8,18,26,27,43,0.627906976744186,1
38,91,0.418,10,33,0.303,26,31,0.839,10,28,38,24,6,3,12,22,28,58,0.4827586206896552,0
32,90,0.356,9,35,0.257,18,30,0.6,14,36,50,14,5,2,17,27,23,55,0.41818181818181815,0
33,83,0.398,7,30,0.233,31,36,0.861,9,45,54,24,9,3,18,25,26,53,0.49056603773584906,1
37,95,0.389,8,30,0.267,16,20,0.8,15,34,49,19,10,3,18,24,29,65,0.4461538461538462,0
46,88,0.523,17,37,0.459,20,21,0.952,5,34,39,34,9,10,14,23,29,51,0.5686274509803921,1
44,102,0.431,13,33,0.394,19,22,0.864,13,47,60,25,6,2,19,24,31,69,0.4492753623188406,1
39,92,0.424,9,33,0.273,25,31,0.806,8,39,47,18,9,14,19,23,30,59,0.5084745762711864,0
46,91,0.505,8,36,0.222,18,22,0.818,9,30,39,27,7,6,8,21,38,55,0.6909090909090909,0
47,85,0.553,15,32,0.469,16,20,0.8,7,32,39,31,5,0,12,22,32,53,0.6037735849056604,1
36,85,0.424,11,33,0.333,29,32,0.906,11,31,42,17,5,6,11,19,25,52,0.4807692307692308,0
42,83,0.506,17,34,0.5,22,27,0.815,10,32,42,22,5,6,9,22,25,49,0.5102040816326531,1
51,89,0.573,27,47,0.574,7,12,0.583,9,26,35,31,7,4,15,16,24,42,0.5714285714285714,1
51,96,0.531,12,33,0.364,11,13,0.846,15,26,41,24,6,6,15,13,39,63,0.6190476190476191,0
47,94,0.5,8,23,0.348,21,24,0.875,12,30,42,19,6,4,12,21,39,71,0.5492957746478874,0
45,86,0.523,18,45,0.4,26,31,0.839,7,29,36,18,9,4,11,18,27,41,0.6585365853658537,1
43,91,0.473,8,37,0.216,25,34,0.735,9,32,41,23,9,5,18,22,35,54,0.6481481481481481,0
48,92,0.522,12,30,0.4,23,31,0.742,10,37,47,25,14,2,15,24,36,62,0.5806451612903226,1
38,84,0.452,9,34,0.265,14,15,0.933,11,27,38,25,12,3,17,18,29,50,0.58,0
39,81,0.481,15,42,0.357,19,21,0.905,10,33,43,26,7,1,22,22,24,39,0.6153846153846154,1
56,91,0.615,19,38,0.5,13,17,0.765,11,36,47,33,14,4,19,19,37,53,0.6981132075471698,1
42,88,0.477,13,31,0.419,16,18,0.889,9,23,32,23,10,0,19,18,29,57,0.5087719298245614,0
46,91,0.505,17,43,0.395,15,21,0.714,8,36,44,25,8,6,15,18,29,48,0.6041666666666666,1
40,83,0.482,14,37,0.378,19,25,0.76,5,36,41,25,10,5,17,17,26,46,0.5652173913043478,0
42,77,0.545,11,26,0.423,17,21,0.81,6,32,38,20,8,8,18,14,31,51,0.6078431372549019,1
39,93,0.419,16,34,0.471,10,13,0.769,11,27,38,26,11,4,15,27,23,59,0.3898305084745763,0
42,96,0.438,20,47,0.426,11,17,0.647,15,39,54,26,6,8,10,23,22,49,0.4489795918367347,1
37,85,0.435,10,33,0.303,20,27,0.741,7,39,46,23,6,3,11,16,27,52,0.5192307692307693,0
47,82,0.573,20,40,0.5,14,15,0.933,4,33,37,28,4,4,10,11,27,42,0.6428571428571429,1
48,88,0.545,16,37,0.432,12,12,1.0,4,30,34,28,7,3,6,15,32,51,0.6274509803921569,0
44,77,0.571,8,24,0.333,26,31,0.839,8,29,37,19,8,2,15,18,36,53,0.6792452830188679,1
40,86,0.465,10,31,0.323,24,27,0.889,11,26,37,22,9,3,16,27,30,55,0.5454545454545454,0
37,82,0.451,8,28,0.286,20,24,0.833,6,34,40,15,9,2,13,21,29,54,0.5370370370370371,0
41,85,0.482,8,28,0.286,15,24,0.625,8,38,46,29,8,7,13,20,33,57,0.5789473684210527,1
44,97,0.454,13,36,0.361,11,12,0.917,7,42,49,28,8,5,18,22,31,61,0.5081967213114754,0
43,95,0.453,18,52,0.346,16,21,0.762,9,37,46,32,10,1,16,19,25,43,0.5813953488372093,1
42,98,0.429,13,40,0.325,17,20,0.85,17,36,53,19,12,3,13,15,29,58,0.5,1
38,86,0.442,9,26,0.346,11,17,0.647,9,38,47,18,5,2,17,19,29,60,0.48333333333333334,0
35,78,0.449,19,41,0.463,24,28,0.857,6,33,39,25,5,3,18,25,16,37,0.43243243243243246,0
42,83,0.506,12,26,0.462,26,33,0.788,7,37,44,31,14,4,13,18,30,57,0.5263157894736842,1
49,97,0.505,13,26,0.5,23,27,0.852,10,41,51,31,5,7,15,18,36,71,0.5070422535211268,1
45,107,0.421,15,40,0.375,23,25,0.92,11,33,44,37,12,8,11,20,30,67,0.44776119402985076,0
46,90,0.511,18,41,0.439,16,18,0.889,7,24,31,26,6,7,9,19,28,49,0.5714285714285714,1
43,89,0.483,15,32,0.469,23,29,0.793,18,33,51,25,5,1,12,15,28,57,0.49122807017543857,0
33,87,0.379,7,27,0.259,16,19,0.842,10,36,46,16,7,5,16,14,26,60,0.43333333333333335,0
42,92,0.457,16,34,0.471,7,10,0.7,10,40,50,27,10,7,14,15,26,58,0.4482758620689655,1
42,92,0.457,15,47,0.319,14,18,0.778,9,30,39,26,13,6,18,24,27,45,0.6,0
39,81,0.481,12,26,0.462,28,32,0.875,7,40,47,23,12,6,23,21,27,55,0.4909090909090909,1
48,92,0.522,17,38,0.447,15,18,0.833,10,32,42,23,7,7,13,26,31,54,0.5740740740740741,0
44,86,0.512,15,33,0.455,27,34,0.794,9,36,45,31,7,3,14,20,29,53,0.5471698113207547,1
38,77,0.494,18,39,0.462,15,24,0.625,8,31,39,23,9,3,14,18,20,38,0.5263157894736842,1
40,83,0.482,8,30,0.267,10,14,0.714,10,29,39,21,7,4,16,16,32,53,0.6037735849056604,0
38,78,0.487,12,35,0.343,22,23,0.957,2,35,37,26,6,6,9,21,26,43,0.6046511627906976,1
35,88,0.398,10,34,0.294,16,23,0.696,15,37,52,23,6,2,15,23,25,54,0.46296296296296297,0
49,95,0.516,12,34,0.353,8,10,0.8,8,37,45,36,8,2,16,15,37,61,0.6065573770491803,1
43,93,0.462,15,41,0.366,9,16,0.563,13,31,44,29,7,3,16,18,28,52,0.5384615384615384,0
38,90,0.422,10,30,0.333,23,25,0.92,13,28,41,21,14,6,14,14,28,60,0.4666666666666667,0
50,90,0.556,14,35,0.4,7,10,0.7,9,35,44,26,8,12,18,21,36,55,0.6545454545454545,1
46,80,0.575,15,31,0.484,13,17,0.765,6,31,37,24,9,2,17,17,31,49,0.6326530612244898,1
39,83,0.47,12,31,0.387,13,21,0.619,13,21,34,30,8,4,18,15,27,52,0.5192307692307693,0
41,86,0.477,12,34,0.353,18,21,0.857,6,32,38,13,7,6,11,22,29,52,0.5576923076923077,0
43,89,0.483,10,30,0.333,20,22,0.909,11,34,45,22,5,4,11,20,33,59,0.559322033898305,1
36,86,0.419,14,45,0.311,9,13,0.692,13,32,45,27,8,7,21,22,22,41,0.5365853658536586,0
42,90,0.467,5,20,0.25,20,23,0.87,13,36,49,20,12,4,13,13,37,70,0.5285714285714286,1
31,85,0.365,12,40,0.3,11,21,0.524,8,38,46,20,4,5,12,23,19,45,0.4222222222222222,0
35,86,0.407,11,34,0.324,17,25,0.68,11,50,61,23,5,6,13,18,24,52,0.46153846153846156,1
28,85,0.329,12,40,0.3,18,22,0.818,15,36,51,16,8,6,15,16,16,45,0.35555555555555557,1
32,83,0.386,9,38,0.237,8,11,0.727,6,37,43,24,6,9,17,23,23,45,0.5111111111111111,0
51,88,0.58,22,39,0.564,8,12,0.667,4,33,37,38,8,4,13,17,29,49,0.5918367346938775,1
42,82,0.512,11,32,0.344,19,24,0.792,6,31,37,28,11,3,14,16,31,50,0.62,0
46,97,0.474,19,42,0.452,9,15,0.6,9,36,45,37,8,0,13,19,27,55,0.4909090909090909,0
46,94,0.489,18,43,0.419,14,17,0.824,8,43,51,30,7,8,13,19,28,51,0.5490196078431373,1
40,95,0.421,7,32,0.219,18,18,1.0,13,29,42,24,5,6,11,20,33,63,0.5238095238095238,0
41,87,0.471,7,21,0.333,23,29,0.793,16,37,53,23,5,7,15,18,34,66,0.5151515151515151,1
44,98,0.449,8,29,0.276,18,22,0.818,12,29,41,22,8,3,7,18,36,69,0.5217391304347826,0
49,82,0.598,11,23,0.478,13,15,0.867,2,36,38,24,5,8,14,23,38,59,0.6440677966101694,1
37,85,0.435,13,39,0.333,13,17,0.765,9,30,39,23,10,3,14,12,24,46,0.5217391304347826,0
37,75,0.493,20,40,0.5,8,9,0.889,4,40,44,23,7,2,25,22,17,35,0.4857142857142857,1
36,85,0.424,8,28,0.286,16,23,0.696,10,39,49,24,8,3,14,20,28,57,0.49122807017543857,1
33,84,0.393,13,45,0.289,15,17,0.882,6,37,43,25,5,6,15,17,20,39,0.5128205128205128,0
46,86,0.535,24,46,0.522,12,13,0.923,5,36,41,35,5,7,12,14,22,40,0.55,1
36,93,0.387,5,33,0.152,20,23,0.87,17,32,49,19,5,4,12,12,31,60,0.5166666666666667,0
45,89,0.506,6,26,0.231,22,29,0.759,12,42,54,23,8,3,17,19,39,63,0.6190476190476191,1
37,103,0.359,19,55,0.345,18,25,0.72,17,33,50,19,10,7,13,22,18,48,0.375,0
43,84,0.512,16,36,0.444,13,16,0.813,3,30,33,25,8,3,13,24,27,48,0.5625,0
42,81,0.519,12,34,0.353,27,33,0.818,10,34,44,29,6,4,11,20,30,47,0.6382978723404256,1
43,79,0.544,13,28,0.464,18,24,0.75,5,32,37,22,9,3,15,18,30,51,0.5882352941176471,1
39,84,0.464,8,35,0.229,15,20,0.75,14,28,42,22,9,4,18,17,31,49,0.6326530612244898,0
44,92,0.478,11,38,0.289,13,19,0.684,9,31,40,21,10,4,6,19,33,54,0.6111111111111112,1
40,87,0.46,15,35,0.429,13,18,0.722,16,36,52,24,3,4,17,17,25,52,0.4807692307692308,0
44,100,0.44,12,33,0.364,15,20,0.75,14,29,43,29,6,3,13,26,32,67,0.47761194029850745,0
44,90,0.489,11,28,0.393,29,36,0.806,14,42,56,22,8,5,18,19,33,62,0.532258064516129,1
39,98,0.398,10,37,0.27,27,34,0.794,11,38,49,22,9,11,11,30,29,61,0.47540983606557374,0
42,94,0.447,11,36,0.306,25,37,0.676,12,40,52,22,5,7,13,24,31,58,0.5344827586206896,1
33,82,0.402,16,35,0.457,17,21,0.81,7,36,43,24,6,3,16,24,17,47,0.3617021276595745,0
33,78,0.423,6,18,0.333,31,38,0.816,11,37,48,17,4,4,13,25,27,60,0.45,1
34,91,0.374,11,40,0.275,17,21,0.81,9,40,49,23,10,4,11,21,23,51,0.45098039215686275,0
35,81,0.432,9,30,0.3,26,29,0.897,5,46,51,24,7,8,12,18,26,51,0.5098039215686274,1
33,85,0.388,11,37,0.297,26,35,0.743,11,34,45,26,8,7,10,21,22,48,0.4583333333333333,0
40,81,0.494,14,34,0.412,16,18,0.889,5,34,39,25,5,5,14,24,26,47,0.5531914893617021,1
37,94,0.394,6,31,0.194,12,19,0.632,13,38,51,17,7,1,14,23,31,63,0.49206349206349204,0
35,80,0.438,15,41,0.366,17,26,0.654,5,44,49,17,6,4,16,18,20,39,0.5128205128205128,1
49,91,0.538,15,36,0.417,7,10,0.7,8,47,55,24,5,5,12,17,34,55,0.6181818181818182,1
37,96,0.385,13,40,0.325,13,19,0.684,11,35,46,20,7,4,9,16,24,56,0.42857142857142855,0
47,96,0.49,9,25,0.36,24,33,0.727,5,44,49,25,9,4,16,25,38,71,0.5352112676056338,1
49,104,0.471,15,44,0.341,11,17,0.647,12,33,45,29,9,11,20,29,34,60,0.5666666666666667,0
36,81,0.444,15,40,0.375,21,25,0.84,10,35,45,30,7,6,13,20,21,41,0.5121951219512195,1
32,74,0.432,14,39,0.359,16,19,0.842,5,33,38,20,6,1,18,24,18,35,0.5142857142857142,0
37,84,0.44,12,39,0.308,14,19,0.737,13,33,46,15,6,6,17,17,25,45,0.5555555555555556,0
50,99,0.505,16,33,0.485,16,18,0.889,13,30,43,29,6,5,7,13,34,66,0.5151515151515151,1
41,89,0.461,11,36,0.306,17,21,0.81,8,27,35,18,13,2,16,17,30,53,0.5660377358490566,0
45,85,0.529,28,55,0.509,14,17,0.824,8,37,45,34,7,7,23,19,17,30,0.5666666666666667,1
45,87,0.517,15,31,0.484,13,19,0.684,5,33,38,25,6,7,15,17,30,56,0.5357142857142857,0
44,89,0.494,17,40,0.425,22,31,0.71,10,31,41,30,8,5,8,16,27,49,0.5510204081632653,1
40,89,0.449,14,31,0.452,17,23,0.739,13,28,41,22,10,4,13,19,26,58,0.4482758620689655,0
41,78,0.526,15,28,0.536,15,19,0.789,7,29,36,28,7,10,16,19,26,50,0.52,1
41,86,0.477,12,39,0.308,13,18,0.722,12,34,46,19,6,6,13,21,29,47,0.6170212765957447,0
42,89,0.472,13,33,0.394,13,15,0.867,8,30,38,19,5,1,10,17,29,56,0.5178571428571429,1
41,87,0.471,14,41,0.341,10,10,1.0,7,40,47,21,0,7,9,19,27,46,0.5869565217391305,0
40,94,0.426,14,36,0.389,17,18,0.944,10,30,40,25,8,3,1,10,26,58,0.4482758620689655,1
47,88,0.534,11,20,0.55,11,16,0.688,6,30,36,32,5,1,13,16,36,68,0.5294117647058824,0
54,94,0.574,19,38,0.5,8,13,0.615,7,39,46,26,7,5,11,22,35,56,0.625,1
42,98,0.429,19,54,0.352,9,9,1.0,7,36,43,35,4,5,14,16,23,44,0.5227272727272727,0
53,99,0.535,20,42,0.476,13,18,0.722,9,43,52,33,11,5,8,13,33,57,0.5789473684210527,1
40,89,0.449,13,38,0.342,21,24,0.875,7,34,41,30,9,8,10,18,27,51,0.5294117647058824,1
38,97,0.392,11,29,0.379,19,22,0.864,18,38,56,22,4,5,15,23,27,68,0.39705882352941174,0
41,88,0.466,10,34,0.294,13,16,0.813,8,41,49,24,10,9,15,19,31,54,0.5740740740740741,1
33,88,0.375,14,38,0.368,13,22,0.591,10,38,48,25,9,6,12,16,19,50,0.38,0
33,80,0.413,17,38,0.447,26,30,0.867,12,42,54,24,5,8,19,15,16,42,0.38095238095238093,1
40,93,0.43,11,37,0.297,11,13,0.846,8,30,38,29,12,11,10,20,29,56,0.5178571428571429,0
42,95,0.442,8,31,0.258,20,23,0.87,12,24,36,20,10,6,6,16,34,64,0.53125,0
45,85,0.529,23,42,0.548,14,17,0.824,12,33,45,27,4,5,17,23,22,43,0.5116279069767442,1
47,104,0.452,12,38,0.316,20,21,0.952,13,28,41,28,11,4,17,24,35,66,0.5303030303030303,0
55,93,0.591,10,25,0.4,13,16,0.813,7,36,43,28,11,5,21,15,45,68,0.6617647058823529,1
36,90,0.4,10,33,0.303,14,17,0.824,9,24,33,18,8,8,7,15,26,57,0.45614035087719296,0
43,85,0.506,16,36,0.444,10,15,0.667,11,44,55,24,4,10,18,20,27,49,0.5510204081632653,1
39,83,0.47,5,26,0.192,28,31,0.903,8,33,41,27,10,4,18,25,34,57,0.5964912280701754,1
37,81,0.457,7,29,0.241,26,32,0.813,7,32,39,20,11,6,19,22,30,52,0.5769230769230769,0
37,74,0.5,20,44,0.455,14,17,0.824,3,29,32,30,5,3,16,25,17,30,0.5666666666666667,0
37,80,0.463,17,38,0.447,25,29,0.862,11,31,42,31,6,4,11,21,20,42,0.47619047619047616,1
47,89,0.528,13,36,0.361,11,16,0.688,9,29,38,31,8,6,13,23,34,53,0.6415094339622641,0
50,90,0.556,10,23,0.435,18,29,0.621,12,33,45,31,10,6,13,10,40,67,0.5970149253731343,1
40,86,0.465,9,25,0.36,10,15,0.667,6,38,44,20,10,4,13,13,31,61,0.5081967213114754,0
37,89,0.416,18,44,0.409,10,11,0.909,10,42,52,21,6,4,17,14,19,45,0.4222222222222222,1
43,88,0.489,13,36,0.361,25,27,0.926,9,37,46,24,8,5,14,21,30,52,0.5769230769230769,1
44,87,0.506,14,38,0.368,19,27,0.704,7,34,41,26,9,6,14,25,30,49,0.6122448979591837,0
34,85,0.4,8,33,0.242,13,20,0.65,12,33,45,17,5,4,14,15,26,52,0.5,0
41,87,0.471,22,48,0.458,10,15,0.667,14,39,53,28,7,1,12,16,19,39,0.48717948717948717,1
35,87,0.402,9,36,0.25,13,15,0.867,4,31,35,19,8,1,18,10,26,51,0.5098039215686274,0
49,92,0.533,20,45,0.444,11,14,0.786,7,44,51,30,11,2,13,18,29,47,0.6170212765957447,1
41,86,0.477,8,26,0.308,22,25,0.88,10,32,42,24,9,2,11,20,33,60,0.55,1
37,85,0.435,15,38,0.395,21,24,0.875,12,32,44,23,6,7,18,20,22,47,0.46808510638297873,0
34,84,0.405,12,34,0.353,14,16,0.875,8,33,41,19,4,4,14,15,22,50,0.44,0
50,92,0.543,11,19,0.579,11,16,0.688,7,41,48,27,7,1,7,17,39,73,0.5342465753424658,1
51,102,0.5,13,39,0.333,10,14,0.714,12,35,47,32,5,4,9,17,38,63,0.6031746031746031,0
52,96,0.542,13,31,0.419,12,16,0.75,8,34,42,21,4,8,9,13,39,65,0.6,1
42,85,0.494,12,35,0.343,25,33,0.758,8,26,34,25,12,0,16,22,30,50,0.6,0
51,87,0.586,19,36,0.528,19,21,0.905,9,34,43,24,8,2,16,23,32,51,0.6274509803921569,1
32,78,0.41,13,34,0.382,20,23,0.87,10,40,50,17,2,9,22,21,19,44,0.4318181818181818,0
39,90,0.433,12,29,0.414,21,25,0.84,8,31,39,26,11,6,8,19,27,61,0.4426229508196721,1
35,89,0.393,15,46,0.326,27,29,0.931,8,32,40,26,8,6,9,22,20,43,0.46511627906976744,0
42,82,0.512,9,22,0.409,25,29,0.862,7,38,45,24,3,6,12,20,33,60,0.55,1
44,88,0.5,6,22,0.273,12,15,0.8,3,27,30,35,11,4,7,11,38,66,0.5757575757575758,1
39,78,0.5,12,31,0.387,7,10,0.7,6,35,41,25,2,4,19,16,27,47,0.574468085106383,0
37,89,0.416,7,32,0.219,29,41,0.707,14,35,49,24,5,6,11,25,30,57,0.5263157894736842,1
37,82,0.451,12,33,0.364,21,32,0.656,10,35,45,20,6,6,11,25,25,49,0.5102040816326531,0
41,89,0.461,17,41,0.415,22,32,0.688,13,25,38,27,11,1,21,23,24,48,0.5,0
48,79,0.608,11,24,0.458,23,25,0.92,4,33,37,38,10,3,25,19,37,55,0.6727272727272727,1
32,83,0.386,11,37,0.297,18,20,0.9,10,35,45,19,5,5,16,21,21,46,0.45652173913043476,0
37,88,0.42,7,27,0.259,21,28,0.75,15,37,52,25,9,7,10,23,30,61,0.4918032786885246,1
44,80,0.55,14,35,0.4,17,18,0.944,4,43,47,34,6,8,17,19,30,45,0.6666666666666666,1
39,97,0.402,9,28,0.321,12,16,0.75,8,29,37,24,10,4,9,14,30,69,0.43478260869565216,0
40,94,0.426,15,46,0.326,21,23,0.913,9,27,36,24,9,3,9,21,25,48,0.5208333333333334,0
44,86,0.512,14,31,0.452,22,25,0.88,11,39,50,24,5,1,15,21,30,55,0.5454545454545454,1
43,97,0.443,12,40,0.3,11,17,0.647,19,35,54,21,6,5,11,13,31,57,0.543859649122807,0
46,88,0.523,16,42,0.381,10,16,0.625,5,34,39,31,6,2,10,17,30,46,0.6521739130434783,1
39,91,0.429,16,47,0.34,17,20,0.85,7,30,37,23,4,5,11,24,23,44,0.5227272727272727,0
40,89,0.449,16,41,0.39,26,27,0.963,11,37,48,29,6,8,13,20,24,48,0.5,1
45,86,0.523,14,36,0.389,11,17,0.647,6,30,36,23,12,8,9,15,31,50,0.62,1
35,86,0.407,14,44,0.318,14,19,0.737,14,33,47,21,5,4,19,16,21,42,0.5,0
38,84,0.452,11,28,0.393,20,25,0.8,6,29,35,27,5,7,16,17,27,56,0.48214285714285715,0
40,81,0.494,12,24,0.5,18,22,0.818,4,34,38,26,12,2,21,22,28,57,0.49122807017543857,1
49,89,0.551,15,31,0.484,13,16,0.813,6,43,49,30,6,3,13,16,34,58,0.5862068965517241,1
37,88,0.42,11,47,0.234,11,15,0.733,7,30,37,24,7,6,14,16,26,41,0.6341463414634146,0
45,85,0.529,17,45,0.378,17,24,0.708,10,42,52,29,2,3,12,14,28,40,0.7,1
44,96,0.458,14,34,0.412,7,8,0.875,7,30,37,27,6,3,4,18,30,62,0.4838709677419355,0
41,97,0.423,8,24,0.333,22,29,0.759,13,39,52,24,12,3,17,26,33,73,0.4520547945205479,1
38,83,0.458,10,28,0.357,23,35,0.657,8,38,46,25,9,10,19,26,28,55,0.509090909090909,0
40,91,0.44,9,32,0.281,25,31,0.806,17,35,52,27,3,2,10,17,31,59,0.5254237288135594,0
41,86,0.477,12,32,0.375,23,28,0.821,8,30,38,24,7,5,9,26,29,54,0.5370370370370371,1
41,95,0.432,11,35,0.314,19,29,0.655,12,38,50,23,9,10,18,29,30,60,0.5,0
44,98,0.449,13,33,0.394,27,34,0.794,15,42,57,27,6,6,16,24,31,65,0.47692307692307695,1
38,84,0.452,9,32,0.281,25,29,0.862,7,29,36,16,10,5,14,22,29,52,0.5576923076923077,0
42,89,0.472,10,30,0.333,17,24,0.708,13,36,49,25,7,0,19,25,32,59,0.5423728813559322,1
44,86,0.512,13,26,0.5,8,10,0.8,6,35,41,23,9,7,12,23,31,60,0.5166666666666667,1
28,72,0.389,9,32,0.281,25,31,0.806,7,33,40,16,8,4,16,15,19,40,0.475,0
50,94,0.532,10,30,0.333,23,28,0.821,11,45,56,27,16,3,18,31,40,64,0.625,1
23,83,0.277,4,45,0.089,34,41,0.829,12,26,38,10,7,6,23,24,19,38,0.5,0
35,86,0.407,8,34,0.235,13,19,0.684,3,32,35,26,10,4,20,25,27,52,0.5192307692307693,0
40,85,0.471,11,31,0.355,26,38,0.684,14,46,60,22,14,6,20,21,29,54,0.5370370370370371,1
36,87,0.414,8,35,0.229,19,22,0.864,16,33,49,22,12,6,17,20,28,52,0.5384615384615384,0
39,86,0.453,11,37,0.297,20,22,0.909,12,33,45,27,8,6,14,20,28,49,0.5714285714285714,1
40,97,0.412,14,44,0.318,6,7,0.857,13,36,49,20,7,3,10,19,26,53,0.49056603773584906,0
38,85,0.447,12,38,0.316,17,22,0.773,8,40,48,21,7,5,12,11,26,47,0.5531914893617021,1
44,89,0.494,7,27,0.259,23,24,0.958,8,39,47,27,7,5,16,18,37,62,0.5967741935483871,1
35,93,0.376,8,35,0.229,21,24,0.875,10,34,44,21,12,4,16,22,27,58,0.46551724137931033,0
45,83,0.542,11,30,0.367,26,27,0.963,7,30,37,30,3,6,16,20,34,53,0.6415094339622641,1
50,92,0.543,16,36,0.444,10,17,0.588,9,24,33,32,6,2,10,19,34,56,0.6071428571428571,0
46,87,0.529,10,27,0.37,16,20,0.8,9,41,50,22,4,6,13,18,36,60,0.6,1
42,94,0.447,12,38,0.316,16,22,0.727,14,30,44,25,7,3,10,18,30,56,0.5357142857142857,0
36,73,0.493,10,30,0.333,19,24,0.792,6,42,48,23,7,6,21,18,26,43,0.6046511627906976,1
31,76,0.408,10,31,0.323,18,24,0.75,4,26,30,13,13,4,14,18,21,45,0.4666666666666667,0
46,101,0.455,17,43,0.395,15,18,0.833,11,28,39,26,11,7,9,22,29,58,0.5,0
52,92,0.565,7,11,0.636,18,23,0.783,10,43,53,27,5,5,13,15,45,81,0.5555555555555556,1
47,90,0.522,17,46,0.37,19,23,0.826,7,39,46,29,6,6,8,12,30,44,0.6818181818181818,1
47,95,0.495,20,41,0.488,10,14,0.714,6,35,41,25,5,1,8,17,27,54,0.5,0
44,91,0.484,8,29,0.276,18,21,0.857,8,26,34,27,8,1,19,19,36,62,0.5806451612903226,0
50,88,0.568,15,35,0.429,15,16,0.938,6,33,39,27,10,6,19,19,35,53,0.660377358490566,1
43,88,0.489,15,34,0.441,10,17,0.588,11,26,37,25,12,5,16,16,28,54,0.5185185185185185,0
46,86,0.535,24,46,0.522,7,10,0.7,8,30,38,26,12,7,17,15,22,40,0.55,1
47,100,0.47,17,41,0.415,13,17,0.765,13,38,51,35,6,8,5,13,30,59,0.5084745762711864,1
44,97,0.454,15,35,0.429,10,15,0.667,9,39,48,30,2,3,9,16,29,62,0.46774193548387094,0
43,87,0.494,18,38,0.474,8,9,0.889,10,25,35,28,3,5,9,19,25,49,0.5102040816326531,0
42,86,0.488,16,32,0.5,17,23,0.739,14,29,43,25,6,4,9,12,26,54,0.48148148148148145,1
38,77,0.494,16,29,0.552,22,25,0.88,5,30,35,30,5,7,14,16,22,48,0.4583333333333333,1
40,79,0.506,11,31,0.355,13,17,0.765,5,29,34,18,6,8,12,23,29,48,0.6041666666666666,0
34,71,0.479,13,36,0.361,13,15,0.867,11,36,47,26,5,2,23,18,21,35,0.6,1
28,75,0.373,9,33,0.273,15,22,0.682,5,21,26,15,16,4,9,13,19,42,0.4523809523809524,0
53,95,0.558,11,30,0.367,11,12,0.917,9,36,45,28,10,3,10,19,42,65,0.6461538461538462,1
32,79,0.405,11,40,0.275,22,31,0.71,11,29,40,22,4,4,13,18,21,39,0.5384615384615384,0
33,81,0.407,15,36,0.417,12,15,0.8,9,32,41,18,2,5,16,16,18,45,0.4,0
43,89,0.483,18,42,0.429,15,21,0.714,9,36,45,31,12,4,9,14,25,47,0.5319148936170213,1
47,95,0.495,13,29,0.448,18,23,0.783,9,35,44,26,15,1,13,21,34,66,0.5151515151515151,1
41,81,0.506,11,31,0.355,18,25,0.72,4,33,37,29,8,3,22,20,30,50,0.6,0
47,83,0.566,8,25,0.32,12,16,0.75,4,23,27,27,18,8,14,16,39,58,0.6724137931034483,1
43,83,0.518,11,28,0.393,14,15,0.933,11,32,43,29,8,1,26,18,32,55,0.5818181818181818,0
29,87,0.333,9,39,0.231,11,17,0.647,8,37,45,13,6,4,13,20,20,48,0.4166666666666667,0
32,83,0.386,8,40,0.2,15,19,0.789,7,46,53,18,8,3,15,13,24,43,0.5581395348837209,1
49,85,0.576,17,35,0.486,17,24,0.708,10,43,53,33,5,1,15,24,32,50,0.64,1
38,91,0.418,18,43,0.419,20,28,0.714,12,25,37,24,10,5,9,18,20,48,0.4166666666666667,0
51,98,0.52,17,39,0.436,16,21,0.762,13,41,54,33,14,7,17,18,34,59,0.576271186440678,1
39,96,0.406,9,40,0.225,15,18,0.833,12,33,45,25,11,2,21,18,30,56,0.5357142857142857,0
48,94,0.511,12,28,0.429,20,22,0.909,13,32,45,28,6,8,16,21,36,66,0.5454545454545454,1
46,83,0.554,6,22,0.273,26,38,0.684,7,28,35,29,10,6,11,19,40,61,0.6557377049180327,0
38,85,0.447,21,45,0.467,18,19,0.947,6,36,42,26,7,5,12,25,17,40,0.425,1
36,84,0.429,13,35,0.371,27,27,1.0,10,36,46,24,6,5,10,15,23,49,0.46938775510204084,0
44,100,0.44,21,44,0.477,14,19,0.737,12,40,52,22,7,1,16,24,23,56,0.4107142857142857,0
48,93,0.516,8,25,0.32,27,35,0.771,8,42,50,22,9,6,11,17,40,68,0.5882352941176471,1
41,97,0.423,15,42,0.357,9,14,0.643,17,37,54,27,8,1,11,24,26,55,0.4727272727272727,0
36,86,0.419,14,49,0.286,22,26,0.846,8,39,47,15,5,4,10,16,22,37,0.5945945945945946,1
49,93,0.527,12,27,0.444,10,14,0.714,15,26,41,27,7,3,12,19,37,66,0.5606060606060606,0
48,80,0.6,12,25,0.48,15,19,0.789,6,24,30,32,5,1,14,19,36,55,0.6545454545454545,1
48,91,0.527,20,41,0.488,13,21,0.619,12,37,49,39,11,4,14,28,28,50,0.56,1
34,77,0.442,12,36,0.333,25,30,0.833,7,27,34,17,6,5,14,20,22,41,0.5365853658536586,0
45,91,0.495,21,50,0.42,14,17,0.824,8,20,28,36,6,1,14,25,24,41,0.5853658536585366,0
45,74,0.608,13,29,0.448,29,40,0.725,9,30,39,25,6,7,16,20,32,45,0.7111111111111111,1
45,77,0.584,12,28,0.429,11,16,0.688,6,35,41,27,6,5,19,13,33,49,0.673469387755102,1
41,90,0.456,14,39,0.359,7,12,0.583,11,23,34,27,12,3,15,17,27,51,0.5294117647058824,0
42,95,0.442,10,34,0.294,18,22,0.818,13,39,52,21,11,5,16,19,32,61,0.5245901639344263,1
40,101,0.396,8,34,0.235,23,24,0.958,17,39,56,21,13,8,12,20,32,67,0.47761194029850745,0
36,73,0.493,10,30,0.333,21,25,0.84,5,36,41,27,6,3,11,20,26,43,0.6046511627906976,1
33,84,0.393,11,43,0.256,16,20,0.8,15,29,44,28,5,3,14,21,22,41,0.5365853658536586,0
39,80,0.488,14,36,0.389,12,15,0.8,6,23,29,23,6,2,13,13,25,44,0.5681818181818182,0
45,83,0.542,9,27,0.333,15,19,0.789,12,35,47,25,10,4,13,13,36,56,0.6428571428571429,1
38,88,0.432,12,35,0.343,10,16,0.625,9,31,40,22,9,4,17,11,26,53,0.49056603773584906,0
49,96,0.51,12,30,0.4,10,13,0.769,12,40,52,31,8,4,16,16,37,66,0.5606060606060606,1
49,103,0.476,11,29,0.379,10,16,0.625,18,33,51,25,3,3,7,19,38,74,0.5135135135135135,0
42,88,0.477,15,38,0.395,24,25,0.96,9,32,41,20,6,7,9,14,27,50,0.54,1
37,85,0.435,12,40,0.3,21,26,0.808,9,36,45,20,9,4,17,16,25,45,0.5555555555555556,1
40,85,0.471,10,31,0.323,12,12,1.0,6,40,46,23,9,5,19,24,30,54,0.5555555555555556,0
38,82,0.463,16,35,0.457,25,27,0.926,10,35,45,24,4,4,19,31,22,47,0.46808510638297873,0
40,88,0.455,9,23,0.391,30,42,0.714,11,30,41,20,12,3,9,24,31,65,0.47692307692307695,1
38,83,0.458,12,28,0.429,16,20,0.8,6,24,30,18,10,2,9,19,26,55,0.4727272727272727,0
43,83,0.518,13,40,0.325,16,19,0.842,13,38,51,29,3,1,15,19,30,43,0.6976744186046512,1
38,95,0.4,11,36,0.306,25,27,0.926,6,33,39,23,9,6,9,26,27,59,0.4576271186440678,0
50,99,0.505,8,23,0.348,19,29,0.655,14,46,60,31,4,6,16,26,42,76,0.5526315789473685,1
41,91,0.451,13,40,0.325,14,22,0.636,11,28,39,22,10,10,11,13,28,51,0.5490196078431373,0
42,88,0.477,19,42,0.452,18,22,0.818,11,34,45,21,3,5,15,22,23,46,0.5,1
53,103,0.515,10,33,0.303,11,15,0.733,13,32,45,25,11,7,11,16,43,70,0.6142857142857143,1
39,83,0.47,14,29,0.483,13,16,0.813,8,30,38,26,3,6,19,19,25,54,0.46296296296296297,0
38,85,0.447,15,46,0.326,11,14,0.786,11,39,50,27,6,5,14,21,23,39,0.5897435897435898,0
36,90,0.4,10,30,0.333,23,24,0.958,12,33,45,26,9,3,9,14,26,60,0.43333333333333335,1
38,88,0.432,9,36,0.25,19,27,0.704,5,39,44,20,6,6,16,23,29,52,0.5576923076923077,0
44,96,0.458,18,41,0.439,24,29,0.828,11,45,56,23,10,6,11,22,26,55,0.4727272727272727,1
39,96,0.406,12,34,0.353,13,15,0.867,16,41,57,22,6,4,14,19,27,62,0.43548387096774194,0
41,91,0.451,16,49,0.327,13,22,0.591,9,35,44,27,8,4,11,16,25,42,0.5952380952380952,1
37,88,0.42,13,37,0.351,14,21,0.667,10,28,38,19,3,5,15,19,24,51,0.47058823529411764,0
50,87,0.575,18,38,0.474,16,17,0.941,5,38,43,29,9,9,12,18,32,49,0.6530612244897959,1
51,95,0.537,19,40,0.475,14,16,0.875,7,31,38,28,11,10,12,20,32,55,0.5818181818181818,1
43,100,0.43,6,32,0.188,13,24,0.542,19,32,51,28,7,6,18,18,37,68,0.5441176470588235,0
35,82,0.427,15,34,0.441,23,33,0.697,6,31,37,20,4,9,6,22,20,48,0.4166666666666667,0
41,91,0.451,16,32,0.5,18,20,0.9,16,39,55,25,2,6,9,24,25,59,0.423728813559322,1
49,83,0.59,13,24,0.542,16,19,0.842,5,33,38,28,6,1,13,20,36,59,0.6101694915254238,1
43,94,0.457,18,43,0.419,17,19,0.895,15,26,41,26,8,2,11,18,25,51,0.49019607843137253,0
41,99,0.414,11,45,0.244,12,17,0.706,10,34,44,24,7,6,13,22,30,54,0.5555555555555556,0
45,92,0.489,11,33,0.333,24,28,0.857,8,45,53,25,11,5,15,19,34,59,0.576271186440678,1
39,90,0.433,15,42,0.357,28,35,0.8,12,41,53,20,8,13,14,26,24,48,0.5,1
42,96,0.438,17,37,0.459,19,23,0.826,13,37,50,23,8,4,14,25,25,59,0.423728813559322,0
37,80,0.463,12,35,0.343,15,20,0.75,1,40,41,26,11,6,10,13,25,45,0.5555555555555556,1
34,92,0.37,15,38,0.395,7,7,1.0,12,38,50,25,5,3,16,16,19,54,0.35185185185185186,0
37,88,0.42,8,36,0.222,18,21,0.857,10,34,44,22,7,4,16,27,29,52,0.5576923076923077,0
34,76,0.447,7,22,0.318,30,39,0.769,6,38,44,20,10,5,15,20,27,54,0.5,1
41,92,0.446,13,37,0.351,8,11,0.727,9,36,45,27,10,5,12,10,28,55,0.509090909090909,1
40,87,0.46,14,28,0.5,8,8,1.0,8,37,45,27,6,5,17,15,26,59,0.4406779661016949,0
30,88,0.341,7,32,0.219,15,20,0.75,5,28,33,13,8,9,7,18,23,56,0.4107142857142857,0
47,101,0.465,6,24,0.25,16,19,0.842,19,51,70,25,2,7,14,18,41,77,0.5324675324675324,1
29,80,0.363,10,38,0.263,9,12,0.75,9,37,46,17,3,4,20,16,19,42,0.4523809523809524,0
40,89,0.449,10,29,0.345,14,18,0.778,7,38,45,24,8,5,11,15,30,60,0.5,1
41,112,0.366,9,43,0.209,8,13,0.615,19,31,50,15,11,5,11,19,32,69,0.463768115942029,0
39,81,0.481,15,40,0.375,21,25,0.84,6,45,51,24,7,10,20,17,24,41,0.5853658536585366,1
49,90,0.544,11,21,0.524,18,18,1.0,10,39,49,26,13,6,17,19,38,69,0.5507246376811594,1
40,82,0.488,8,24,0.333,13,22,0.591,6,26,32,19,10,2,18,16,32,58,0.5517241379310345,0
43,98,0.439,7,36,0.194,13,16,0.813,22,25,47,27,5,1,13,26,36,62,0.5806451612903226,0
43,84,0.512,12,33,0.364,23,33,0.697,13,32,45,21,6,2,9,17,31,51,0.6078431372549019,1
36,89,0.404,8,32,0.25,15,20,0.75,12,34,46,26,10,8,13,16,28,57,0.49122807017543857,0
39,80,0.488,6,27,0.222,16,22,0.727,5,30,35,22,8,7,12,16,33,53,0.6226415094339622,1
37,96,0.385,15,46,0.326,15,18,0.833,13,34,47,25,10,6,16,16,22,50,0.44,0
39,81,0.481,21,49,0.429,15,19,0.789,8,43,51,30,10,6,27,22,18,32,0.5625,1
42,86,0.488,18,46,0.391,14,16,0.875,11,37,48,26,5,3,8,19,24,40,0.6,1
37,90,0.411,16,41,0.39,13,18,0.722,12,30,42,27,5,1,10,19,21,49,0.42857142857142855,0
43,89,0.483,13,40,0.325,26,30,0.867,7,27,34,26,6,5,8,18,30,49,0.6122448979591837,1
44,86,0.512,10,26,0.385,23,31,0.742,19,37,56,23,5,7,18,24,34,60,0.5666666666666667,0
44,90,0.489,14,35,0.4,17,22,0.773,11,33,44,23,12,2,11,20,30,55,0.5454545454545454,1
37,76,0.487,8,32,0.25,15,21,0.714,5,35,40,22,3,4,18,18,29,44,0.6590909090909091,0
46,87,0.529,13,28,0.464,17,21,0.81,9,36,45,25,9,6,16,18,33,59,0.559322033898305,1
43,91,0.473,12,31,0.387,13,17,0.765,10,30,40,28,9,4,16,17,31,60,0.5166666666666667,0
43,99,0.434,17,45,0.378,22,25,0.88,13,44,57,33,9,3,18,19,26,54,0.48148148148148145,1
43,94,0.457,16,41,0.39,17,22,0.773,6,35,41,25,9,2,15,20,27,53,0.5094339622641509,0
31,81,0.383,8,30,0.267,12,23,0.522,14,20,34,19,4,5,13,18,23,51,0.45098039215686275,0
32,71,0.451,12,29,0.414,24,26,0.923,12,37,49,21,4,6,21,21,20,42,0.47619047619047616,1
34,90,0.378,12,45,0.267,15,21,0.714,7,31,38,23,5,7,12,22,22,45,0.4888888888888889,0
44,97,0.454,12,44,0.273,18,23,0.783,14,46,60,35,6,7,12,20,32,53,0.6037735849056604,1
41,93,0.441,15,44,0.341,22,29,0.759,18,33,51,24,6,6,14,16,26,49,0.5306122448979592,0
50,89,0.562,16,31,0.516,15,18,0.833,5,35,40,33,12,2,14,26,34,58,0.5862068965517241,1
51,92,0.554,18,37,0.486,14,21,0.667,10,45,55,29,8,3,14,22,33,55,0.6,1
35,91,0.385,16,50,0.32,21,31,0.677,10,27,37,23,8,5,11,19,19,41,0.4634146341463415,0
39,89,0.438,17,45,0.378,17,21,0.81,9,33,42,22,6,3,12,29,22,44,0.5,0
36,73,0.493,13,38,0.342,29,39,0.744,5,40,45,24,6,4,12,22,23,35,0.6571428571428571,1
42,92,0.457,15,43,0.349,16,19,0.842,9,23,32,23,12,2,12,17,27,49,0.5510204081632653,0
53,81,0.654,12,26,0.462,17,21,0.81,4,36,40,38,8,1,19,16,41,55,0.7454545454545455,1
47,92,0.511,7,22,0.318,21,29,0.724,11,21,32,27,13,3,7,21,40,70,0.5714285714285714,0
42,73,0.575,16,31,0.516,28,34,0.824,8,38,46,26,7,4,25,20,26,42,0.6190476190476191,1
37,89,0.416,14,50,0.28,14,15,0.933,10,33,43,28,15,6,11,17,23,39,0.5897435897435898,1
33,75,0.44,16,40,0.4,15,21,0.714,8,37,45,25,4,1,23,18,17,35,0.4857142857142857,0
36,85,0.424,4,21,0.19,23,31,0.742,10,22,32,20,8,10,9,13,32,64,0.5,0
56,98,0.571,15,29,0.517,7,11,0.636,13,41,54,35,7,7,11,27,41,69,0.5942028985507246,1
37,92,0.402,15,42,0.357,23,27,0.852,13,27,40,16,9,2,9,22,22,50,0.44,0
44,76,0.579,12,29,0.414,17,22,0.773,3,38,41,29,3,6,15,19,32,47,0.6808510638297872,1
48,86,0.558,9,31,0.29,11,17,0.647,4,40,44,28,7,6,12,19,39,55,0.7090909090909091,0
45,94,0.479,12,30,0.4,20,25,0.8,10,36,46,30,7,3,9,15,33,64,0.515625,1
43,86,0.5,14,32,0.438,9,11,0.818,9,37,46,23,10,0,9,12,29,54,0.5370370370370371,1
39,79,0.494,17,41,0.415,4,5,0.8,4,29,33,24,8,4,15,16,22,38,0.5789473684210527,0
39,90,0.433,17,42,0.405,11,13,0.846,10,29,39,28,8,9,12,13,22,48,0.4583333333333333,0
45,97,0.464,15,28,0.536,16,19,0.842,17,37,54,32,7,7,10,15,30,69,0.43478260869565216,1
47,83,0.566,12,25,0.48,3,5,0.6,10,35,45,29,3,9,22,23,35,58,0.603448275862069,1
39,83,0.47,7,25,0.28,14,25,0.56,8,26,34,22,9,5,10,9,32,58,0.5517241379310345,0
49,78,0.628,11,27,0.407,19,25,0.76,7,39,46,36,9,3,19,25,38,51,0.7450980392156863,1
34,79,0.43,13,37,0.351,16,24,0.667,9,21,30,24,9,2,22,23,21,42,0.5,0
38,87,0.437,5,23,0.217,18,26,0.692,10,29,39,15,11,0,11,17,33,64,0.515625,0
47,83,0.566,12,30,0.4,16,18,0.889,5,37,42,28,7,5,15,19,35,53,0.660377358490566,1
52,94,0.553,11,28,0.393,18,19,0.947,9,37,46,29,6,5,16,20,41,66,0.6212121212121212,1
44,87,0.506,16,38,0.421,18,24,0.75,2,31,33,34,5,1,14,18,28,49,0.5714285714285714,0
38,80,0.475,19,43,0.442,22,24,0.917,10,28,38,23,6,6,17,18,19,37,0.5135135135135135,1
48,98,0.49,10,29,0.345,3,4,0.75,16,29,45,28,8,5,14,18,38,69,0.5507246376811594,0
42,90,0.467,7,20,0.35,11,13,0.846,13,30,43,16,9,9,17,15,35,70,0.5,0
48,94,0.511,12,36,0.333,15,18,0.833,12,30,42,24,8,4,12,17,36,58,0.6206896551724138,1
44,86,0.512,17,37,0.459,14,16,0.875,9,29,38,32,8,6,12,18,27,49,0.5510204081632653,1
42,88,0.477,13,34,0.382,10,13,0.769,10,27,37,27,6,6,13,19,29,54,0.5370370370370371,0
47,90,0.522,11,35,0.314,16,22,0.727,8,26,34,28,9,6,12,21,36,55,0.6545454545454545,0
50,87,0.575,13,26,0.5,24,28,0.857,10,33,43,37,3,3,14,16,37,61,0.6065573770491803,1
39,86,0.453,10,35,0.286,10,14,0.714,15,27,42,23,7,6,14,19,29,51,0.5686274509803921,0
42,85,0.494,10,27,0.37,19,21,0.905,16,32,48,30,11,5,15,18,32,58,0.5517241379310345,1
37,84,0.44,8,24,0.333,14,22,0.636,9,38,47,19,7,5,13,23,29,60,0.48333333333333334,0
37,90,0.411,11,32,0.344,14,19,0.737,12,38,50,19,8,10,12,22,26,58,0.4482758620689655,1
46,88,0.523,16,33,0.485,16,20,0.8,10,31,41,38,8,3,16,24,30,55,0.5454545454545454,0
38,73,0.521,18,43,0.419,31,31,1.0,4,28,32,20,8,8,17,19,20,30,0.6666666666666666,1
38,89,0.427,8,31,0.258,22,30,0.733,13,33,46,19,5,6,9,8,30,58,0.5172413793103449,1
40,91,0.44,11,33,0.333,8,9,0.889,14,37,51,24,6,3,17,22,29,58,0.5,0
40,88,0.455,10,38,0.263,20,29,0.69,15,25,40,19,10,9,12,27,30,50,0.6,0
40,74,0.541,10,23,0.435,27,33,0.818,7,33,40,23,6,3,17,17,30,51,0.5882352941176471,1
37,88,0.42,9,32,0.281,6,11,0.545,8,29,37,22,12,3,13,15,28,56,0.5,0
40,79,0.506,15,34,0.441,10,12,0.833,6,37,43,14,7,7,18,16,25,45,0.5555555555555556,1
36,80,0.45,12,38,0.316,20,28,0.714,7,26,33,25,11,1,17,16,24,42,0.5714285714285714,0
52,90,0.578,16,44,0.364,9,13,0.692,8,40,48,37,12,3,16,22,36,46,0.782608695652174,1
37,86,0.43,12,40,0.3,26,34,0.765,10,20,30,27,7,6,9,26,25,46,0.5434782608695652,0
38,75,0.507,12,29,0.414,28,32,0.875,13,41,54,23,8,5,21,30,26,46,0.5652173913043478,1
41,90,0.456,16,45,0.356,10,12,0.833,6,42,48,32,7,4,13,26,25,45,0.5555555555555556,1
33,80,0.413,7,27,0.259,21,40,0.525,8,40,48,19,7,3,16,15,26,53,0.49056603773584906,0
42,87,0.483,9,27,0.333,31,40,0.775,15,35,50,22,10,2,18,20,33,60,0.55,1
43,84,0.512,9,32,0.281,20,25,0.8,4,30,34,29,10,3,16,28,34,52,0.6538461538461539,0
32,89,0.36,8,34,0.235,13,18,0.722,8,43,51,17,4,2,11,21,24,55,0.43636363636363634,0
30,85,0.353,10,42,0.238,19,25,0.76,8,42,50,22,5,4,10,17,20,43,0.46511627906976744,1
41,101,0.406,9,39,0.231,18,24,0.75,12,46,58,22,11,1,22,11,32,62,0.5161290322580645,1
43,109,0.394,14,41,0.341,5,8,0.625,13,46,59,28,14,7,20,23,29,68,0.4264705882352941,0
41,93,0.441,10,33,0.303,29,35,0.829,6,32,38,25,10,4,10,26,31,60,0.5166666666666667,1
46,94,0.489,4,25,0.16,23,28,0.821,10,42,52,25,5,2,15,25,42,69,0.6086956521739131,0
34,93,0.366,13,34,0.382,12,16,0.75,11,27,38,18,5,3,10,13,21,59,0.3559322033898305,0
47,87,0.54,11,33,0.333,11,13,0.846,6,44,50,26,6,7,14,16,36,54,0.6666666666666666,1
41,83,0.494,11,29,0.379,12,20,0.6,8,36,44,26,7,8,19,19,30,54,0.5555555555555556,0
44,92,0.478,13,39,0.333,15,20,0.75,11,37,48,23,7,6,11,19,31,53,0.5849056603773585,1
35,82,0.427,10,34,0.294,13,16,0.813,8,41,49,21,6,6,11,13,25,48,0.5208333333333334,0
37,86,0.43,14,34,0.412,6,11,0.545,5,38,43,24,6,4,7,14,23,52,0.4423076923076923,1
44,93,0.473,11,34,0.324,24,35,0.686,11,27,38,22,14,4,12,16,33,59,0.559322033898305,1
45,85,0.529,15,36,0.417,14,19,0.737,9,38,47,29,6,6,22,30,30,49,0.6122448979591837,0
33,83,0.398,10,37,0.27,17,25,0.68,10,34,44,24,6,5,13,19,23,46,0.5,0
33,87,0.379,14,43,0.326,21,25,0.84,14,36,50,11,8,8,13,19,19,44,0.4318181818181818,1
44,96,0.458,18,48,0.375,16,28,0.571,11,36,47,19,10,3,17,27,26,48,0.5416666666666666,0
47,86,0.547,7,17,0.412,30,38,0.789,7,36,43,23,6,2,13,27,40,69,0.5797101449275363,1
37,81,0.457,12,30,0.4,21,26,0.808,11,34,45,22,6,9,14,16,25,51,0.49019607843137253,1
39,91,0.429,12,31,0.387,6,7,0.857,12,33,45,22,8,4,16,20,27,60,0.45,0
41,88,0.466,7,18,0.389,27,33,0.818,17,34,51,19,5,4,13,25,34,70,0.4857142857142857,1
39,89,0.438,7,27,0.259,25,32,0.781,15,32,47,19,8,4,11,21,32,62,0.5161290322580645,0
47,90,0.522,17,35,0.486,16,23,0.696,9,33,42,32,6,2,18,20,30,55,0.5454545454545454,0
48,91,0.527,14,34,0.412,21,27,0.778,9,34,43,29,10,3,13,22,34,57,0.5964912280701754,1
37,85,0.435,14,29,0.483,25,28,0.893,12,37,49,28,7,4,13,17,23,56,0.4107142857142857,1
39,88,0.443,9,32,0.281,13,16,0.813,7,31,38,21,7,4,15,17,30,56,0.5357142857142857,0
44,91,0.484,15,41,0.366,13,18,0.722,8,35,43,31,13,6,13,16,29,50,0.58,1
39,84,0.464,8,26,0.308,17,21,0.81,9,37,46,24,10,6,21,17,31,58,0.5344827586206896,0
52,89,0.584,20,36,0.556,13,19,0.684,9,38,47,38,7,9,17,17,32,53,0.6037735849056604,1
41,92,0.446,9,34,0.265,19,20,0.95,10,26,36,22,10,4,11,17,32,58,0.5517241379310345,0
43,91,0.473,10,37,0.27,17,23,0.739,9,30,39,24,9,3,8,16,33,54,0.6111111111111112,0
43,84,0.512,21,40,0.525,14,20,0.7,8,36,44,26,4,1,17,20,22,44,0.5,1
37,79,0.468,13,35,0.371,14,18,0.778,5,34,39,22,8,6,20,19,24,44,0.5454545454545454,0
43,86,0.5,14,27,0.519,13,17,0.765,6,34,40,29,8,1,18,19,29,59,0.4915254237288136,1
44,81,0.543,19,42,0.452,12,13,0.923,5,34,39,25,4,4,12,16,25,39,0.6410256410256411,0
44,93,0.473,22,47,0.468,15,17,0.882,13,30,43,17,5,0,6,15,22,46,0.4782608695652174,1
34,74,0.459,12,37,0.324,35,41,0.854,9,39,48,21,7,5,13,16,22,37,0.5945945945945946,1
40,83,0.482,21,44,0.477,11,14,0.786,3,28,31,31,9,4,11,28,19,39,0.48717948717948717,0
31,80,0.388,15,41,0.366,21,28,0.75,13,26,39,25,5,4,14,20,16,39,0.41025641025641024,0
45,86,0.523,12,34,0.353,23,23,1.0,9,33,42,26,9,1,10,25,33,52,0.6346153846153846,1
39,98,0.398,13,37,0.351,8,9,0.889,16,33,49,26,13,7,8,21,26,61,0.4262295081967213,1
34,81,0.42,8,26,0.308,18,24,0.75,13,39,52,18,6,3,16,16,26,55,0.4727272727272727,0
31,90,0.344,13,41,0.317,28,34,0.824,7,39,46,23,8,7,12,25,18,49,0.3673469387755102,0
37,95,0.389,10,32,0.313,27,31,0.871,13,47,60,25,8,5,12,22,27,63,0.42857142857142855,1
46,96,0.479,12,33,0.364,9,10,0.9,5,36,41,29,6,4,9,11,34,63,0.5396825396825397,0
45,92,0.489,14,38,0.368,16,18,0.889,6,43,49,24,5,3,11,11,31,54,0.5740740740740741,1
39,85,0.459,10,28,0.357,17,27,0.63,4,29,33,28,4,2,8,21,29,57,0.5087719298245614,0
48,86,0.558,11,23,0.478,22,29,0.759,9,43,52,24,7,3,11,22,37,63,0.5873015873015873,1
32,84,0.381,11,34,0.324,21,30,0.7,9,35,44,20,6,4,6,13,21,50,0.42,0
40,88,0.455,23,55,0.418,9,9,1.0,7,38,45,27,6,3,10,21,17,33,0.5151515151515151,1
42,79,0.532,7,21,0.333,15,19,0.789,10,33,43,24,5,4,19,22,35,58,0.603448275862069,0
44,90,0.489,9,29,0.31,16,22,0.727,10,25,35,24,11,8,7,18,35,61,0.5737704918032787,1
37,95,0.389,15,46,0.326,16,19,0.842,9,28,37,19,13,3,14,26,22,49,0.4489795918367347,0
39,77,0.506,17,33,0.515,21,28,0.75,7,47,54,29,8,4,27,19,22,44,0.5,1
41,85,0.482,8,28,0.286,23,30,0.767,14,31,45,26,8,7,16,12,33,57,0.5789473684210527,1
44,88,0.5,12,34,0.353,8,10,0.8,10,27,37,30,9,5,15,28,32,54,0.5925925925925926,0
37,80,0.463,14,28,0.5,12,14,0.857,9,43,52,26,8,8,21,22,23,52,0.4423076923076923,1
32,82,0.39,4,25,0.16,18,25,0.72,8,29,37,20,11,5,15,16,28,57,0.49122807017543857,0
42,91,0.462,13,39,0.333,17,25,0.68,19,33,52,22,8,2,18,21,29,52,0.5576923076923077,1
39,79,0.494,14,38,0.368,20,27,0.741,8,30,38,22,7,4,16,20,25,41,0.6097560975609756,0
38,98,0.388,15,45,0.333,18,20,0.9,13,37,50,27,8,10,15,22,23,53,0.4339622641509434,1
39,97,0.402,9,37,0.243,19,23,0.826,13,38,51,27,7,7,16,19,30,60,0.5,0
38,82,0.463,11,25,0.44,14,23,0.609,8,36,44,19,12,9,20,18,27,57,0.47368421052631576,1
38,88,0.432,11,24,0.458,13,23,0.565,13,31,44,16,13,2,17,19,27,64,0.421875,0
35,85,0.412,5,25,0.2,19,28,0.679,7,34,41,20,3,2,11,18,30,60,0.5,0
42,87,0.483,9,32,0.281,18,23,0.783,9,42,51,30,7,6,11,24,33,55,0.6,1
48,86,0.558,19,37,0.514,17,20,0.85,8,44,52,23,4,3,11,17,29,49,0.5918367346938775,1
34,89,0.382,9,41,0.22,15,19,0.789,9,24,33,17,7,3,7,17,25,48,0.5208333333333334,0
45,92,0.489,17,39,0.436,13,15,0.867,10,36,46,25,9,10,9,16,28,53,0.5283018867924528,1
39,96,0.406,6,26,0.231,11,12,0.917,14,35,49,21,5,3,14,14,33,70,0.4714285714285714,0
49,90,0.544,13,30,0.433,8,12,0.667,10,39,49,26,6,7,17,17,36,60,0.6,1
41,96,0.427,4,17,0.235,19,23,0.826,10,29,39,22,13,4,10,11,37,79,0.46835443037974683,0
37,87,0.425,10,40,0.25,15,19,0.789,8,36,44,19,6,5,15,24,27,47,0.574468085106383,0
41,90,0.456,14,36,0.389,21,26,0.808,10,37,47,28,7,7,12,21,27,54,0.5,1
43,95,0.453,12,34,0.353,12,16,0.75,15,33,48,21,3,3,7,18,31,61,0.5081967213114754,0
42,85,0.494,17,38,0.447,18,20,0.9,8,36,44,26,4,7,8,16,25,47,0.5319148936170213,1
47,90,0.522,17,35,0.486,15,24,0.625,5,38,43,31,3,6,13,18,30,55,0.5454545454545454,0
55,110,0.5,12,35,0.343,10,15,0.667,17,37,54,38,8,6,10,20,43,75,0.5733333333333334,1
45,111,0.405,12,50,0.24,11,12,0.917,11,29,40,27,8,3,6,16,33,61,0.5409836065573771,0
53,94,0.564,24,39,0.615,10,15,0.667,8,47,55,35,3,5,16,16,29,55,0.5272727272727272,1
41,87,0.471,21,37,0.568,9,10,0.9,9,38,47,27,8,10,17,14,20,50,0.4,1
38,92,0.413,14,39,0.359,13,18,0.722,11,31,42,24,11,4,12,17,24,53,0.4528301886792453,0
34,81,0.42,12,32,0.375,20,23,0.87,7,33,40,27,5,7,15,14,22,49,0.4489795918367347,1
36,78,0.462,11,32,0.344,14,17,0.824,5,33,38,17,5,9,14,22,25,46,0.5434782608695652,0
39,86,0.453,7,24,0.292,23,35,0.657,13,38,51,15,5,4,14,24,32,62,0.5161290322580645,1
36,83,0.434,8,25,0.32,18,26,0.692,6,32,38,22,5,7,13,23,28,58,0.4827586206896552,0
45,91,0.495,12,37,0.324,8,9,0.889,8,31,39,29,5,6,7,18,33,54,0.6111111111111112,1
36,86,0.419,13,36,0.361,15,17,0.882,17,33,50,23,3,4,14,13,23,50,0.46,0
36,85,0.424,18,37,0.486,21,30,0.7,6,28,34,25,10,4,13,17,18,48,0.375,0
47,90,0.522,10,29,0.345,24,26,0.923,11,42,53,28,9,3,14,24,37,61,0.6065573770491803,1
38,79,0.481,9,23,0.391,28,35,0.8,7,31,38,25,5,5,17,23,29,56,0.5178571428571429,0
47,92,0.511,16,30,0.533,21,24,0.875,12,30,42,23,6,8,10,28,31,62,0.5,1
45,91,0.495,8,30,0.267,12,13,0.923,13,39,52,25,12,7,12,13,37,61,0.6065573770491803,1
39,88,0.443,11,34,0.324,10,14,0.714,9,28,37,27,8,4,13,12,28,54,0.5185185185185185,0
43,87,0.494,9,30,0.3,21,27,0.778,10,37,47,25,5,2,11,17,34,57,0.5964912280701754,1
36,90,0.4,19,55,0.345,21,23,0.913,13,31,44,25,4,5,8,20,17,35,0.4857142857142857,0
42,92,0.457,11,29,0.379,8,10,0.8,12,34,46,28,8,7,11,16,31,63,0.49206349206349204,1
37,83,0.446,8,28,0.286,12,14,0.857,10,35,45,21,6,4,15,12,29,55,0.5272727272727272,0
41,80,0.513,18,38,0.474,22,29,0.759,10,40,50,27,4,3,14,20,23,42,0.5476190476190477,1
33,86,0.384,16,49,0.327,15,22,0.682,10,29,39,24,6,2,7,19,17,37,0.4594594594594595,0
44,83,0.53,11,28,0.393,12,19,0.632,5,36,41,29,8,9,15,18,33,55,0.6,0
45,97,0.464,15,34,0.441,11,14,0.786,11,26,37,25,7,8,10,20,30,63,0.47619047619047616,1
45,94,0.479,19,47,0.404,10,10,1.0,9,29,38,24,9,6,13,15,26,47,0.5531914893617021,0
45,90,0.5,17,37,0.459,14,20,0.7,13,33,46,19,8,5,16,14,28,53,0.5283018867924528,1
48,99,0.485,16,44,0.364,16,22,0.727,14,39,53,27,5,6,10,22,32,55,0.5818181818181818,1
38,86,0.442,12,38,0.316,20,26,0.769,6,31,37,24,6,2,12,25,26,48,0.5416666666666666,0
47,99,0.475,11,30,0.367,11,13,0.846,14,42,56,19,12,10,18,10,36,69,0.5217391304347826,1
43,95,0.453,10,35,0.286,11,17,0.647,9,35,44,26,13,8,15,10,33,60,0.55,0
40,90,0.444,11,33,0.333,20,22,0.909,10,37,47,22,9,3,9,15,29,57,0.5087719298245614,0
42,90,0.467,13,37,0.351,15,19,0.789,9,40,49,18,3,5,11,18,29,53,0.5471698113207547,1
41,85,0.482,7,25,0.28,19,23,0.826,11,31,42,17,5,3,13,20,34,60,0.5666666666666667,0
40,84,0.476,10,30,0.333,20,22,0.909,12,30,42,21,5,6,16,16,30,54,0.5555555555555556,1
49,88,0.557,17,33,0.515,19,30,0.633,5,39,44,23,10,3,8,20,32,55,0.5818181818181818,1
39,85,0.459,7,22,0.318,16,19,0.842,6,34,40,22,6,6,16,24,32,63,0.5079365079365079,0
41,98,0.418,14,43,0.326,15,18,0.833,17,29,46,25,5,2,12,19,27,55,0.4909090909090909,0
45,89,0.506,24,48,0.5,21,23,0.913,9,36,45,31,3,6,10,21,21,41,0.5121951219512195,1
35,97,0.361,7,35,0.2,11,15,0.733,13,35,48,19,9,1,9,10,28,62,0.45161290322580644,0
41,91,0.451,23,55,0.418,13,14,0.929,11,45,56,24,6,6,13,15,18,36,0.5,1
39,80,0.488,17,45,0.378,14,21,0.667,7,32,39,24,13,9,21,26,22,35,0.6285714285714286,1
34,78,0.436,9,26,0.346,24,33,0.727,7,35,42,22,10,0,22,19,25,52,0.4807692307692308,0
44,92,0.478,20,46,0.435,17,19,0.895,10,30,40,24,3,7,11,14,24,46,0.5217391304347826,1
47,84,0.56,16,34,0.471,12,13,0.923,5,34,39,34,3,7,11,18,31,50,0.62,0
37,80,0.463,8,26,0.308,20,33,0.606,8,38,46,26,8,9,17,32,29,54,0.5370370370370371,0
34,93,0.366,7,28,0.25,31,42,0.738,18,37,55,14,12,4,15,28,27,65,0.4153846153846154,1
45,88,0.511,17,32,0.531,12,12,1.0,7,31,38,24,4,0,12,19,28,56,0.5,0
53,89,0.596,19,38,0.5,16,19,0.842,5,33,38,28,6,4,6,13,34,51,0.6666666666666666,1
34,89,0.382,13,34,0.382,17,18,0.944,14,43,57,16,6,5,10,13,21,55,0.38181818181818183,1
33,82,0.402,8,23,0.348,11,13,0.846,2,37,39,16,4,6,7,14,25,59,0.423728813559322,0
40,87,0.46,15,43,0.349,10,20,0.5,9,30,39,28,9,3,10,17,25,44,0.5681818181818182,0
39,79,0.494,18,43,0.419,14,19,0.737,6,36,42,30,6,7,16,16,21,36,0.5833333333333334,1
38,87,0.437,20,47,0.426,13,18,0.722,13,36,49,26,9,10,12,17,18,40,0.45,1
39,95,0.411,8,35,0.229,8,14,0.571,15,36,51,17,4,4,16,18,31,60,0.5166666666666667,0
37,84,0.44,13,33,0.394,26,34,0.765,16,33,49,19,3,4,10,27,24,51,0.47058823529411764,1
33,73,0.452,11,31,0.355,34,47,0.723,7,29,36,19,6,4,11,30,22,42,0.5238095238095238,0
46,84,0.548,13,33,0.394,19,24,0.792,8,37,45,31,6,5,10,23,33,51,0.6470588235294118,1
39,79,0.494,12,28,0.429,18,26,0.692,5,28,33,29,7,4,13,22,27,51,0.5294117647058824,0
31,80,0.388,5,26,0.192,19,28,0.679,10,27,37,24,11,4,21,19,26,54,0.48148148148148145,0
38,78,0.487,6,26,0.231,18,25,0.72,9,36,45,23,15,3,23,23,32,52,0.6153846153846154,1
43,88,0.489,22,47,0.468,14,16,0.875,8,36,44,27,10,8,15,16,21,41,0.5121951219512195,1
44,99,0.444,19,47,0.404,7,11,0.636,16,33,49,24,7,3,16,16,25,52,0.4807692307692308,0
37,87,0.425,17,44,0.386,10,13,0.769,7,40,47,26,5,9,21,20,20,43,0.46511627906976744,0
39,103,0.379,10,38,0.263,19,24,0.792,14,36,50,30,12,3,9,13,29,65,0.4461538461538462,1
47,93,0.505,14,28,0.5,5,7,0.714,11,25,36,28,7,7,8,16,33,65,0.5076923076923077,1
39,78,0.5,12,29,0.414,18,20,0.9,6,31,37,30,7,7,15,11,27,49,0.5510204081632653,0
40,85,0.471,18,40,0.45,14,21,0.667,10,36,46,21,7,9,16,18,22,45,0.4888888888888889,1
42,95,0.442,12,27,0.444,9,17,0.529,11,29,40,29,7,5,12,18,30,68,0.4411764705882353,0
43,90,0.478,9,36,0.25,9,9,1.0,9,38,47,26,4,3,13,16,34,54,0.6296296296296297,1
37,90,0.411,12,45,0.267,14,16,0.875,7,31,38,20,5,4,12,17,25,45,0.5555555555555556,0
44,97,0.454,12,30,0.4,14,18,0.778,12,36,48,27,3,2,7,14,32,67,0.47761194029850745,0
45,98,0.459,12,33,0.364,15,18,0.833,14,37,51,25,5,4,7,15,33,65,0.5076923076923077,1
39,77,0.506,10,26,0.385,24,33,0.727,8,30,38,17,5,2,16,27,29,51,0.5686274509803921,0
45,85,0.529,11,26,0.423,21,27,0.778,9,29,38,26,9,3,12,25,34,59,0.576271186440678,1
40,93,0.43,16,44,0.364,6,8,0.75,12,32,44,28,9,11,16,19,24,49,0.4897959183673469,1
36,87,0.414,14,36,0.389,10,16,0.625,15,33,48,21,11,7,16,11,22,51,0.43137254901960786,0
50,92,0.543,18,39,0.462,11,13,0.846,10,31,41,29,7,7,12,24,32,53,0.6037735849056604,1
36,85,0.424,13,40,0.325,22,28,0.786,10,30,40,26,8,6,13,15,23,45,0.5111111111111111,0
37,83,0.446,10,31,0.323,19,24,0.792,10,28,38,19,2,4,7,20,27,52,0.5192307692307693,0
42,81,0.519,9,26,0.346,19,29,0.655,8,34,42,20,2,5,7,18,33,55,0.6,1
44,96,0.458,12,38,0.316,11,14,0.786,10,42,52,22,10,4,12,19,32,58,0.5517241379310345,1
34,83,0.41,11,38,0.289,15,24,0.625,10,40,50,16,7,4,18,12,23,45,0.5111111111111111,0
37,84,0.44,9,26,0.346,15,23,0.652,7,29,36,20,11,2,10,13,28,58,0.4827586206896552,0
41,80,0.513,7,30,0.233,11,14,0.786,7,37,44,16,4,9,18,20,34,50,0.68,1
41,95,0.432,8,34,0.235,14,18,0.778,11,37,48,28,6,3,14,25,33,61,0.5409836065573771,0
46,85,0.541,10,25,0.4,18,28,0.643,4,37,41,29,9,7,11,15,36,60,0.6,1
39,97,0.402,9,33,0.273,23,30,0.767,16,31,47,24,16,2,15,14,30,64,0.46875,0
46,92,0.5,19,45,0.422,15,20,0.75,13,39,52,22,8,8,22,22,27,47,0.574468085106383,1
33,85,0.388,10,29,0.345,16,19,0.842,7,36,43,19,9,5,19,18,23,56,0.4107142857142857,0
44,91,0.484,9,21,0.429,9,9,1.0,7,41,48,24,7,5,18,22,35,70,0.5,1
34,96,0.354,8,40,0.2,25,29,0.862,21,29,50,17,15,2,14,17,26,56,0.4642857142857143,1
34,85,0.4,13,43,0.302,16,23,0.696,16,36,52,16,8,3,21,23,21,42,0.5,0
36,76,0.474,12,34,0.353,18,21,0.857,2,29,31,18,7,3,12,16,24,42,0.5714285714285714,0
50,92,0.543,15,36,0.417,11,16,0.688,15,34,49,32,7,3,10,15,35,56,0.625,1
34,88,0.386,11,33,0.333,14,17,0.824,10,41,51,19,5,4,11,18,23,55,0.41818181818181815,0
34,82,0.415,11,40,0.275,17,23,0.739,8,44,52,25,9,5,12,17,23,42,0.5476190476190477,1
46,97,0.474,10,34,0.294,20,24,0.833,13,34,47,24,7,11,8,25,36,63,0.5714285714285714,1
39,87,0.448,14,42,0.333,25,33,0.758,12,33,45,17,3,6,13,20,25,45,0.5555555555555556,0
41,82,0.5,16,31,0.516,17,30,0.567,8,39,47,30,8,2,15,21,25,51,0.49019607843137253,1
40,93,0.43,14,43,0.326,15,19,0.789,12,34,46,21,5,9,14,25,26,50,0.52,0
40,103,0.388,14,44,0.318,13,17,0.765,17,34,51,23,10,10,15,25,26,59,0.4406779661016949,0
40,85,0.471,10,30,0.333,22,25,0.88,7,43,50,31,10,7,16,18,30,55,0.5454545454545454,1
35,86,0.407,11,36,0.306,23,28,0.821,11,28,39,21,5,6,13,25,24,50,0.48,0
38,75,0.507,15,30,0.5,27,34,0.794,9,34,43,26,6,6,19,24,23,45,0.5111111111111111,1
44,84,0.524,6,24,0.25,8,11,0.727,8,31,39,33,8,5,20,18,38,60,0.6333333333333333,0
46,92,0.5,16,38,0.421,8,9,0.889,10,29,39,28,9,8,15,14,30,54,0.5555555555555556,1
46,85,0.541,11,31,0.355,17,24,0.708,7,40,47,31,8,4,16,18,35,54,0.6481481481481481,1
40,94,0.426,11,42,0.262,19,22,0.864,10,32,42,28,9,5,12,18,29,52,0.5576923076923077,0
38,81,0.469,11,30,0.367,18,21,0.857,5,27,32,18,8,4,12,14,27,51,0.5294117647058824,0
51,95,0.537,19,34,0.559,8,10,0.8,13,33,46,25,5,2,14,15,32,61,0.5245901639344263,1
37,86,0.43,10,34,0.294,14,17,0.824,12,35,47,22,7,5,12,18,27,52,0.5192307692307693,1
33,80,0.413,10,36,0.278,12,20,0.6,6,35,41,15,4,6,14,19,23,44,0.5227272727272727,0
51,96,0.531,16,44,0.364,9,13,0.692,8,35,43,30,11,3,9,21,35,52,0.6730769230769231,1
38,81,0.469,9,26,0.346,21,33,0.636,10,37,47,17,8,4,16,14,29,55,0.5272727272727272,0
47,84,0.56,18,36,0.5,20,25,0.8,4,33,37,29,9,6,7,15,29,48,0.6041666666666666,1
47,93,0.505,10,27,0.37,11,14,0.786,12,29,41,24,5,4,11,18,37,66,0.5606060606060606,0
29,83,0.349,7,34,0.206,10,16,0.625,6,34,40,17,5,5,10,18,22,49,0.4489795918367347,0
38,82,0.463,19,41,0.463,19,23,0.826,9,46,55,29,6,5,12,14,19,41,0.4634146341463415,1
44,93,0.473,12,30,0.4,24,33,0.727,7,30,37,32,11,6,14,18,32,63,0.5079365079365079,0
55,99,0.556,10,19,0.526,12,18,0.667,12,43,55,30,5,8,19,24,45,80,0.5625,1
35,82,0.427,11,35,0.314,14,15,0.933,5,29,34,18,14,6,12,18,24,47,0.5106382978723404,0
39,81,0.481,12,31,0.387,14,17,0.824,9,42,51,26,9,6,20,16,27,50,0.54,1
38,92,0.413,5,17,0.294,22,25,0.88,15,35,50,23,10,6,9,13,33,75,0.44,1
37,89,0.416,12,37,0.324,10,10,1.0,12,36,48,25,3,4,17,21,25,52,0.4807692307692308,0
41,85,0.482,13,32,0.406,15,21,0.714,6,30,36,30,9,1,7,17,28,53,0.5283018867924528,0
45,88,0.511,12,32,0.375,15,18,0.833,11,38,49,27,6,1,14,14,33,56,0.5892857142857143,1
42,90,0.467,14,34,0.412,16,19,0.842,9,41,50,24,6,6,14,17,28,56,0.5,1
41,100,0.41,10,37,0.27,12,15,0.8,15,36,51,22,5,1,13,19,31,63,0.49206349206349204,0
38,77,0.494,19,39,0.487,18,25,0.72,4,39,43,20,6,4,20,18,19,38,0.5,1
39,94,0.415,11,47,0.234,19,23,0.826,8,28,36,20,11,2,9,19,28,47,0.5957446808510638,0
39,78,0.5,13,40,0.325,17,24,0.708,6,25,31,22,5,8,13,21,26,38,0.6842105263157895,0
44,90,0.489,13,36,0.361,19,19,1.0,12,33,45,25,6,3,12,21,31,54,0.5740740740740741,1
42,82,0.512,16,30,0.533,24,26,0.923,6,37,43,27,11,7,13,20,26,52,0.5,1
40,86,0.465,9,27,0.333,12,17,0.706,5,31,36,29,7,7,17,26,31,59,0.5254237288135594,0
32,78,0.41,10,32,0.313,18,28,0.643,8,34,42,22,5,4,12,14,22,46,0.4782608695652174,1
34,85,0.4,11,37,0.297,8,12,0.667,11,37,48,23,7,4,15,23,23,48,0.4791666666666667,0
42,79,0.532,14,26,0.538,14,18,0.778,7,35,42,23,13,8,22,17,28,53,0.5283018867924528,1
35,87,0.402,10,36,0.278,17,22,0.773,11,29,40,22,9,5,22,22,25,51,0.49019607843137253,0
38,89,0.427,16,49,0.327,19,25,0.76,11,35,46,20,10,5,15,21,22,40,0.55,1
42,90,0.467,5,18,0.278,18,23,0.783,11,35,46,23,10,4,11,20,37,72,0.5138888888888888,0
39,82,0.476,11,23,0.478,12,17,0.706,7,34,41,20,7,6,17,18,28,59,0.4745762711864407,0
36,87,0.414,14,40,0.35,16,19,0.842,9,31,40,25,9,8,13,14,22,47,0.46808510638297873,1
35,90,0.389,16,46,0.348,17,20,0.85,7,28,35,21,13,7,7,25,19,44,0.4318181818181818,0
39,86,0.453,14,33,0.424,21,28,0.75,19,45,64,19,2,6,20,16,25,53,0.4716981132075472,1
43,99,0.434,11,33,0.333,19,21,0.905,18,32,50,27,6,4,10,20,32,66,0.48484848484848486,0
46,81,0.568,11,25,0.44,18,24,0.75,4,28,32,29,6,7,10,21,35,56,0.625,1
39,92,0.424,11,35,0.314,17,19,0.895,11,32,43,22,7,5,12,20,28,57,0.49122807017543857,0
43,92,0.467,10,26,0.385,24,34,0.706,14,40,54,24,9,2,11,17,33,66,0.5,1
30,86,0.349,13,38,0.342,16,19,0.842,11,32,43,22,11,5,12,9,17,48,0.3541666666666667,0
44,91,0.484,20,45,0.444,3,4,0.75,13,43,56,34,8,5,15,18,24,46,0.5217391304347826,1
40,93,0.43,15,37,0.405,19,25,0.76,12,43,55,27,11,8,10,19,25,56,0.44642857142857145,1
34,80,0.425,10,35,0.286,16,21,0.762,4,36,40,26,5,3,18,24,24,45,0.5333333333333333,0
40,85,0.471,5,19,0.263,6,19,0.316,4,36,40,25,6,6,15,21,35,66,0.5303030303030303,0
45,94,0.479,12,29,0.414,18,22,0.818,10,38,48,31,8,5,13,18,33,65,0.5076923076923077,1
39,81,0.481,13,25,0.52,10,14,0.714,7,31,38,28,6,5,13,16,26,56,0.4642857142857143,1
35,85,0.412,10,34,0.294,14,16,0.875,13,32,45,17,6,5,12,19,25,51,0.49019607843137253,0
36,82,0.439,15,37,0.405,22,25,0.88,12,34,46,23,7,3,20,26,21,45,0.4666666666666667,0
39,82,0.476,13,39,0.333,25,30,0.833,5,32,37,30,10,6,12,22,26,43,0.6046511627906976,1
45,106,0.425,5,25,0.2,20,23,0.87,12,36,48,20,17,5,11,20,40,81,0.49382716049382713,1
41,93,0.441,12,29,0.414,16,19,0.842,12,43,55,26,7,7,25,23,29,64,0.453125,0
50,100,0.5,13,24,0.542,21,26,0.808,10,47,57,28,3,9,12,22,37,76,0.4868421052631579,1
49,110,0.445,13,40,0.325,18,24,0.75,11,35,46,25,8,6,6,22,36,70,0.5142857142857142,0
37,86,0.43,12,36,0.333,16,26,0.615,10,30,40,26,6,1,14,11,25,50,0.5,0
46,88,0.523,17,41,0.415,9,12,0.75,11,39,50,35,9,7,15,22,29,47,0.6170212765957447,1
43,95,0.453,8,31,0.258,20,29,0.69,11,33,44,27,16,3,10,16,35,64,0.546875,1
38,82,0.463,10,33,0.303,11,19,0.579,9,39,48,29,7,6,20,21,28,49,0.5714285714285714,0
38,85,0.447,12,33,0.364,20,23,0.87,5,34,39,21,6,6,11,20,26,52,0.5,0
42,95,0.442,19,39,0.487,17,25,0.68,14,39,53,26,8,4,12,20,23,56,0.4107142857142857,1
49,87,0.563,13,29,0.448,15,21,0.714,6,36,42,25,10,9,15,23,36,58,0.6206896551724138,1
38,88,0.432,8,29,0.276,19,23,0.826,5,29,34,22,7,6,15,18,30,59,0.5084745762711864,0
41,88,0.466,12,37,0.324,5,10,0.5,4,43,47,19,6,2,10,12,29,51,0.5686274509803921,1
32,89,0.36,12,38,0.316,10,10,1.0,9,34,43,18,7,3,12,17,20,51,0.39215686274509803,0
35,89,0.393,15,38,0.395,18,23,0.783,11,27,38,19,6,3,16,17,20,51,0.39215686274509803,0
54,90,0.6,15,33,0.455,17,21,0.81,6,35,41,36,12,8,10,20,39,57,0.6842105263157895,1
49,90,0.544,12,39,0.308,17,19,0.895,4,46,50,25,7,5,15,18,37,51,0.7254901960784313,1
36,99,0.364,21,54,0.389,16,22,0.727,13,32,45,19,11,3,14,18,15,45,0.3333333333333333,0
43,91,0.473,17,33,0.515,12,20,0.6,13,42,55,26,10,2,17,19,26,58,0.4482758620689655,1
36,85,0.424,10,35,0.286,12,16,0.75,6,32,38,24,8,5,15,16,26,50,0.52,0
26,79,0.329,11,34,0.324,14,18,0.778,7,31,38,19,5,4,21,18,15,45,0.3333333333333333,0
47,88,0.534,15,35,0.429,21,25,0.84,10,43,53,26,14,8,12,17,32,53,0.6037735849056604,1
43,89,0.483,7,28,0.25,13,17,0.765,7,34,41,26,5,3,7,19,36,61,0.5901639344262295,0
37,79,0.468,13,36,0.361,26,27,0.963,6,37,43,16,6,5,11,18,24,43,0.5581395348837209,1
43,79,0.544,19,39,0.487,20,27,0.741,7,37,44,31,12,11,7,18,24,40,0.6,1
29,82,0.354,9,28,0.321,14,20,0.7,12,31,43,20,4,4,15,20,20,54,0.37037037037037035,0
35,74,0.473,10,31,0.323,21,25,0.84,5,30,35,25,7,4,16,15,25,43,0.5813953488372093,0
44,82,0.537,15,38,0.395,12,16,0.75,4,33,37,35,6,3,11,20,29,44,0.6590909090909091,1
35,78,0.449,12,36,0.333,31,36,0.861,6,30,36,17,7,5,11,24,23,42,0.5476190476190477,0
41,81,0.506,12,28,0.429,28,37,0.757,8,34,42,26,7,7,12,24,29,53,0.5471698113207547,1
30,85,0.353,8,34,0.235,17,24,0.708,12,34,46,17,4,6,22,21,22,51,0.43137254901960786,0
51,104,0.49,20,46,0.435,11,14,0.786,15,41,56,25,13,3,9,18,31,58,0.5344827586206896,1
50,93,0.538,11,31,0.355,18,20,0.9,12,35,47,31,10,3,13,15,39,62,0.6290322580645161,1
49,99,0.495,17,39,0.436,13,13,1.0,12,28,40,31,7,4,12,17,32,60,0.5333333333333333,0
52,94,0.553,12,29,0.414,23,26,0.885,11,33,44,27,10,6,14,22,40,65,0.6153846153846154,1
48,99,0.485,10,29,0.345,27,32,0.844,18,28,46,22,6,6,18,21,38,70,0.5428571428571428,0
32,87,0.368,2,23,0.087,25,31,0.806,9,30,39,11,5,4,11,14,30,64,0.46875,0
51,92,0.554,26,55,0.473,9,12,0.75,7,43,50,34,10,6,11,25,25,37,0.6756756756756757,1
40,90,0.444,10,30,0.333,19,24,0.792,14,36,50,17,7,4,8,22,30,60,0.5,1
35,86,0.407,5,25,0.2,12,15,0.8,9,35,44,12,4,3,14,21,30,61,0.4918032786885246,0
43,92,0.467,10,40,0.25,15,21,0.714,9,36,45,25,12,6,16,26,33,52,0.6346153846153846,0
35,81,0.432,12,32,0.375,35,45,0.778,10,39,49,19,10,3,15,19,23,49,0.46938775510204084,1
32,80,0.4,10,31,0.323,12,20,0.6,9,33,42,23,3,5,17,15,22,49,0.4489795918367347,0
43,94,0.457,21,54,0.389,9,11,0.818,14,30,44,29,11,5,6,20,22,40,0.55,1
45,93,0.484,11,28,0.393,6,7,0.857,4,31,35,28,3,3,5,17,34,65,0.5230769230769231,0
43,78,0.551,8,22,0.364,21,30,0.7,6,34,40,29,4,3,9,11,35,56,0.625,1
42,89,0.472,13,35,0.371,12,17,0.706,10,26,36,27,11,4,12,26,29,54,0.5370370370370371,0
43,88,0.489,9,29,0.31,24,31,0.774,19,35,54,27,6,5,15,14,34,59,0.576271186440678,1
42,91,0.462,16,37,0.432,22,35,0.629,16,39,55,26,12,9,15,27,26,54,0.48148148148148145,1
41,89,0.461,16,40,0.4,17,24,0.708,9,39,48,25,3,3,17,24,25,49,0.5102040816326531,0
32,80,0.4,7,23,0.304,15,20,0.75,7,29,36,16,9,7,19,11,25,57,0.43859649122807015,0
41,86,0.477,14,28,0.5,8,9,0.889,13,37,50,23,10,4,20,25,27,58,0.46551724137931033,1
44,89,0.494,16,38,0.421,12,15,0.8,10,39,49,30,6,10,12,23,28,51,0.5490196078431373,1
37,89,0.416,8,34,0.235,18,28,0.643,16,34,50,23,4,6,11,19,29,55,0.5272727272727272,0
40,86,0.465,14,29,0.483,18,22,0.818,5,36,41,24,7,4,12,25,26,57,0.45614035087719296,0
42,92,0.457,10,32,0.313,20,26,0.769,11,34,45,27,6,6,10,14,32,60,0.5333333333333333,1
37,88,0.42,12,44,0.273,17,22,0.773,14,34,48,20,3,4,9,18,25,44,0.5681818181818182,0
41,91,0.451,23,49,0.469,6,8,0.75,10,34,44,22,2,2,10,18,18,42,0.42857142857142855,1
44,86,0.512,18,37,0.486,27,31,0.871,6,31,37,29,11,3,11,22,26,49,0.5306122448979592,1
43,79,0.544,17,33,0.515,27,33,0.818,5,33,38,28,6,3,18,25,26,46,0.5652173913043478,0
39,88,0.443,9,36,0.25,19,24,0.792,10,32,42,27,9,8,15,19,30,52,0.5769230769230769,0
38,91,0.418,12,32,0.375,28,33,0.848,15,36,51,22,10,4,14,16,26,59,0.4406779661016949,1
49,95,0.516,13,28,0.464,21,24,0.875,13,37,50,32,10,7,14,20,36,67,0.5373134328358209,1
41,97,0.423,5,27,0.185,21,25,0.84,13,29,42,17,10,6,15,20,36,70,0.5142857142857142,0
45,86,0.523,12,34,0.353,23,27,0.852,7,40,47,29,5,4,9,24,33,52,0.6346153846153846,1
35,83,0.422,5,26,0.192,26,32,0.813,8,30,38,22,4,3,10,22,30,57,0.5263157894736842,0
37,94,0.394,12,35,0.343,15,18,0.833,15,39,54,21,7,5,18,18,25,59,0.423728813559322,0
44,94,0.468,7,33,0.212,8,11,0.727,6,39,45,22,11,9,13,20,37,61,0.6065573770491803,1
37,91,0.407,12,38,0.316,21,28,0.75,16,33,49,24,7,7,14,15,25,53,0.4716981132075472,0
44,88,0.5,20,31,0.645,15,22,0.682,10,32,42,24,7,6,11,23,24,57,0.42105263157894735,1
34,73,0.466,9,24,0.375,29,39,0.744,9,29,38,16,11,4,13,20,25,49,0.5102040816326531,1
33,70,0.471,14,34,0.412,16,18,0.889,3,29,32,19,5,6,22,22,19,36,0.5277777777777778,0
44,81,0.543,15,35,0.429,16,20,0.8,7,23,30,27,4,2,13,12,29,46,0.6304347826086957,0
56,94,0.596,14,31,0.452,8,9,0.889,13,31,44,36,7,5,11,20,42,63,0.6666666666666666,1
44,86,0.512,14,32,0.438,19,22,0.864,6,34,40,25,7,2,14,13,30,54,0.5555555555555556,0
46,96,0.479,15,40,0.375,15,17,0.882,12,30,42,28,6,5,11,18,31,56,0.5535714285714286,1
44,94,0.468,14,33,0.424,11,14,0.786,14,43,57,28,9,5,21,12,30,61,0.4918032786885246,1
38,88,0.432,9,30,0.3,12,16,0.75,6,27,33,20,15,12,15,17,29,58,0.5,0
37,92,0.402,11,36,0.306,31,37,0.838,14,34,48,18,4,5,7,22,26,56,0.4642857142857143,0
46,89,0.517,16,41,0.39,25,30,0.833,8,40,48,24,5,5,8,24,30,48,0.625,1
46,84,0.548,17,41,0.415,15,20,0.75,9,33,42,30,11,2,14,13,29,43,0.6744186046511628,1
44,82,0.537,13,33,0.394,11,18,0.611,7,28,35,34,9,4,14,16,31,49,0.6326530612244898,0
39,79,0.494,18,40,0.45,14,22,0.636,11,38,49,29,8,7,22,24,21,39,0.5384615384615384,1
36,91,0.396,5,33,0.152,24,30,0.8,15,27,42,17,13,3,12,19,31,58,0.5344827586206896,0
48,89,0.539,17,40,0.425,18,21,0.857,11,43,54,30,5,5,14,17,31,49,0.6326530612244898,1
45,101,0.446,10,28,0.357,13,15,0.867,11,31,42,26,5,3,7,19,35,73,0.4794520547945205,0
35,84,0.417,16,33,0.485,13,16,0.813,5,34,39,22,7,4,14,21,19,51,0.37254901960784315,0
36,86,0.419,15,40,0.375,14,20,0.7,16,37,53,22,6,7,20,14,21,46,0.45652173913043476,1
38,89,0.427,6,27,0.222,29,39,0.744,17,23,40,23,9,2,15,14,32,62,0.5161290322580645,0
51,92,0.554,19,41,0.463,18,22,0.818,10,35,45,37,10,8,17,31,32,51,0.6274509803921569,1
38,91,0.418,6,24,0.25,14,21,0.667,11,31,42,23,11,4,15,19,32,67,0.47761194029850745,0
40,91,0.44,8,26,0.308,18,24,0.75,12,41,53,26,10,6,19,18,32,65,0.49230769230769234,1
33,87,0.379,10,39,0.256,17,22,0.773,11,35,46,16,4,5,9,15,23,48,0.4791666666666667,0
38,88,0.432,17,44,0.386,9,16,0.563,10,39,49,21,7,5,11,18,21,44,0.4772727272727273,1
48,91,0.527,10,28,0.357,31,40,0.775,13,29,42,30,7,2,13,17,38,63,0.6031746031746031,0
55,93,0.591,14,28,0.5,17,19,0.895,7,28,35,32,6,7,13,28,41,65,0.6307692307692307,1
43,97,0.443,15,44,0.341,12,13,0.923,11,31,42,27,12,5,12,16,28,53,0.5283018867924528,1
37,85,0.435,16,41,0.39,12,17,0.706,11,35,46,29,4,5,22,11,21,44,0.4772727272727273,0
49,85,0.576,19,36,0.528,14,16,0.875,5,32,37,35,7,3,13,18,30,49,0.6122448979591837,1
44,93,0.473,12,31,0.387,16,23,0.696,11,28,39,22,11,3,11,16,32,62,0.5161290322580645,0
46,103,0.447,11,44,0.25,10,15,0.667,7,38,45,14,6,4,13,23,35,59,0.5932203389830508,0
45,101,0.446,11,34,0.324,16,20,0.8,16,45,61,20,7,5,14,21,34,67,0.5074626865671642,1
38,100,0.38,12,33,0.364,13,16,0.813,14,38,52,16,8,1,9,20,26,67,0.3880597014925373,0
43,97,0.443,17,45,0.378,13,18,0.722,15,41,56,23,6,8,11,15,26,52,0.5,1
36,71,0.507,6,24,0.25,25,30,0.833,9,27,36,20,6,6,15,18,30,47,0.6382978723404256,0
42,84,0.5,18,37,0.486,11,12,0.917,9,26,35,26,5,1,11,22,24,47,0.5106382978723404,1
35,79,0.443,12,35,0.343,22,25,0.88,10,30,40,26,9,3,22,24,23,44,0.5227272727272727,0
34,71,0.479,10,25,0.4,32,40,0.8,9,29,38,22,12,8,21,25,24,46,0.5217391304347826,1
48,94,0.511,13,37,0.351,20,24,0.833,9,35,44,35,8,3,7,12,35,57,0.6140350877192983,1
40,89,0.449,13,32,0.406,9,13,0.692,11,33,44,28,5,5,18,20,27,57,0.47368421052631576,0
44,84,0.524,8,23,0.348,17,20,0.85,7,36,43,24,7,4,16,24,36,61,0.5901639344262295,1
38,86,0.442,7,30,0.233,18,26,0.692,6,32,38,20,9,4,12,21,31,56,0.5535714285714286,0
47,87,0.54,12,30,0.4,16,18,0.889,12,37,49,35,5,3,16,16,35,57,0.6140350877192983,1
42,97,0.433,11,34,0.324,18,22,0.818,15,26,41,19,10,4,10,20,31,63,0.49206349206349204,0
38,96,0.396,13,48,0.271,14,18,0.778,9,32,41,18,3,5,6,21,25,48,0.5208333333333334,0
43,95,0.453,12,42,0.286,24,27,0.889,14,44,58,21,4,3,7,15,31,53,0.5849056603773585,1
41,86,0.477,13,33,0.394,13,14,0.929,8,30,38,25,6,1,13,17,28,53,0.5283018867924528,0
47,84,0.56,7,27,0.259,19,23,0.826,6,35,41,25,7,4,9,14,40,57,0.7017543859649122,1
47,96,0.49,15,42,0.357,27,30,0.9,9,28,37,30,14,0,15,26,32,54,0.5925925925925926,0
47,87,0.54,19,42,0.452,32,34,0.941,9,36,45,32,9,5,21,25,28,45,0.6222222222222222,1
43,93,0.462,9,27,0.333,24,28,0.857,11,27,38,33,10,2,9,21,34,66,0.5151515151515151,0
43,79,0.544,14,27,0.519,21,23,0.913,9,37,46,32,5,4,18,22,29,52,0.5576923076923077,1
43,89,0.483,5,19,0.263,19,24,0.792,11,36,47,30,6,1,18,16,38,70,0.5428571428571428,1
41,88,0.466,11,36,0.306,14,21,0.667,8,33,41,27,15,3,13,20,30,52,0.5769230769230769,0
39,83,0.47,12,37,0.324,19,27,0.704,12,29,41,28,3,6,14,15,27,46,0.5869565217391305,0
48,88,0.545,19,37,0.514,11,13,0.846,4,34,38,31,10,4,10,24,29,51,0.5686274509803921,1
44,91,0.484,19,50,0.38,20,22,0.909,13,36,49,35,4,10,20,19,25,41,0.6097560975609756,1
44,98,0.449,14,38,0.368,17,23,0.739,13,35,48,23,10,3,17,14,30,60,0.5,0
33,79,0.418,11,31,0.355,17,24,0.708,4,43,47,20,8,5,19,23,22,48,0.4583333333333333,0
39,90,0.433,4,22,0.182,19,30,0.633,10,46,56,22,11,7,14,17,35,68,0.5147058823529411,1
47,94,0.5,14,30,0.467,21,34,0.618,10,33,43,33,7,6,14,27,33,64,0.515625,0
45,96,0.469,14,32,0.438,29,33,0.879,11,37,48,24,7,7,14,25,31,64,0.484375,1
38,92,0.413,11,33,0.333,24,28,0.857,11,38,49,26,8,10,14,24,27,59,0.4576271186440678,1
38,90,0.422,6,24,0.25,24,31,0.774,12,38,50,23,3,8,15,22,32,66,0.48484848484848486,0
47,93,0.505,19,34,0.559,13,20,0.65,12,35,47,30,12,4,15,24,28,59,0.4745762711864407,1
35,80,0.438,5,27,0.185,26,30,0.867,9,33,42,19,6,10,19,20,30,53,0.5660377358490566,0
53,86,0.616,17,32,0.531,12,14,0.857,5,34,39,29,12,11,19,18,36,54,0.6666666666666666,1
39,86,0.453,15,35,0.429,22,26,0.846,7,25,32,27,11,5,17,13,24,51,0.47058823529411764,0
41,88,0.466,13,37,0.351,14,20,0.7,13,32,45,25,8,3,18,17,28,51,0.5490196078431373,0
49,91,0.538,14,35,0.4,13,16,0.813,9,36,45,31,13,5,16,19,35,56,0.625,1
44,94,0.468,12,38,0.316,17,25,0.68,13,34,47,24,11,10,10,17,32,56,0.5714285714285714,1
38,76,0.5,8,20,0.4,9,19,0.474,6,39,45,21,3,4,23,21,30,56,0.5357142857142857,0
39,84,0.464,9,25,0.36,19,28,0.679,7,42,49,27,2,1,16,12,30,59,0.5084745762711864,0
55,107,0.514,17,43,0.395,7,7,1.0,5,40,45,36,8,3,3,18,38,64,0.59375,1
37,83,0.446,9,26,0.346,20,28,0.714,9,29,38,25,9,6,12,23,28,57,0.49122807017543857,0
43,90,0.478,13,29,0.448,19,24,0.792,14,35,49,18,5,8,16,20,30,61,0.4918032786885246,1
42,88,0.477,14,42,0.333,14,22,0.636,4,34,38,23,8,4,10,23,28,46,0.6086956521739131,0
40,88,0.455,18,50,0.36,30,35,0.857,11,41,52,22,8,5,10,17,22,38,0.5789473684210527,1
38,84,0.452,17,39,0.436,12,16,0.75,7,34,41,27,7,1,12,11,21,45,0.4666666666666667,1
37,80,0.463,15,43,0.349,12,14,0.857,6,32,38,28,5,5,12,14,22,37,0.5945945945945946,0
44,86,0.512,7,24,0.292,21,26,0.808,14,36,50,30,9,3,16,16,37,62,0.5967741935483871,1
41,85,0.482,13,40,0.325,14,17,0.824,9,27,36,29,7,5,17,23,28,45,0.6222222222222222,0
45,83,0.542,8,21,0.381,21,27,0.778,10,31,41,20,10,7,15,20,37,62,0.5967741935483871,1
45,94,0.479,13,42,0.31,14,15,0.933,11,26,37,25,5,3,12,21,32,52,0.6153846153846154,0
39,87,0.448,7,33,0.212,20,23,0.87,10,42,52,20,4,7,11,18,32,54,0.5925925925925926,1
32,88,0.364,8,34,0.235,15,18,0.833,13,33,46,23,5,4,9,20,24,54,0.4444444444444444,0
46,87,0.529,15,32,0.469,17,19,0.895,12,19,31,33,12,4,13,24,31,55,0.5636363636363636,0
50,80,0.625,15,27,0.556,16,21,0.762,7,30,37,35,4,5,17,18,35,53,0.660377358490566,1
52,99,0.525,13,37,0.351,15,17,0.882,15,38,53,35,5,10,12,16,39,62,0.6290322580645161,1
53,115,0.461,6,20,0.3,13,19,0.684,24,26,50,27,11,6,6,12,47,95,0.49473684210526314,0
47,92,0.511,15,38,0.395,8,13,0.615,8,30,38,30,10,8,14,19,32,54,0.5925925925925926,0
40,81,0.494,16,36,0.444,25,25,1.0,3,33,36,27,7,6,15,14,24,45,0.5333333333333333,1
33,79,0.418,11,34,0.324,19,23,0.826,5,35,40,19,8,7,17,23,22,45,0.4888888888888889,0
35,88,0.398,9,35,0.257,23,27,0.852,11,35,46,19,9,4,13,19,26,53,0.49056603773584906,1
46,94,0.489,19,40,0.475,13,15,0.867,12,44,56,28,8,7,12,15,27,54,0.5,1
32,86,0.372,8,36,0.222,15,19,0.789,7,30,37,19,8,6,14,13,24,50,0.48,0
41,83,0.494,12,29,0.414,13,20,0.65,6,24,30,21,12,4,8,18,29,54,0.5370370370370371,1
37,77,0.481,11,35,0.314,13,19,0.684,8,33,41,21,5,5,17,16,26,42,0.6190476190476191,0
39,80,0.488,12,31,0.387,23,33,0.697,6,34,40,24,9,4,9,20,27,49,0.5510204081632653,1
35,83,0.422,9,36,0.25,16,20,0.8,11,35,46,16,7,3,15,24,26,47,0.5531914893617021,0
39,83,0.47,8,26,0.308,21,25,0.84,10,31,41,23,11,2,20,24,31,57,0.543859649122807,0
39,81,0.481,18,44,0.409,20,22,0.909,4,32,36,23,11,3,16,22,21,37,0.5675675675675675,1
36,86,0.419,5,31,0.161,13,17,0.765,8,32,40,23,8,3,17,16,31,55,0.5636363636363636,0
40,85,0.471,9,28,0.321,12,14,0.857,10,41,51,27,7,7,20,20,31,57,0.543859649122807,1
39,90,0.433,10,35,0.286,22,37,0.595,8,26,34,21,14,3,10,26,29,55,0.5272727272727272,0
42,77,0.545,6,19,0.316,27,39,0.692,9,42,51,24,8,5,23,23,36,58,0.6206896551724138,1
35,80,0.438,12,36,0.333,14,18,0.778,4,29,33,22,5,7,25,21,23,44,0.5227272727272727,0
42,89,0.472,5,27,0.185,22,27,0.815,15,32,47,18,14,9,15,20,37,62,0.5967741935483871,1
48,93,0.516,10,25,0.4,14,18,0.778,12,35,47,30,6,5,9,26,38,68,0.5588235294117647,1
36,80,0.45,5,20,0.25,20,32,0.625,11,33,44,15,6,2,15,17,31,60,0.5166666666666667,0
44,87,0.506,17,42,0.405,15,19,0.789,12,39,51,32,9,3,21,15,27,45,0.6,0
45,94,0.479,25,45,0.556,11,18,0.611,12,30,42,33,14,3,14,18,20,49,0.40816326530612246,1
47,90,0.522,9,19,0.474,22,28,0.786,8,36,44,29,7,4,8,27,38,71,0.5352112676056338,1
41,85,0.482,15,36,0.417,24,31,0.774,9,34,43,21,2,3,14,23,26,49,0.5306122448979592,0
34,82,0.415,16,44,0.364,17,18,0.944,8,30,38,24,9,2,11,18,18,38,0.47368421052631576,1
36,83,0.434,9,35,0.257,12,18,0.667,12,33,45,22,5,3,18,18,27,48,0.5625,0
48,89,0.539,13,28,0.464,17,19,0.895,6,42,48,34,10,5,14,20,35,61,0.5737704918032787,1
44,96,0.458,9,40,0.225,18,22,0.818,9,33,42,14,9,5,12,17,35,56,0.625,0
46,91,0.505,15,36,0.417,20,24,0.833,11,46,57,31,8,4,19,22,31,55,0.5636363636363636,1
30,87,0.345,13,49,0.265,24,33,0.727,11,33,44,16,13,12,14,20,17,38,0.4473684210526316,0
31,82,0.378,9,44,0.205,15,19,0.789,8,28,36,24,13,2,18,20,22,38,0.5789473684210527,0
38,82,0.463,13,42,0.31,17,18,0.944,9,39,48,28,11,2,21,18,25,40,0.625,1
42,90,0.467,15,35,0.429,17,24,0.708,9,37,46,30,5,4,10,19,27,55,0.4909090909090909,1
43,90,0.478,17,43,0.395,12,17,0.706,8,38,46,31,6,5,14,22,26,47,0.5531914893617021,0
40,84,0.476,13,30,0.433,15,22,0.682,8,31,39,21,7,2,14,16,27,54,0.5,1
42,88,0.477,10,39,0.256,9,13,0.692,6,36,42,16,7,4,13,19,32,49,0.6530612244897959,0
36,93,0.387,14,34,0.412,10,18,0.556,15,35,50,13,8,1,14,23,22,59,0.3728813559322034,0
36,86,0.419,17,47,0.362,17,20,0.85,11,40,51,24,6,10,14,18,19,39,0.48717948717948717,1
44,89,0.494,12,27,0.444,15,20,0.75,13,33,46,29,8,10,7,15,32,62,0.5161290322580645,1
41,86,0.477,17,37,0.459,7,9,0.778,7,33,40,23,7,6,12,16,24,49,0.4897959183673469,0
37,76,0.487,13,31,0.419,16,19,0.842,9,38,47,27,9,7,16,11,24,45,0.5333333333333333,1
34,84,0.405,16,44,0.364,6,12,0.5,10,28,38,23,8,5,13,18,18,40,0.45,0
39,79,0.494,13,32,0.406,15,18,0.833,4,26,30,29,7,8,8,13,26,47,0.5531914893617021,0
48,89,0.539,17,36,0.472,10,13,0.769,11,32,43,32,5,7,11,19,31,53,0.5849056603773585,1
37,93,0.398,7,29,0.241,19,21,0.905,15,32,47,10,8,2,11,20,30,64,0.46875,1
37,85,0.435,7,24,0.292,17,22,0.773,11,35,46,17,5,4,16,21,30,61,0.4918032786885246,0
50,94,0.532,15,36,0.417,17,22,0.773,11,37,48,28,10,6,18,16,35,58,0.603448275862069,1
48,104,0.462,10,34,0.294,18,22,0.818,16,31,47,22,12,6,15,17,38,70,0.5428571428571428,0
44,88,0.5,13,40,0.325,13,17,0.765,8,37,45,25,4,3,11,17,31,48,0.6458333333333334,1
42,90,0.467,13,34,0.382,16,21,0.762,11,34,45,27,7,3,7,18,29,56,0.5178571428571429,0
46,98,0.469,19,40,0.475,19,23,0.826,7,45,52,26,14,4,16,20,27,58,0.46551724137931033,1
34,92,0.37,15,41,0.366,22,31,0.71,10,37,47,22,13,7,16,17,19,51,0.37254901960784315,0
44,97,0.454,17,33,0.515,11,13,0.846,11,37,48,19,6,5,6,17,27,64,0.421875,1
40,88,0.455,6,28,0.214,20,24,0.833,9,40,49,25,3,5,9,12,34,60,0.5666666666666667,0
52,95,0.547,24,47,0.511,19,23,0.826,9,32,41,39,12,6,14,20,28,48,0.5833333333333334,1
44,92,0.478,7,27,0.259,14,25,0.56,17,33,50,22,6,2,21,22,37,65,0.5692307692307692,0
43,83,0.518,4,21,0.19,27,30,0.9,11,32,43,23,6,3,16,21,39,62,0.6290322580645161,0
45,87,0.517,13,28,0.464,20,25,0.8,4,28,32,23,8,9,10,21,32,59,0.5423728813559322,1
47,90,0.522,7,24,0.292,22,27,0.815,14,42,56,23,12,3,26,18,40,66,0.6060606060606061,1
42,91,0.462,9,27,0.333,18,24,0.75,5,25,30,22,17,8,17,22,33,64,0.515625,0
38,89,0.427,17,39,0.436,19,27,0.704,12,29,41,26,6,7,13,19,21,50,0.42,0
41,88,0.466,14,30,0.467,21,25,0.84,13,41,54,21,8,5,16,19,27,58,0.46551724137931033,1
46,95,0.484,16,43,0.372,12,17,0.706,14,37,51,25,8,1,9,16,30,52,0.5769230769230769,1
39,86,0.453,14,34,0.412,17,19,0.895,8,31,39,23,5,4,12,15,25,52,0.4807692307692308,0
47,92,0.511,17,46,0.37,8,10,0.8,9,38,47,33,9,5,16,24,30,46,0.6521739130434783,1
35,81,0.432,10,31,0.323,21,27,0.778,8,31,39,21,11,2,15,20,25,50,0.5,0
48,85,0.565,14,32,0.438,11,13,0.846,7,41,48,33,4,6,21,20,34,53,0.6415094339622641,1
44,98,0.449,12,37,0.324,13,19,0.684,11,25,36,28,12,2,8,16,32,61,0.5245901639344263,0
43,78,0.551,14,30,0.467,14,19,0.737,4,28,32,22,7,4,15,16,29,48,0.6041666666666666,0
48,86,0.558,14,38,0.368,12,14,0.857,10,29,39,30,9,4,11,18,34,48,0.7083333333333334,1
44,83,0.53,12,34,0.353,15,20,0.75,8,29,37,26,12,3,19,18,32,49,0.6530612244897959,0
47,85,0.553,21,41,0.512,15,16,0.938,7,30,37,35,12,5,18,17,26,44,0.5909090909090909,1
45,86,0.523,17,40,0.425,19,24,0.792,6,36,42,33,9,4,6,17,28,46,0.6086956521739131,1
45,96,0.469,13,34,0.382,12,15,0.8,13,33,46,34,3,1,12,20,32,62,0.5161290322580645,0
44,86,0.512,14,28,0.5,15,21,0.714,9,36,45,22,4,5,10,20,30,58,0.5172413793103449,1
40,91,0.44,15,45,0.333,14,19,0.737,10,31,41,30,6,7,9,17,25,46,0.5434782608695652,0
39,97,0.402,7,39,0.179,19,26,0.731,18,38,56,19,13,8,22,23,32,58,0.5517241379310345,0
38,90,0.422,10,35,0.286,24,34,0.706,15,39,54,22,13,7,18,24,28,55,0.509090909090909,1
46,94,0.489,9,31,0.29,27,31,0.871,18,36,54,22,11,3,9,15,37,63,0.5873015873015873,1
38,86,0.442,11,35,0.314,12,18,0.667,8,27,35,23,7,3,14,19,27,51,0.5294117647058824,0
39,80,0.488,14,34,0.412,19,26,0.731,7,26,33,33,11,5,14,28,25,46,0.5434782608695652,0
42,81,0.519,15,36,0.417,20,29,0.69,10,35,45,30,8,2,21,22,27,45,0.6,1
37,82,0.451,19,39,0.487,10,16,0.625,8,35,43,26,6,3,19,26,18,43,0.4186046511627907,0
35,83,0.422,14,44,0.318,22,30,0.733,11,35,46,21,13,7,13,19,21,39,0.5384615384615384,1
41,89,0.461,11,29,0.379,14,16,0.875,9,29,38,23,9,6,11,12,30,60,0.5,1
45,95,0.474,7,23,0.304,9,10,0.9,14,35,49,30,7,9,14,14,38,72,0.5277777777777778,0
35,77,0.455,8,23,0.348,24,34,0.706,6,29,35,20,8,4,11,14,27,54,0.5,0
41,82,0.5,14,35,0.4,17,18,0.944,8,34,42,24,6,10,17,24,27,47,0.574468085106383,1
41,105,0.39,13,39,0.333,16,17,0.941,14,29,43,23,13,3,10,19,28,66,0.42424242424242425,0
42,87,0.483,16,42,0.381,19,24,0.792,10,46,56,22,5,6,21,19,26,45,0.5777777777777777,1
40,97,0.412,7,28,0.25,28,33,0.848,11,45,56,26,11,7,16,22,33,69,0.4782608695652174,0
45,96,0.469,4,27,0.148,23,32,0.719,3,43,46,24,5,7,13,24,41,69,0.5942028985507246,1
41,80,0.513,17,40,0.425,15,20,0.75,8,32,40,22,6,2,18,23,24,40,0.6,0
44,94,0.468,15,46,0.326,16,20,0.8,14,31,45,18,9,2,9,18,29,48,0.6041666666666666,1
39,88,0.443,12,30,0.4,6,7,0.857,11,33,44,27,6,1,11,10,27,58,0.46551724137931033,0
41,82,0.5,16,40,0.4,8,9,0.889,4,34,38,30,6,2,10,15,25,42,0.5952380952380952,1
42,101,0.416,23,59,0.39,8,8,1.0,6,31,37,31,10,3,16,21,19,42,0.4523809523809524,0
48,93,0.516,11,33,0.333,20,23,0.87,11,41,52,26,8,8,15,14,37,60,0.6166666666666667,1
51,93,0.548,15,40,0.375,11,12,0.917,7,36,43,31,10,3,11,18,36,53,0.6792452830188679,1
39,91,0.429,16,47,0.34,21,27,0.778,13,32,45,27,7,1,16,8,23,44,0.5227272727272727,0
45,89,0.506,12,29,0.414,9,12,0.75,5,41,46,23,10,9,13,17,33,60,0.55,1
36,90,0.4,6,27,0.222,7,16,0.438,15,33,48,19,7,2,14,14,30,63,0.47619047619047616,0
37,84,0.44,9,27,0.333,17,23,0.739,9,36,45,19,7,6,18,20,28,57,0.49122807017543857,0
50,94,0.532,9,16,0.563,12,19,0.632,10,38,48,25,11,6,14,24,41,78,0.5256410256410257,1
45,92,0.489,10,32,0.313,17,20,0.85,8,33,41,33,7,5,12,27,35,60,0.5833333333333334,0
45,92,0.489,13,32,0.406,26,34,0.765,14,37,51,20,8,7,10,19,32,60,0.5333333333333333,1
36,91,0.396,10,36,0.278,19,28,0.679,13,34,47,18,7,3,9,17,26,55,0.4727272727272727,0
39,83,0.47,18,43,0.419,13,17,0.765,7,39,46,26,6,8,14,25,21,40,0.525,1
44,89,0.494,11,24,0.458,22,25,0.88,10,32,42,22,11,3,8,19,33,65,0.5076923076923077,1
39,87,0.448,16,48,0.333,13,20,0.65,10,32,42,15,3,8,14,20,23,39,0.5897435897435898,0
36,88,0.409,17,45,0.378,16,21,0.762,6,31,37,27,6,7,11,21,19,43,0.4418604651162791,0
45,89,0.506,21,42,0.5,13,17,0.765,8,40,48,31,6,3,15,26,24,47,0.5106382978723404,1
39,82,0.476,17,43,0.395,12,18,0.667,8,30,38,26,10,6,11,17,22,39,0.5641025641025641,0
38,87,0.437,16,39,0.41,17,21,0.81,16,37,53,28,9,1,17,13,22,48,0.4583333333333333,1
41,101,0.406,6,27,0.222,24,30,0.8,20,32,52,25,6,4,13,16,35,74,0.47297297297297297,0
45,95,0.474,11,29,0.379,21,24,0.875,13,36,49,27,9,6,13,26,34,66,0.5151515151515151,1
42,82,0.512,16,34,0.471,14,20,0.7,10,33,43,26,7,7,19,21,26,48,0.5416666666666666,1
41,91,0.451,11,32,0.344,17,19,0.895,9,27,36,28,10,5,15,19,30,59,0.5084745762711864,0
37,82,0.451,14,33,0.424,18,21,0.857,9,37,46,22,6,8,23,19,23,49,0.46938775510204084,0
37,96,0.385,17,38,0.447,21,24,0.875,16,31,47,23,9,5,15,15,20,58,0.3448275862068966,1
41,91,0.451,11,32,0.344,9,10,0.9,9,31,40,30,11,8,12,15,30,59,0.5084745762711864,1
36,77,0.468,10,25,0.4,14,15,0.933,3,36,39,21,8,3,16,15,26,52,0.5,0
51,107,0.477,17,40,0.425,18,24,0.75,10,37,47,33,15,3,15,24,34,67,0.5074626865671642,0
51,102,0.5,15,39,0.385,22,26,0.846,13,45,58,30,6,6,24,19,36,63,0.5714285714285714,1
42,86,0.488,5,26,0.192,16,20,0.8,9,30,39,24,9,8,18,21,37,60,0.6166666666666667,0
42,86,0.488,10,27,0.37,15,21,0.714,10,34,44,25,8,5,17,22,32,59,0.5423728813559322,1
36,84,0.429,8,28,0.286,29,35,0.829,9,48,57,27,4,4,12,23,28,56,0.5,1
34,104,0.327,8,34,0.235,18,27,0.667,14,40,54,20,4,7,7,27,26,70,0.37142857142857144,0
43,75,0.573,15,33,0.455,10,11,0.909,2,40,42,29,5,5,17,20,28,42,0.6666666666666666,1
34,79,0.43,12,28,0.429,17,25,0.68,5,27,32,17,10,1,10,14,22,51,0.43137254901960786,0
33,85,0.388,9,38,0.237,16,17,0.941,6,35,41,20,8,3,13,7,24,47,0.5106382978723404,0
45,93,0.484,19,48,0.396,4,7,0.571,11,41,52,31,7,5,15,19,26,45,0.5777777777777777,1
51,106,0.481,17,42,0.405,9,10,0.9,8,37,45,28,7,4,11,16,34,64,0.53125,1
49,102,0.48,11,34,0.324,18,19,0.947,9,42,51,19,7,3,12,15,38,68,0.5588235294117647,0
34,76,0.447,14,32,0.438,25,32,0.781,6,39,45,15,2,5,16,19,20,44,0.45454545454545453,1
35,89,0.393,12,32,0.375,14,18,0.778,10,32,42,26,9,6,13,21,23,57,0.40350877192982454,0
36,83,0.434,13,33,0.394,22,27,0.815,9,39,48,23,6,2,19,26,23,50,0.46,0
46,91,0.505,10,31,0.323,17,29,0.586,8,34,42,31,8,2,12,19,36,60,0.6,1
34,86,0.395,8,37,0.216,20,29,0.69,6,34,40,13,11,3,10,19,26,49,0.5306122448979592,0
39,94,0.415,9,34,0.265,25,29,0.862,18,47,65,20,6,3,14,22,30,60,0.5,1
49,89,0.551,14,37,0.378,22,28,0.786,10,34,44,30,7,2,13,21,35,52,0.6730769230769231,1
51,91,0.56,12,33,0.364,15,24,0.625,7,30,37,28,5,2,13,21,39,58,0.6724137931034483,0
39,86,0.453,16,39,0.41,3,8,0.375,11,28,39,26,6,3,13,10,23,47,0.48936170212765956,0
40,83,0.482,18,45,0.4,11,12,0.917,11,28,39,22,5,6,12,13,22,38,0.5789473684210527,1
45,90,0.5,11,38,0.289,12,15,0.8,10,35,45,24,3,3,10,15,34,52,0.6538461538461539,1
42,94,0.447,14,44,0.318,14,19,0.737,13,29,42,22,7,4,6,16,28,50,0.56,0
51,90,0.567,18,43,0.419,14,19,0.737,12,38,50,34,5,9,18,16,33,47,0.7021276595744681,1
44,97,0.454,18,42,0.429,14,16,0.875,13,26,39,28,10,3,11,17,26,55,0.4727272727272727,0
39,79,0.494,13,37,0.351,14,18,0.778,7,34,41,27,6,4,20,24,26,42,0.6190476190476191,0
45,88,0.511,16,36,0.444,15,19,0.789,9,32,41,27,8,1,12,19,29,52,0.5576923076923077,1
40,79,0.506,13,32,0.406,24,31,0.774,7,35,42,30,2,2,14,24,27,47,0.574468085106383,0
46,92,0.5,16,43,0.372,19,26,0.731,11,32,43,25,8,2,6,22,30,49,0.6122448979591837,1
41,90,0.456,17,46,0.37,13,16,0.813,9,52,61,27,7,4,12,16,24,44,0.5454545454545454,1
35,99,0.354,10,49,0.204,9,17,0.529,12,38,50,17,7,5,11,21,25,50,0.5,0
48,104,0.462,9,29,0.31,11,16,0.688,17,38,55,26,8,3,17,18,39,75,0.52,0
46,101,0.455,14,40,0.35,16,20,0.8,14,33,47,30,13,7,11,16,32,61,0.5245901639344263,1
38,84,0.452,13,30,0.433,16,23,0.696,11,31,42,19,6,8,13,29,25,54,0.46296296296296297,0
38,84,0.452,14,27,0.519,27,36,0.75,10,33,43,28,4,5,13,17,24,57,0.42105263157894735,1
49,102,0.48,12,34,0.353,17,24,0.708,12,29,41,28,10,3,10,18,37,68,0.5441176470588235,0
49,91,0.538,19,35,0.543,20,25,0.8,8,41,49,29,8,3,17,19,30,56,0.5357142857142857,1
41,86,0.477,15,42,0.357,19,21,0.905,10,23,33,30,7,8,10,21,26,44,0.5909090909090909,1
41,80,0.513,13,25,0.52,18,26,0.692,14,30,44,24,7,7,17,19,28,55,0.509090909090909,0
39,88,0.443,13,39,0.333,15,17,0.882,16,30,46,24,7,5,14,16,26,49,0.5306122448979592,1
40,87,0.46,12,36,0.333,13,15,0.867,9,32,41,21,7,2,11,16,28,51,0.5490196078431373,0
46,87,0.529,15,34,0.441,18,22,0.818,9,25,34,30,7,4,12,21,31,53,0.5849056603773585,0
43,74,0.581,17,33,0.515,25,31,0.806,4,29,33,29,7,5,14,20,26,41,0.6341463414634146,1
39,83,0.47,13,31,0.419,16,20,0.8,9,35,44,28,8,1,8,20,26,52,0.5,1
31,77,0.403,10,35,0.286,15,20,0.75,7,31,38,21,1,7,11,15,21,42,0.5,0
36,91,0.396,13,41,0.317,18,23,0.783,12,38,50,19,3,6,13,17,23,50,0.46,0
39,90,0.433,18,47,0.383,18,21,0.857,9,39,48,23,7,8,11,20,21,43,0.4883720930232558,1
40,101,0.396,15,45,0.333,19,21,0.905,10,34,44,22,15,5,17,23,25,56,0.44642857142857145,0
38,91,0.418,10,28,0.357,32,38,0.842,15,46,61,23,12,7,23,16,28,63,0.4444444444444444,1
36,88,0.409,6,35,0.171,8,9,0.889,10,28,38,18,10,2,17,23,30,53,0.5660377358490566,0
33,77,0.429,12,40,0.3,21,24,0.875,10,38,48,20,7,2,23,12,21,37,0.5675675675675675,1
35,82,0.427,8,31,0.258,13,17,0.765,7,31,38,30,5,3,14,18,27,51,0.5294117647058824,0
43,87,0.494,14,43,0.326,8,11,0.727,11,39,50,30,8,2,18,14,29,44,0.6590909090909091,1
43,90,0.478,10,30,0.333,14,17,0.824,12,33,45,26,7,5,16,28,33,60,0.55,0
40,82,0.488,9,24,0.375,26,36,0.722,9,29,38,23,11,5,12,15,31,58,0.5344827586206896,1
46,91,0.505,12,27,0.444,13,18,0.722,7,26,33,27,7,3,9,17,34,64,0.53125,0
45,81,0.556,20,40,0.5,14,23,0.609,6,39,45,32,6,8,16,16,25,41,0.6097560975609756,1
50,90,0.556,12,28,0.429,23,26,0.885,12,46,58,34,2,3,15,16,38,62,0.6129032258064516,1
36,98,0.367,13,36,0.361,15,19,0.789,13,27,40,13,6,6,6,18,23,62,0.3709677419354839,0
35,77,0.455,8,22,0.364,13,22,0.591,9,34,43,15,2,5,18,22,27,55,0.4909090909090909,0
37,80,0.463,11,24,0.458,21,27,0.778,11,32,43,28,12,7,10,19,26,56,0.4642857142857143,1
38,79,0.481,13,37,0.351,14,16,0.875,6,24,30,24,10,5,13,18,25,42,0.5952380952380952,0
43,80,0.538,15,35,0.429,17,19,0.895,8,30,38,24,12,2,14,17,28,45,0.6222222222222222,1
38,94,0.404,17,42,0.405,11,16,0.688,15,39,54,21,6,6,19,20,21,52,0.40384615384615385,0
37,86,0.43,11,32,0.344,24,28,0.857,6,41,47,26,12,7,11,19,26,54,0.48148148148148145,1
41,80,0.513,10,30,0.333,10,14,0.714,11,36,47,27,4,1,17,20,31,50,0.62,0
40,94,0.426,14,40,0.35,14,18,0.778,15,23,38,26,7,1,5,16,26,54,0.48148148148148145,1
34,88,0.386,13,46,0.283,16,20,0.8,6,30,36,26,9,7,9,14,21,42,0.5,0
45,84,0.536,15,39,0.385,13,18,0.722,7,45,52,40,8,4,15,15,30,45,0.6666666666666666,1
39,97,0.402,12,34,0.353,19,23,0.826,14,44,58,22,8,3,14,19,27,63,0.42857142857142855,1
36,89,0.404,13,42,0.31,19,22,0.864,9,38,47,24,7,5,14,19,23,47,0.48936170212765956,0
48,93,0.516,18,32,0.563,15,16,0.938,12,38,50,25,7,7,20,23,30,61,0.4918032786885246,1
39,93,0.419,10,33,0.303,21,25,0.84,14,26,40,18,12,7,17,17,29,60,0.48333333333333334,0
52,98,0.531,9,30,0.3,17,22,0.773,8,31,39,33,7,5,9,21,43,68,0.6323529411764706,1
46,96,0.479,14,35,0.4,22,27,0.815,14,36,50,28,6,3,12,20,32,61,0.5245901639344263,0
33,86,0.384,12,45,0.267,15,19,0.789,6,30,36,22,11,4,9,22,21,41,0.5121951219512195,0
38,78,0.487,13,30,0.433,19,25,0.76,10,41,51,26,3,2,18,17,25,48,0.5208333333333334,1
41,82,0.5,15,40,0.375,19,28,0.679,6,29,35,27,10,1,16,16,26,42,0.6190476190476191,0
50,84,0.595,16,37,0.432,13,16,0.813,1,35,36,36,8,8,15,22,34,47,0.723404255319149,1
39,96,0.406,10,34,0.294,21,26,0.808,15,47,62,26,3,7,18,25,29,62,0.46774193548387094,0
40,96,0.417,10,32,0.313,25,35,0.714,9,30,39,28,10,9,5,21,30,64,0.46875,1
38,79,0.481,13,38,0.342,12,13,0.923,6,36,42,28,7,2,18,20,25,41,0.6097560975609756,0
36,80,0.45,14,37,0.378,20,24,0.833,6,31,37,22,11,2,13,12,22,43,0.5116279069767442,1
31,82,0.378,7,31,0.226,25,34,0.735,10,31,41,15,11,4,17,20,24,51,0.47058823529411764,0
49,95,0.516,18,40,0.45,16,24,0.667,16,39,55,33,10,4,16,28,31,55,0.5636363636363636,1
37,85,0.435,9,31,0.29,27,32,0.844,9,37,46,22,9,8,17,23,28,54,0.5185185185185185,1
41,87,0.471,9,22,0.409,17,32,0.531,10,38,48,20,12,1,20,24,32,65,0.49230769230769234,0
36,83,0.434,17,44,0.386,14,19,0.737,5,28,33,31,6,3,7,19,19,39,0.48717948717948717,0
42,75,0.56,16,31,0.516,20,24,0.833,5,39,44,20,4,4,15,17,26,44,0.5909090909090909,1
40,92,0.435,9,38,0.237,12,20,0.6,11,36,47,15,13,2,14,19,31,54,0.5740740740740741,1
33,82,0.402,19,47,0.404,11,15,0.733,9,36,45,24,9,5,20,21,14,35,0.4,0
39,81,0.481,8,28,0.286,18,23,0.783,4,37,41,20,6,6,12,18,31,53,0.5849056603773585,0
40,88,0.455,13,35,0.371,18,23,0.783,5,39,44,23,6,1,10,20,27,53,0.5094339622641509,1
43,90,0.478,12,34,0.353,21,25,0.84,15,28,43,22,5,3,12,24,31,56,0.5535714285714286,0
46,87,0.529,13,28,0.464,23,27,0.852,11,33,44,30,6,4,11,17,33,59,0.559322033898305,1
34,88,0.386,14,41,0.341,22,26,0.846,11,30,41,18,6,2,13,13,20,47,0.425531914893617,0
47,93,0.505,21,43,0.488,10,11,0.909,10,36,46,39,7,8,11,21,26,50,0.52,1
41,86,0.477,14,37,0.378,17,22,0.773,6,31,37,22,8,5,11,15,27,49,0.5510204081632653,0
46,95,0.484,14,36,0.389,11,15,0.733,17,36,53,30,5,3,17,16,32,59,0.5423728813559322,1
50,91,0.549,15,32,0.469,16,18,0.889,5,43,48,28,3,5,13,20,35,59,0.5932203389830508,1
40,101,0.396,10,32,0.313,22,28,0.786,15,36,51,22,9,3,7,14,30,69,0.43478260869565216,0
42,91,0.462,12,23,0.522,24,28,0.857,8,46,54,22,9,7,15,22,30,68,0.4411764705882353,1
39,105,0.371,14,38,0.368,21,25,0.84,15,38,53,21,11,6,11,22,25,67,0.373134328358209,0
40,78,0.513,10,27,0.37,20,25,0.8,10,27,37,28,5,4,19,25,30,51,0.5882352941176471,0
43,89,0.483,12,31,0.387,21,26,0.808,10,26,36,25,11,6,10,21,31,58,0.5344827586206896,1
34,81,0.42,4,32,0.125,24,31,0.774,6,39,45,20,8,6,16,22,30,49,0.6122448979591837,0
45,94,0.479,11,33,0.333,19,22,0.864,8,40,48,25,8,3,11,20,34,61,0.5573770491803278,1
33,85,0.388,4,27,0.148,16,17,0.941,9,36,45,19,10,4,16,17,29,58,0.5,0
40,84,0.476,9,26,0.346,11,15,0.733,8,39,47,22,9,8,14,16,31,58,0.5344827586206896,1
41,77,0.532,11,29,0.379,17,22,0.773,9,42,51,33,3,4,18,21,30,48,0.625,1
36,84,0.429,7,36,0.194,23,25,0.92,6,28,34,18,13,4,6,19,29,48,0.6041666666666666,0
37,95,0.389,16,57,0.281,14,19,0.737,16,33,49,24,9,6,11,18,21,38,0.5526315789473685,0
37,83,0.446,16,44,0.364,15,21,0.714,8,40,48,29,7,4,16,21,21,39,0.5384615384615384,1
36,90,0.4,14,45,0.311,17,17,1.0,13,31,44,20,5,5,19,23,22,45,0.4888888888888889,0
44,82,0.537,15,29,0.517,17,26,0.654,8,36,44,28,13,5,16,18,29,53,0.5471698113207547,1
45,83,0.542,14,34,0.412,14,17,0.824,5,32,37,23,5,6,12,13,31,49,0.6326530612244898,1
45,87,0.517,12,29,0.414,8,10,0.8,6,29,35,24,6,1,11,19,33,58,0.5689655172413793,0
47,87,0.54,11,31,0.355,9,14,0.643,9,35,44,23,8,5,12,18,36,56,0.6428571428571429,1
36,76,0.474,11,25,0.44,20,24,0.833,4,24,28,16,5,3,11,18,25,51,0.49019607843137253,0
35,78,0.449,7,30,0.233,13,23,0.565,11,27,38,21,11,1,30,16,28,48,0.5833333333333334,0
47,86,0.547,14,31,0.452,13,18,0.722,10,31,41,27,22,7,21,19,33,55,0.6,1
43,92,0.467,12,42,0.286,8,14,0.571,14,26,40,24,9,2,10,15,31,50,0.62,0
42,81,0.519,13,29,0.448,16,18,0.889,11,35,46,23,6,4,18,15,29,52,0.5576923076923077,1
36,83,0.434,10,38,0.263,14,16,0.875,9,28,37,25,6,3,14,16,26,45,0.5777777777777777,0
43,79,0.544,8,29,0.276,18,20,0.9,5,35,40,32,7,5,13,19,35,50,0.7,1
55,103,0.534,6,17,0.353,30,35,0.857,13,31,44,27,6,1,6,21,49,86,0.5697674418604651,1
58,109,0.532,6,20,0.3,21,25,0.84,18,32,50,26,4,8,8,23,52,89,0.5842696629213483,0
39,81,0.481,13,30,0.433,28,36,0.778,10,41,51,25,5,3,27,24,26,51,0.5098039215686274,1
41,97,0.423,11,49,0.224,22,25,0.88,8,31,39,21,16,7,14,26,30,48,0.625,0
47,93,0.505,9,35,0.257,11,14,0.786,9,39,48,28,13,3,15,24,38,58,0.6551724137931034,1
38,82,0.463,12,35,0.343,16,23,0.696,7,31,38,26,6,7,18,17,26,47,0.5531914893617021,0
48,92,0.522,18,35,0.514,19,22,0.864,9,41,50,21,9,4,13,19,30,57,0.5263157894736842,1
34,84,0.405,16,43,0.372,19,24,0.792,10,33,43,25,11,5,18,18,18,41,0.43902439024390244,0
45,93,0.484,10,38,0.263,14,25,0.56,12,36,48,29,10,6,14,20,35,55,0.6363636363636364,1
42,86,0.488,7,31,0.226,16,22,0.727,8,37,45,24,9,4,17,22,35,55,0.6363636363636364,0
50,106,0.472,20,35,0.571,13,16,0.813,20,37,57,26,6,5,13,19,30,71,0.4225352112676056,1
40,86,0.465,10,30,0.333,22,28,0.786,7,31,38,25,6,12,13,17,30,56,0.5357142857142857,0
40,83,0.482,18,45,0.4,18,18,1.0,7,34,41,30,9,6,11,20,22,38,0.5789473684210527,1
36,91,0.396,15,43,0.349,16,19,0.842,15,32,47,24,5,3,13,19,21,48,0.4375,0
37,87,0.425,13,35,0.371,24,32,0.75,11,22,33,29,7,5,11,18,24,52,0.46153846153846156,0
44,92,0.478,15,40,0.375,17,22,0.773,19,35,54,26,9,8,14,24,29,52,0.5576923076923077,1
43,85,0.506,10,29,0.345,13,20,0.65,9,40,49,26,9,7,15,21,33,56,0.5892857142857143,1
37,92,0.402,12,44,0.273,18,24,0.75,13,32,45,30,12,3,13,15,25,48,0.5208333333333334,0
43,87,0.494,12,30,0.4,14,19,0.737,6,36,42,27,13,5,21,24,31,57,0.543859649122807,0
43,85,0.506,10,32,0.313,18,23,0.783,3,35,38,26,14,8,18,17,33,53,0.6226415094339622,1
45,92,0.489,15,40,0.375,25,28,0.893,11,40,51,23,7,6,10,20,30,52,0.5769230769230769,1
37,88,0.42,9,32,0.281,26,30,0.867,8,36,44,26,7,6,11,21,28,56,0.5,0
41,88,0.466,10,32,0.313,19,24,0.792,7,33,40,26,6,3,9,20,31,56,0.5535714285714286,0
43,85,0.506,9,25,0.36,21,24,0.875,10,38,48,26,4,1,13,23,34,60,0.5666666666666667,1
39,85,0.459,10,29,0.345,6,10,0.6,7,36,43,29,2,4,14,12,29,56,0.5178571428571429,0
42,91,0.462,12,27,0.444,17,19,0.895,9,32,41,27,10,9,4,16,30,64,0.46875,1
27,81,0.333,6,19,0.316,23,29,0.793,17,30,47,17,3,3,15,18,21,62,0.3387096774193548,0
48,89,0.539,16,36,0.444,15,22,0.682,11,35,46,29,12,10,8,22,32,53,0.6037735849056604,1
41,80,0.513,12,31,0.387,7,9,0.778,5,31,36,24,8,0,15,16,29,49,0.5918367346938775,0
43,91,0.473,13,37,0.351,10,13,0.769,15,30,45,23,9,4,10,11,30,54,0.5555555555555556,1
55,86,0.64,24,41,0.585,20,21,0.952,8,39,47,36,4,9,14,15,31,45,0.6888888888888889,1
42,87,0.483,7,21,0.333,14,17,0.824,3,21,24,24,8,6,13,19,35,66,0.5303030303030303,0
42,96,0.438,10,34,0.294,13,21,0.619,13,28,41,31,10,8,10,20,32,62,0.5161290322580645,0
47,90,0.522,6,18,0.333,16,21,0.762,10,40,50,24,6,4,14,20,41,72,0.5694444444444444,1
40,83,0.482,16,32,0.5,15,18,0.833,7,29,36,27,10,6,16,19,24,51,0.47058823529411764,0
44,93,0.473,12,35,0.343,21,26,0.808,14,33,47,22,6,7,11,16,32,58,0.5517241379310345,1
40,89,0.449,13,30,0.433,22,23,0.957,8,27,35,22,6,2,12,20,27,59,0.4576271186440678,1
36,71,0.507,10,29,0.345,23,34,0.676,3,36,39,26,7,5,18,23,26,42,0.6190476190476191,0
49,93,0.527,16,39,0.41,22,25,0.88,8,30,38,27,12,5,14,21,33,54,0.6111111111111112,0
49,98,0.5,25,46,0.543,20,24,0.833,16,36,52,23,6,6,18,23,24,52,0.46153846153846156,1
47,89,0.528,12,35,0.343,24,28,0.857,8,42,50,35,3,5,14,19,35,54,0.6481481481481481,1
41,96,0.427,11,39,0.282,20,21,0.952,7,31,38,23,8,6,10,23,30,57,0.5263157894736842,0
42,85,0.494,15,38,0.395,15,21,0.714,4,30,34,28,10,7,10,21,27,47,0.574468085106383,0
43,94,0.457,20,41,0.488,20,29,0.69,16,41,57,31,5,2,14,21,23,53,0.4339622641509434,1
45,101,0.446,5,29,0.172,14,19,0.737,15,41,56,26,11,6,12,22,40,72,0.5555555555555556,1
34,89,0.382,11,39,0.282,16,20,0.8,12,41,53,18,6,4,22,21,23,50,0.46,0
49,92,0.533,11,24,0.458,31,38,0.816,8,35,43,29,6,1,11,27,38,68,0.5588235294117647,0
49,105,0.467,18,38,0.474,27,36,0.75,17,35,52,31,7,7,13,26,31,67,0.4626865671641791,1
47,91,0.516,16,36,0.444,18,20,0.9,8,42,50,24,3,2,10,17,31,55,0.5636363636363636,1
40,95,0.421,13,41,0.317,16,19,0.842,11,31,42,20,6,3,8,18,27,54,0.5,0
42,90,0.467,9,25,0.36,15,20,0.75,8,43,51,24,5,5,11,19,33,65,0.5076923076923077,1
37,96,0.385,10,33,0.303,14,21,0.667,14,36,50,23,5,5,10,18,27,63,0.42857142857142855,0
46,92,0.5,8,18,0.444,22,26,0.846,11,35,46,31,14,3,14,19,38,74,0.5135135135135135,1
34,82,0.415,7,33,0.212,18,28,0.643,14,32,46,19,6,4,25,17,27,49,0.5510204081632653,0
39,86,0.453,12,33,0.364,20,22,0.909,11,26,37,29,10,3,17,16,27,53,0.5094339622641509,1
42,83,0.506,7,28,0.25,15,21,0.714,11,32,43,24,9,12,21,17,35,55,0.6363636363636364,0
27,86,0.314,6,26,0.231,15,20,0.75,12,44,56,16,4,6,20,19,21,60,0.35,0
34,99,0.343,11,39,0.282,13,16,0.813,15,42,57,25,10,8,9,15,23,60,0.38333333333333336,1
36,82,0.439,10,28,0.357,22,28,0.786,12,34,46,19,3,8,18,23,26,54,0.48148148148148145,0
47,101,0.465,10,28,0.357,22,26,0.846,18,32,50,27,8,6,9,21,37,73,0.5068493150684932,1
35,80,0.438,14,39,0.359,16,18,0.889,8,28,36,22,8,5,14,17,21,41,0.5121951219512195,0
48,88,0.545,11,33,0.333,14,19,0.737,8,36,44,27,7,7,11,14,37,55,0.6727272727272727,1
40,85,0.471,6,24,0.25,11,17,0.647,8,31,39,22,11,0,13,22,34,61,0.5573770491803278,0
37,74,0.5,14,36,0.389,20,26,0.769,6,38,44,19,11,5,15,21,23,38,0.6052631578947368,1
35,91,0.385,13,37,0.351,11,17,0.647,12,31,43,27,6,7,13,16,22,54,0.4074074074074074,0
42,87,0.483,14,37,0.378,9,20,0.45,14,40,54,24,8,15,14,16,28,50,0.56,1
47,87,0.54,18,36,0.5,12,15,0.8,10,27,37,30,12,1,8,16,29,51,0.5686274509803921,1
37,74,0.5,20,40,0.5,13,17,0.765,9,30,39,30,3,4,19,17,17,34,0.5,0
47,91,0.516,6,19,0.316,24,31,0.774,14,32,46,19,5,3,11,23,41,72,0.5694444444444444,0
47,87,0.54,17,38,0.447,14,22,0.636,7,29,36,31,6,4,11,25,30,49,0.6122448979591837,1
39,84,0.464,18,46,0.391,17,24,0.708,4,46,50,32,10,8,17,18,21,38,0.5526315789473685,1
32,89,0.36,9,42,0.214,14,22,0.636,10,39,49,20,9,3,20,18,23,47,0.48936170212765956,0
39,80,0.488,12,32,0.375,20,21,0.952,8,36,44,26,2,4,11,23,27,48,0.5625,1
36,83,0.434,14,34,0.412,18,24,0.75,10,29,39,21,8,3,6,19,22,49,0.4489795918367347,0
47,92,0.511,14,36,0.389,32,46,0.696,14,38,52,34,8,5,21,20,33,56,0.5892857142857143,1
48,106,0.453,15,48,0.313,25,32,0.781,13,38,51,35,17,5,16,30,33,58,0.5689655172413793,0
57,87,0.655,21,33,0.636,17,22,0.773,3,50,53,41,7,11,17,22,36,54,0.6666666666666666,1
38,111,0.342,8,38,0.211,11,23,0.478,21,27,48,23,8,4,14,15,30,73,0.410958904109589,0
44,96,0.458,10,29,0.345,13,21,0.619,17,38,55,21,6,10,17,20,34,67,0.5074626865671642,0
38,85,0.447,11,25,0.44,25,28,0.893,6,31,37,20,10,5,11,17,27,60,0.45,1
42,94,0.447,12,33,0.364,6,9,0.667,11,28,39,26,12,3,10,15,30,61,0.4918032786885246,0
37,78,0.474,17,41,0.415,15,18,0.833,9,40,49,20,3,3,21,15,20,37,0.5405405405405406,1
44,85,0.518,19,38,0.5,22,26,0.846,3,33,36,27,8,5,10,18,25,47,0.5319148936170213,1
43,89,0.483,20,39,0.513,13,15,0.867,10,35,45,29,3,6,18,21,23,50,0.46,0
45,88,0.511,11,38,0.289,20,27,0.741,11,31,42,30,10,6,11,22,34,50,0.68,1
40,81,0.494,14,33,0.424,17,22,0.773,8,31,39,30,9,1,15,20,26,48,0.5416666666666666,0
45,81,0.556,11,28,0.393,10,16,0.625,8,30,38,27,9,1,20,26,34,53,0.6415094339622641,1
34,81,0.42,6,35,0.171,25,31,0.806,13,27,40,16,12,4,17,16,28,46,0.6086956521739131,0
45,86,0.523,18,35,0.514,14,16,0.875,6,32,38,22,10,1,13,21,27,51,0.5294117647058824,1
34,79,0.43,8,35,0.229,21,32,0.656,14,33,47,19,6,5,18,18,26,44,0.5909090909090909,0
42,94,0.447,15,38,0.395,22,31,0.71,13,36,49,24,11,4,13,23,27,56,0.48214285714285715,1
41,85,0.482,11,29,0.379,21,31,0.677,7,37,44,32,7,6,14,22,30,56,0.5357142857142857,0
41,96,0.427,17,42,0.405,15,17,0.882,14,39,53,18,5,1,16,11,24,54,0.4444444444444444,0
48,98,0.49,15,37,0.405,6,12,0.5,8,37,45,19,9,11,10,18,33,61,0.5409836065573771,1
45,84,0.536,12,31,0.387,21,27,0.778,8,31,39,27,9,7,11,17,33,53,0.6226415094339622,1
45,92,0.489,13,30,0.433,17,24,0.708,17,30,47,23,7,3,15,22,32,62,0.5161290322580645,0
42,94,0.447,11,30,0.367,18,25,0.72,13,36,49,23,7,9,13,19,31,64,0.484375,1
43,96,0.448,12,31,0.387,13,17,0.765,10,38,48,20,9,5,14,25,31,65,0.47692307692307695,0
43,95,0.453,17,41,0.415,11,14,0.786,8,31,39,25,7,4,8,15,26,54,0.48148148148148145,0
44,84,0.524,20,41,0.488,15,18,0.833,5,44,49,32,6,3,11,18,24,43,0.5581395348837209,1
40,75,0.533,11,28,0.393,15,21,0.714,7,37,44,23,11,6,18,13,29,47,0.6170212765957447,1
36,87,0.414,11,34,0.324,11,14,0.786,12,28,40,25,7,2,15,15,25,53,0.4716981132075472,0
45,88,0.511,10,23,0.435,19,25,0.76,9,39,48,27,6,3,11,18,35,65,0.5384615384615384,1
44,93,0.473,11,35,0.314,13,18,0.722,12,30,42,24,8,4,11,19,33,58,0.5689655172413793,0
36,82,0.439,6,24,0.25,11,16,0.688,6,35,41,22,10,7,13,24,30,58,0.5172413793103449,0
32,73,0.438,13,30,0.433,16,23,0.696,7,36,43,18,5,8,20,20,19,43,0.4418604651162791,1
45,89,0.506,14,27,0.519,14,18,0.778,8,37,45,19,6,8,10,21,31,62,0.5,1
34,86,0.395,16,41,0.39,20,24,0.833,13,33,46,26,7,4,12,14,18,45,0.4,0
47,88,0.534,17,44,0.386,12,14,0.857,5,33,38,31,9,8,15,28,30,44,0.6818181818181818,1
39,90,0.433,5,25,0.2,25,32,0.781,13,34,47,20,6,4,17,8,34,65,0.5230769230769231,0
42,90,0.467,5,18,0.278,10,10,1.0,8,29,37,25,10,4,13,13,37,72,0.5138888888888888,0
44,88,0.5,11,36,0.306,11,16,0.688,14,36,50,22,10,5,16,11,33,52,0.6346153846153846,1
53,107,0.495,14,27,0.519,21,25,0.84,14,31,45,28,8,6,17,17,39,80,0.4875,0
63,103,0.612,9,22,0.409,19,24,0.792,9,35,44,50,10,7,17,19,54,81,0.6666666666666666,1
55,105,0.524,12,31,0.387,12,13,0.923,12,36,48,35,10,11,7,26,43,74,0.581081081081081,1
41,90,0.456,13,29,0.448,23,27,0.852,9,33,42,29,3,3,18,13,28,61,0.45901639344262296,0
38,93,0.409,8,31,0.258,18,24,0.75,16,35,51,23,8,5,8,23,30,62,0.4838709677419355,1
39,85,0.459,9,32,0.281,12,20,0.6,10,36,46,21,3,3,13,21,30,53,0.5660377358490566,0
40,87,0.46,12,35,0.343,8,13,0.615,7,30,37,22,10,3,12,15,28,52,0.5384615384615384,0
39,75,0.52,15,34,0.441,12,13,0.923,4,38,42,28,7,5,18,14,24,41,0.5853658536585366,1
46,87,0.529,22,48,0.458,13,18,0.722,12,32,44,26,6,4,13,17,24,39,0.6153846153846154,1
39,84,0.464,18,41,0.439,17,21,0.81,8,31,39,30,9,2,12,17,21,43,0.4883720930232558,0
41,84,0.488,20,43,0.465,16,26,0.615,6,33,39,21,6,6,13,25,21,41,0.5121951219512195,0
44,98,0.449,14,37,0.378,22,27,0.815,15,40,55,23,7,3,13,21,30,61,0.4918032786885246,1
39,93,0.419,20,53,0.377,5,7,0.714,8,40,48,22,7,9,18,17,19,40,0.475,0
39,97,0.402,12,30,0.4,18,22,0.818,14,43,57,28,10,3,12,9,27,67,0.40298507462686567,1
39,95,0.411,12,43,0.279,13,16,0.813,9,40,49,25,6,10,12,19,27,52,0.5192307692307693,1
35,98,0.357,11,36,0.306,18,25,0.72,17,40,57,21,5,4,10,14,24,62,0.3870967741935484,0
33,79,0.418,12,32,0.375,25,29,0.862,10,20,30,19,9,3,10,16,21,47,0.44680851063829785,0
53,84,0.631,13,26,0.5,16,18,0.889,9,37,46,35,8,6,11,21,40,58,0.6896551724137931,1
53,92,0.576,16,33,0.485,19,25,0.76,11,43,54,26,7,9,10,20,37,59,0.6271186440677966,1
37,92,0.402,13,38,0.342,18,26,0.692,12,30,42,23,9,3,9,18,24,54,0.4444444444444444,0
33,86,0.384,13,35,0.371,18,27,0.667,6,36,42,18,6,10,15,24,20,51,0.39215686274509803,0
37,97,0.381,12,39,0.308,27,33,0.818,17,46,63,23,13,7,15,24,25,58,0.43103448275862066,1
50,94,0.532,15,35,0.429,20,22,0.909,11,36,47,26,10,6,10,16,35,59,0.5932203389830508,1
42,93,0.452,17,45,0.378,14,18,0.778,12,26,38,28,6,5,13,16,25,48,0.5208333333333334,0
43,95,0.453,8,32,0.25,10,14,0.714,12,36,48,21,16,7,12,14,35,63,0.5555555555555556,1
36,83,0.434,9,25,0.36,12,17,0.706,10,38,48,26,8,6,22,13,27,58,0.46551724137931033,0
47,96,0.49,8,22,0.364,32,43,0.744,11,32,43,27,6,6,7,23,39,74,0.527027027027027,0
48,89,0.539,18,37,0.486,21,28,0.75,10,35,45,30,4,6,20,31,30,52,0.5769230769230769,1
52,97,0.536,14,29,0.483,21,28,0.75,12,34,46,30,6,4,14,19,38,68,0.5588235294117647,1
49,94,0.521,19,39,0.487,18,22,0.818,12,29,41,32,7,5,14,22,30,55,0.5454545454545454,0
51,96,0.531,21,45,0.467,9,12,0.75,9,36,45,28,8,9,11,23,30,51,0.5882352941176471,1
33,85,0.388,6,25,0.24,24,28,0.857,10,35,45,13,7,7,19,11,27,60,0.45,0
37,92,0.402,7,23,0.304,13,20,0.65,9,26,35,22,7,5,7,13,30,69,0.43478260869565216,0
49,88,0.557,18,41,0.439,10,14,0.714,7,46,53,24,5,2,18,20,31,47,0.6595744680851063,1
46,91,0.505,18,37,0.486,10,17,0.588,15,41,56,33,10,8,17,20,28,54,0.5185185185185185,1
38,90,0.422,16,35,0.457,7,18,0.389,13,32,45,29,11,3,15,16,22,55,0.4,0
41,95,0.432,13,37,0.351,14,15,0.933,10,41,51,18,8,4,13,18,28,58,0.4827586206896552,0
40,89,0.449,15,34,0.441,18,26,0.692,12,39,51,23,10,3,12,15,25,55,0.45454545454545453,1
38,89,0.427,10,37,0.27,11,17,0.647,12,30,42,25,7,5,15,14,28,52,0.5384615384615384,0
44,83,0.53,11,28,0.393,12,14,0.857,5,34,39,24,9,6,12,18,33,55,0.6,1
36,88,0.409,9,39,0.231,16,20,0.8,5,34,39,21,9,1,10,19,27,49,0.5510204081632653,0
42,86,0.488,19,47,0.404,15,18,0.833,7,42,49,36,4,1,14,19,23,39,0.5897435897435898,1
48,94,0.511,15,37,0.405,15,18,0.833,10,24,34,27,8,6,12,17,33,57,0.5789473684210527,0
54,87,0.621,8,20,0.4,17,19,0.895,4,32,36,35,11,4,15,19,46,67,0.6865671641791045,1
33,87,0.379,10,36,0.278,18,29,0.621,11,23,34,21,8,6,11,23,23,51,0.45098039215686275,0
41,77,0.532,13,31,0.419,23,26,0.885,9,39,48,23,4,5,22,25,28,46,0.6086956521739131,1
41,94,0.436,13,30,0.433,36,43,0.837,11,36,47,29,4,6,15,22,28,64,0.4375,1
47,105,0.448,14,38,0.368,21,27,0.778,18,32,50,23,9,5,13,30,33,67,0.4925373134328358,0
35,86,0.407,11,39,0.282,18,23,0.783,11,36,47,19,5,8,14,15,24,47,0.5106382978723404,0
43,99,0.434,18,40,0.45,17,18,0.944,15,37,52,26,10,4,9,20,25,59,0.423728813559322,1
41,98,0.418,9,30,0.3,21,28,0.75,14,33,47,19,6,7,7,24,32,68,0.47058823529411764,0
44,89,0.494,9,33,0.273,25,33,0.758,11,40,51,28,5,4,11,22,35,56,0.625,1
32,83,0.386,6,29,0.207,20,26,0.769,11,32,43,17,6,0,15,18,26,54,0.48148148148148145,0
41,83,0.494,10,32,0.313,18,22,0.818,9,36,45,21,7,7,10,22,31,51,0.6078431372549019,1
41,85,0.482,10,37,0.27,20,30,0.667,9,32,41,27,7,4,16,24,31,48,0.6458333333333334,0
44,87,0.506,13,32,0.406,20,27,0.741,8,29,37,27,9,2,14,22,31,55,0.5636363636363636,1
48,96,0.5,25,53,0.472,12,18,0.667,7,30,37,36,10,5,16,21,23,43,0.5348837209302325,0
51,95,0.537,19,46,0.413,20,23,0.87,13,40,53,30,8,5,17,14,32,49,0.6530612244897959,1
41,101,0.406,9,36,0.25,16,22,0.727,16,36,52,26,12,6,11,21,32,65,0.49230769230769234,0
38,85,0.447,15,35,0.429,18,22,0.818,10,41,51,27,5,6,17,19,23,50,0.46,1
38,84,0.452,11,32,0.344,18,23,0.783,6,35,41,24,2,4,13,25,27,52,0.5192307692307693,0
43,92,0.467,18,41,0.439,24,25,0.96,7,38,45,26,5,3,7,17,25,51,0.49019607843137253,1
37,89,0.416,11,30,0.367,16,22,0.727,10,39,49,19,2,4,14,20,26,59,0.4406779661016949,0
37,88,0.42,12,37,0.324,20,21,0.952,6,38,44,22,6,2,9,20,25,51,0.49019607843137253,1
46,89,0.517,4,22,0.182,17,19,0.895,7,37,44,20,8,7,13,12,42,67,0.6268656716417911,1
41,84,0.488,13,32,0.406,9,15,0.6,4,31,35,27,10,3,16,19,28,52,0.5384615384615384,0
43,83,0.518,17,38,0.447,17,20,0.85,9,29,38,31,8,3,17,16,26,45,0.5777777777777777,0
43,89,0.483,21,46,0.457,20,23,0.87,9,29,38,27,9,3,12,20,22,43,0.5116279069767442,1
41,66,0.621,16,31,0.516,27,33,0.818,2,33,35,27,10,5,17,24,25,35,0.7142857142857143,1
42,92,0.457,14,41,0.341,21,23,0.913,10,23,33,21,8,1,12,23,28,51,0.5490196078431373,0
38,94,0.404,9,37,0.243,12,20,0.6,11,30,41,21,10,1,13,16,29,57,0.5087719298245614,0
47,81,0.58,27,54,0.5,15,18,0.833,2,44,46,31,5,4,19,19,20,27,0.7407407407407407,1
49,110,0.445,9,32,0.281,26,30,0.867,15,45,60,26,7,9,18,24,40,78,0.5128205128205128,1
50,104,0.481,7,29,0.241,25,30,0.833,8,41,49,33,11,5,13,24,43,75,0.5733333333333334,0
41,84,0.488,11,34,0.324,11,16,0.688,10,34,44,22,5,7,18,25,30,50,0.6,0
41,84,0.488,9,30,0.3,27,31,0.871,9,35,44,22,11,4,11,18,32,54,0.5925925925925926,1
37,93,0.398,8,30,0.267,20,23,0.87,7,33,40,17,6,5,7,24,29,63,0.4603174603174603,0
45,97,0.464,12,34,0.353,22,30,0.733,18,45,63,24,3,5,8,15,33,63,0.5238095238095238,1
38,85,0.447,14,43,0.326,19,26,0.731,14,42,56,24,7,8,17,21,24,42,0.5714285714285714,1
36,94,0.383,10,32,0.313,17,24,0.708,13,33,46,18,10,2,12,21,26,62,0.41935483870967744,0
43,98,0.439,18,51,0.353,12,17,0.706,9,31,40,25,11,3,9,15,25,47,0.5319148936170213,0
45,85,0.529,15,38,0.395,19,21,0.905,7,42,49,28,7,4,18,13,30,47,0.6382978723404256,1
47,82,0.573,16,35,0.457,20,22,0.909,3,32,35,30,8,2,11,20,31,47,0.6595744680851063,1
45,83,0.542,14,38,0.368,20,25,0.8,6,28,34,29,7,3,14,22,31,45,0.6888888888888889,0
45,96,0.469,12,37,0.324,10,22,0.455,16,35,51,26,11,9,16,20,33,59,0.559322033898305,1
42,95,0.442,13,37,0.351,13,18,0.722,11,35,46,22,6,8,19,19,29,58,0.5,0
50,93,0.538,15,39,0.385,9,11,0.818,8,34,42,33,9,7,12,24,35,54,0.6481481481481481,1
33,86,0.384,11,31,0.355,20,31,0.645,10,28,38,18,5,2,16,12,22,55,0.4,0
43,84,0.512,12,32,0.375,10,14,0.714,5,38,43,27,6,3,9,22,31,52,0.5961538461538461,1
36,79,0.456,11,27,0.407,13,22,0.591,5,32,37,22,4,4,14,14,25,52,0.4807692307692308,0
42,90,0.467,13,32,0.406,9,9,1.0,8,37,45,25,7,5,10,17,29,58,0.5,1
37,86,0.43,12,35,0.343,14,16,0.875,7,36,43,24,5,1,13,12,25,51,0.49019607843137253,0
39,73,0.534,11,25,0.44,21,25,0.84,3,29,32,23,8,6,15,29,28,48,0.5833333333333334,0
39,80,0.488,13,30,0.433,32,41,0.78,14,27,41,24,11,3,14,21,26,50,0.52,1
47,97,0.485,16,45,0.356,18,24,0.75,12,45,57,30,5,9,10,20,31,52,0.5961538461538461,1
36,91,0.396,9,36,0.25,15,22,0.682,10,35,45,20,5,5,13,20,27,55,0.4909090909090909,0
34,87,0.391,11,37,0.297,19,29,0.655,10,28,38,23,9,3,14,18,23,50,0.46,0
45,85,0.529,16,36,0.444,20,24,0.833,9,42,51,30,8,11,15,19,29,49,0.5918367346938775,1
51,100,0.51,13,26,0.5,9,11,0.818,8,34,42,28,8,8,9,21,38,74,0.5135135135135135,0
46,96,0.479,10,30,0.333,23,26,0.885,13,42,55,23,4,6,12,17,36,66,0.5454545454545454,1
44,88,0.5,11,27,0.407,12,16,0.75,10,37,47,32,7,13,11,21,33,61,0.5409836065573771,1
33,93,0.355,13,39,0.333,23,30,0.767,15,35,50,21,8,2,12,13,20,54,0.37037037037037035,0
41,91,0.451,13,44,0.295,21,24,0.875,13,35,48,14,7,1,15,20,28,47,0.5957446808510638,0
41,88,0.466,14,42,0.333,23,25,0.92,9,32,41,26,8,2,10,20,27,46,0.5869565217391305,1
43,97,0.443,10,23,0.435,14,21,0.667,14,36,50,29,9,4,12,18,33,74,0.44594594594594594,0
45,91,0.495,9,30,0.3,16,27,0.593,10,39,49,33,8,19,12,17,36,61,0.5901639344262295,1
42,85,0.494,18,38,0.474,27,28,0.964,7,37,44,30,5,2,13,26,24,47,0.5106382978723404,0
47,92,0.511,18,40,0.45,28,35,0.8,12,35,47,30,7,4,9,18,29,52,0.5576923076923077,1
47,94,0.5,13,41,0.317,18,23,0.783,8,26,34,26,6,6,8,13,34,53,0.6415094339622641,0
56,94,0.596,17,29,0.586,17,21,0.81,9,37,46,27,6,5,13,16,39,65,0.6,1
48,81,0.593,16,30,0.533,17,22,0.773,6,37,43,25,7,4,14,21,32,51,0.6274509803921569,1
46,88,0.523,18,37,0.486,11,17,0.647,3,29,32,31,8,5,11,21,28,51,0.5490196078431373,0
42,89,0.472,12,33,0.364,19,25,0.76,13,38,51,32,4,8,8,19,30,56,0.5357142857142857,1
39,96,0.406,18,44,0.409,11,14,0.786,10,35,45,21,4,5,9,20,21,52,0.40384615384615385,0
41,83,0.494,13,33,0.394,22,26,0.846,10,28,38,26,12,2,17,19,28,50,0.56,1
42,91,0.462,11,39,0.282,17,20,0.85,15,34,49,30,9,5,17,17,31,52,0.5961538461538461,0
45,98,0.459,14,48,0.292,15,21,0.714,11,33,44,30,16,8,15,22,31,50,0.62,1
35,75,0.467,10,23,0.435,20,26,0.769,6,40,46,21,8,5,28,23,25,52,0.4807692307692308,0
41,79,0.519,16,37,0.432,18,20,0.9,6,30,36,26,4,6,11,20,25,42,0.5952380952380952,0
47,95,0.495,11,40,0.275,17,20,0.85,12,28,40,33,8,1,10,20,36,55,0.6545454545454545,1
38,87,0.437,8,26,0.308,10,14,0.714,5,30,35,23,9,5,11,17,30,61,0.4918032786885246,0
37,83,0.446,14,41,0.341,15,16,0.938,7,38,45,28,7,6,14,15,23,42,0.5476190476190477,1
34,87,0.391,10,29,0.345,21,23,0.913,5,36,41,19,8,3,10,21,24,58,0.41379310344827586,0
37,89,0.416,12,28,0.429,15,19,0.789,14,39,53,31,5,5,20,17,25,61,0.4098360655737705,1
37,88,0.42,12,38,0.316,18,19,0.947,13,22,35,23,8,2,13,15,25,50,0.5,0
51,89,0.573,16,33,0.485,15,16,0.938,10,34,44,32,11,6,11,16,35,56,0.625,1
39,94,0.415,10,30,0.333,14,20,0.7,10,42,52,18,6,2,12,20,29,64,0.453125,0
43,101,0.426,8,33,0.242,20,27,0.741,17,46,63,16,10,1,9,15,35,68,0.5147058823529411,1
39,84,0.464,9,23,0.391,19,28,0.679,9,36,45,22,9,5,18,18,30,61,0.4918032786885246,0
44,86,0.512,19,39,0.487,15,19,0.789,6,34,40,28,13,6,16,21,25,47,0.5319148936170213,1
39,78,0.5,11,32,0.344,26,26,1.0,9,40,49,25,10,4,18,17,28,46,0.6086956521739131,1
35,86,0.407,10,37,0.27,16,19,0.842,9,26,35,21,10,8,13,22,25,49,0.5102040816326531,0
45,101,0.446,10,29,0.345,16,19,0.842,9,33,42,29,10,1,7,20,35,72,0.4861111111111111,0
44,86,0.512,10,33,0.303,22,28,0.786,7,44,51,22,4,5,14,21,34,53,0.6415094339622641,1
43,101,0.426,8,31,0.258,22,27,0.815,16,30,46,21,7,2,8,19,35,70,0.5,0
48,79,0.608,12,28,0.429,20,27,0.741,3,40,43,33,3,9,11,19,36,51,0.7058823529411765,1
36,101,0.356,12,41,0.293,10,14,0.714,13,33,46,14,9,8,7,23,24,60,0.4,0
36,80,0.45,8,24,0.333,22,27,0.815,7,48,55,27,4,6,16,13,28,56,0.5,1
36,87,0.414,7,28,0.25,28,38,0.737,11,33,44,18,5,2,13,18,29,59,0.4915254237288136,0
47,96,0.49,15,45,0.333,16,20,0.8,9,39,48,23,4,2,8,27,32,51,0.6274509803921569,1
43,85,0.506,18,42,0.429,18,27,0.667,8,33,41,33,7,4,15,23,25,43,0.5813953488372093,0
52,91,0.571,7,20,0.35,13,22,0.591,8,33,41,28,8,3,11,20,45,71,0.6338028169014085,1
40,91,0.44,13,32,0.406,12,17,0.706,9,30,39,17,7,6,5,18,27,59,0.4576271186440678,1
35,85,0.412,12,40,0.3,16,21,0.762,15,38,53,15,4,4,12,22,23,45,0.5111111111111111,0
36,94,0.383,11,36,0.306,10,15,0.667,16,35,51,24,3,6,14,16,25,58,0.43103448275862066,0
41,94,0.436,14,36,0.389,20,24,0.833,12,37,49,19,9,4,7,16,27,58,0.46551724137931033,1
40,90,0.444,12,36,0.333,10,18,0.556,7,25,32,24,16,1,11,14,28,54,0.5185185185185185,0
45,83,0.542,17,36,0.472,7,10,0.7,8,43,51,31,4,4,19,15,28,47,0.5957446808510638,1
40,75,0.533,21,45,0.467,12,16,0.75,6,38,44,28,6,6,17,17,19,30,0.6333333333333333,1
33,84,0.393,9,33,0.273,15,19,0.789,8,27,35,24,9,1,12,15,24,51,0.47058823529411764,0
54,94,0.574,11,30,0.367,23,31,0.742,10,41,51,34,5,6,12,10,43,64,0.671875,1
50,110,0.455,21,43,0.488,12,15,0.8,12,28,40,34,6,2,8,22,29,67,0.43283582089552236,0
42,96,0.438,17,41,0.415,9,14,0.643,13,22,35,33,9,9,11,16,25,55,0.45454545454545453,0
45,90,0.5,11,33,0.333,15,18,0.833,12,36,48,30,2,9,18,13,34,57,0.5964912280701754,1
36,78,0.462,7,25,0.28,15,20,0.75,8,22,30,20,8,1,13,18,29,53,0.5471698113207547,0
41,81,0.506,13,35,0.371,11,11,1.0,15,32,47,26,5,6,20,15,28,46,0.6086956521739131,1
46,96,0.479,12,36,0.333,10,11,0.909,14,39,53,30,6,3,14,25,34,60,0.5666666666666667,1
34,80,0.425,16,41,0.39,19,32,0.594,11,32,43,20,3,5,15,17,18,39,0.46153846153846156,0
38,91,0.418,6,21,0.286,16,19,0.842,9,38,47,22,4,6,11,16,32,70,0.45714285714285713,0
35,86,0.407,14,35,0.4,18,18,1.0,10,38,48,23,7,8,10,19,21,51,0.4117647058823529,1
44,81,0.543,15,33,0.455,14,18,0.778,1,32,33,23,7,3,13,18,29,48,0.6041666666666666,0
41,88,0.466,13,32,0.406,23,26,0.885,10,32,42,22,4,3,11,17,28,56,0.5,1
42,85,0.494,13,38,0.342,13,17,0.765,4,40,44,19,7,5,12,18,29,47,0.6170212765957447,0
39,90,0.433,17,42,0.405,19,21,0.905,11,31,42,27,4,3,10,18,22,48,0.4583333333333333,1
42,86,0.488,9,32,0.281,11,14,0.786,9,40,49,29,6,3,12,17,33,54,0.6111111111111112,1
34,83,0.41,6,37,0.162,17,23,0.739,9,32,41,21,6,8,10,13,28,46,0.6086956521739131,0
46,99,0.465,11,27,0.407,19,28,0.679,12,39,51,21,6,3,9,23,35,72,0.4861111111111111,0
42,87,0.483,17,39,0.436,24,30,0.8,8,38,46,29,4,4,12,21,25,48,0.5208333333333334,1
45,93,0.484,11,35,0.314,14,15,0.933,7,28,35,29,9,5,14,15,34,58,0.5862068965517241,0
46,86,0.535,14,37,0.378,16,22,0.727,8,33,41,30,4,4,16,20,32,49,0.6530612244897959,1
37,96,0.385,10,42,0.238,22,27,0.815,14,42,56,21,7,2,10,21,27,54,0.5,0
37,84,0.44,11,33,0.333,22,35,0.629,9,40,49,23,8,5,13,20,26,51,0.5098039215686274,1
40,93,0.43,13,39,0.333,16,21,0.762,17,36,53,23,9,3,11,17,27,54,0.5,1
36,84,0.429,6,19,0.316,15,16,0.938,10,35,45,13,6,2,17,20,30,65,0.46153846153846156,0
33,83,0.398,10,30,0.333,21,28,0.75,10,34,44,21,4,5,13,15,23,53,0.4339622641509434,0
44,93,0.473,16,34,0.471,18,19,0.947,10,36,46,35,9,8,9,25,28,59,0.4745762711864407,1
39,84,0.464,10,36,0.278,17,21,0.81,7,37,44,24,4,3,17,21,29,48,0.6041666666666666,0
41,89,0.461,7,25,0.28,31,37,0.838,12,35,47,23,9,6,11,19,34,64,0.53125,1
34,98,0.347,11,41,0.268,12,17,0.706,19,33,52,24,7,4,9,13,23,57,0.40350877192982454,0
41,87,0.471,14,34,0.412,9,15,0.6,8,44,52,26,6,8,10,16,27,53,0.5094339622641509,1
41,86,0.477,11,29,0.379,29,36,0.806,11,34,45,25,5,3,13,15,30,57,0.5263157894736842,1
46,89,0.517,9,33,0.273,14,19,0.737,8,29,37,28,10,8,13,23,37,56,0.6607142857142857,0
40,96,0.417,22,49,0.449,6,8,0.75,9,29,38,25,8,3,11,18,18,47,0.3829787234042553,0
46,86,0.535,13,35,0.371,17,24,0.708,5,43,48,29,4,3,11,15,33,51,0.6470588235294118,1
46,95,0.484,18,42,0.429,14,18,0.778,9,35,44,27,8,6,15,24,28,53,0.5283018867924528,1
39,95,0.411,5,37,0.135,25,34,0.735,20,31,51,22,8,7,13,19,34,58,0.5862068965517241,0
39,102,0.382,13,49,0.265,18,24,0.75,15,36,51,28,5,2,8,18,26,53,0.49056603773584906,0
45,88,0.511,16,37,0.432,12,15,0.8,7,43,50,29,3,7,10,20,29,51,0.5686274509803921,1
52,94,0.553,15,33,0.455,21,22,0.955,7,40,47,32,10,1,10,15,37,61,0.6065573770491803,1
39,88,0.443,4,26,0.154,21,24,0.875,7,34,41,23,5,2,16,17,35,62,0.5645161290322581,0
31,92,0.337,18,63,0.286,15,20,0.75,11,32,43,25,8,5,16,18,13,29,0.4482758620689655,0
49,90,0.544,7,21,0.333,19,26,0.731,11,45,56,32,10,8,13,16,42,69,0.6086956521739131,1
38,85,0.447,12,39,0.308,21,31,0.677,11,34,45,16,8,5,16,14,26,46,0.5652173913043478,0
47,83,0.566,16,30,0.533,13,17,0.765,4,33,37,35,9,9,12,20,31,53,0.5849056603773585,1
38,90,0.422,12,37,0.324,24,32,0.75,10,31,41,14,13,5,12,16,26,53,0.49056603773584906,0
45,87,0.517,14,32,0.438,14,19,0.737,8,37,45,23,8,8,16,20,31,55,0.5636363636363636,1
47,84,0.56,13,34,0.382,13,20,0.65,6,33,39,32,11,5,12,19,34,50,0.68,1
40,86,0.465,11,35,0.314,16,22,0.727,7,26,33,26,4,4,16,21,29,51,0.5686274509803921,0
40,92,0.435,6,25,0.24,15,19,0.789,12,27,39,25,12,5,13,21,34,67,0.5074626865671642,0
41,83,0.494,15,39,0.385,16,18,0.889,12,34,46,26,9,4,20,19,26,44,0.5909090909090909,1
44,91,0.484,16,38,0.421,17,20,0.85,11,27,38,32,5,5,16,19,28,53,0.5283018867924528,0
49,90,0.544,17,40,0.425,21,25,0.84,11,27,38,35,11,4,10,22,32,50,0.64,1
45,96,0.469,11,35,0.314,9,15,0.6,8,34,42,30,14,5,10,16,34,61,0.5573770491803278,1
37,78,0.474,9,25,0.36,15,21,0.714,8,39,47,26,4,5,21,18,28,53,0.5283018867924528,0
35,86,0.407,11,41,0.268,11,15,0.733,9,37,46,19,4,6,12,19,24,45,0.5333333333333333,0
34,79,0.43,13,27,0.481,15,19,0.789,4,37,41,16,7,6,11,17,21,52,0.40384615384615385,1
45,106,0.425,10,43,0.233,12,15,0.8,16,28,44,17,8,3,3,14,35,63,0.5555555555555556,0
50,94,0.532,8,26,0.308,9,16,0.563,14,40,54,20,1,12,15,11,42,68,0.6176470588235294,1
36,76,0.474,10,28,0.357,35,41,0.854,9,38,47,23,4,3,17,25,26,48,0.5416666666666666,0
46,94,0.489,19,40,0.475,17,23,0.739,9,32,41,35,8,5,12,27,27,54,0.5,1
44,98,0.449,14,37,0.378,14,15,0.933,10,26,36,20,8,2,6,20,30,61,0.4918032786885246,0
46,87,0.529,18,43,0.419,22,26,0.846,11,40,51,24,3,6,14,16,28,44,0.6363636363636364,1
41,86,0.477,18,39,0.462,21,25,0.84,9,41,50,28,9,3,16,14,23,47,0.48936170212765956,1
42,90,0.467,9,30,0.3,6,10,0.6,5,34,39,24,10,5,13,22,33,60,0.55,0
53,104,0.51,13,35,0.371,4,4,1.0,10,38,48,36,7,5,8,13,40,69,0.5797101449275363,1
50,98,0.51,7,24,0.292,14,19,0.737,11,35,46,30,5,5,10,8,43,74,0.581081081081081,0
48,95,0.505,15,37,0.405,14,18,0.778,10,37,47,34,8,3,13,19,33,58,0.5689655172413793,1
39,97,0.402,12,38,0.316,23,29,0.793,16,32,48,21,8,3,12,12,27,59,0.4576271186440678,0
37,94,0.394,14,45,0.311,22,24,0.917,10,32,42,25,8,5,13,15,23,49,0.46938775510204084,0
44,91,0.484,10,31,0.323,17,21,0.81,10,43,53,22,4,3,14,20,34,60,0.5666666666666667,1
40,92,0.435,3,21,0.143,17,20,0.85,13,36,49,17,5,9,15,31,37,71,0.5211267605633803,0
38,96,0.396,15,45,0.333,27,32,0.844,14,35,49,20,8,5,10,17,23,51,0.45098039215686275,1
43,94,0.457,12,40,0.3,19,25,0.76,7,29,36,26,8,6,14,14,31,54,0.5740740740740741,0
58,105,0.552,16,35,0.457,12,15,0.8,12,42,54,35,7,5,16,21,42,70,0.6,1
37,83,0.446,15,34,0.441,11,15,0.733,9,37,46,19,8,8,20,21,22,49,0.4489795918367347,0
37,91,0.407,10,31,0.323,19,25,0.76,13,36,49,27,15,7,11,18,27,60,0.45,1
34,97,0.351,8,22,0.364,20,24,0.833,15,40,55,20,5,7,8,22,26,75,0.3466666666666667,0
40,90,0.444,7,22,0.318,13,24,0.542,11,45,56,18,4,11,9,19,33,68,0.4852941176470588,1
41,100,0.41,15,41,0.366,18,21,0.857,9,31,40,30,9,4,14,19,26,59,0.4406779661016949,0
54,93,0.581,14,28,0.5,20,26,0.769,7,45,52,34,7,9,15,20,40,65,0.6153846153846154,1
40,98,0.408,15,35,0.429,22,26,0.846,16,31,47,22,14,6,13,23,25,63,0.3968253968253968,1
42,94,0.447,12,34,0.353,16,20,0.8,11,37,48,30,7,7,21,23,30,60,0.5,0
31,84,0.369,11,30,0.367,20,26,0.769,11,29,40,19,6,12,12,18,20,54,0.37037037037037035,0
35,84,0.417,8,34,0.235,26,29,0.897,14,36,50,18,7,7,11,22,27,50,0.54,1
43,91,0.473,19,40,0.475,18,19,0.947,10,29,39,29,3,2,6,14,24,51,0.47058823529411764,1
47,93,0.505,11,36,0.306,4,8,0.5,11,37,48,22,3,7,8,18,36,57,0.631578947368421,0
38,76,0.5,17,36,0.472,20,26,0.769,10,32,42,22,2,3,13,21,21,40,0.525,1
37,84,0.44,11,40,0.275,18,24,0.75,13,26,39,22,7,7,5,21,26,44,0.5909090909090909,0
36,99,0.364,20,50,0.4,15,19,0.789,12,39,51,22,8,3,17,23,16,49,0.32653061224489793,0
42,96,0.438,5,31,0.161,20,33,0.606,15,49,64,19,11,1,17,18,37,65,0.5692307692307692,1
42,90,0.467,12,34,0.353,11,12,0.917,7,35,42,17,6,7,6,13,30,56,0.5357142857142857,1
42,94,0.447,10,30,0.333,11,15,0.733,13,36,49,21,3,4,11,16,32,64,0.5,0
49,88,0.557,8,20,0.4,12,15,0.8,7,34,41,26,4,4,16,24,41,68,0.6029411764705882,0
46,93,0.495,10,32,0.313,23,33,0.697,13,27,40,27,10,5,11,18,36,61,0.5901639344262295,1
33,76,0.434,7,26,0.269,17,28,0.607,10,23,33,19,10,5,14,18,26,50,0.52,0
40,86,0.465,9,28,0.321,10,12,0.833,16,31,47,24,7,4,16,20,31,58,0.5344827586206896,1
45,100,0.45,7,20,0.35,15,21,0.714,16,26,42,18,12,5,9,23,38,80,0.475,1
34,81,0.42,12,47,0.255,29,33,0.879,12,38,50,20,3,11,16,21,22,34,0.6470588235294118,0
35,73,0.479,16,33,0.485,23,28,0.821,10,30,40,15,3,7,21,27,19,40,0.475,0
46,86,0.535,12,28,0.429,24,30,0.8,10,25,35,29,12,3,13,25,34,58,0.5862068965517241,1
33,82,0.402,8,28,0.286,24,35,0.686,9,27,36,20,6,2,11,13,25,54,0.46296296296296297,0
46,94,0.489,22,53,0.415,18,20,0.9,21,40,61,34,8,5,17,25,24,41,0.5853658536585366,1
39,92,0.424,12,34,0.353,18,23,0.783,15,28,43,23,10,4,17,20,27,58,0.46551724137931033,0
46,88,0.523,17,38,0.447,21,22,0.955,12,34,46,31,7,7,17,23,29,50,0.58,1
48,82,0.585,18,34,0.529,13,24,0.542,4,30,34,25,8,4,11,19,30,48,0.625,1
45,84,0.536,13,33,0.394,18,20,0.9,9,30,39,23,7,3,14,22,32,51,0.6274509803921569,0
36,80,0.45,10,33,0.303,27,31,0.871,8,31,39,24,9,6,9,23,26,47,0.5531914893617021,1
33,71,0.465,8,26,0.308,28,30,0.933,4,27,31,21,4,3,13,23,25,45,0.5555555555555556,0
31,84,0.369,12,44,0.273,18,22,0.818,6,35,41,17,5,12,14,21,19,40,0.475,0
36,94,0.383,12,33,0.364,17,23,0.739,13,41,54,15,8,2,11,20,24,61,0.39344262295081966,1
37,92,0.402,2,22,0.091,19,30,0.633,13,27,40,22,3,2,14,21,35,70,0.5,0
49,88,0.557,9,21,0.429,13,19,0.684,8,37,45,26,10,14,12,21,40,67,0.5970149253731343,1
46,85,0.541,8,23,0.348,29,38,0.763,9,24,33,20,6,4,11,25,38,62,0.6129032258064516,0
49,90,0.544,19,39,0.487,24,31,0.774,12,30,42,28,2,4,13,25,30,51,0.5882352941176471,1
35,82,0.427,11,29,0.379,14,18,0.778,8,27,35,24,8,6,18,24,24,53,0.4528301886792453,0
38,86,0.442,7,28,0.25,26,30,0.867,15,36,51,19,10,4,20,19,31,58,0.5344827586206896,1
43,89,0.483,13,36,0.361,14,18,0.778,10,45,55,25,6,2,15,19,30,53,0.5660377358490566,1
32,85,0.376,9,32,0.281,11,13,0.846,7,35,42,19,9,6,16,26,23,53,0.4339622641509434,0
39,84,0.464,20,38,0.526,22,27,0.815,12,33,45,24,4,4,14,18,19,46,0.41304347826086957,1
45,100,0.45,14,45,0.311,11,13,0.846,14,31,45,20,6,4,7,24,31,55,0.5636363636363636,0
29,81,0.358,9,30,0.3,27,30,0.9,13,32,45,14,6,2,13,21,20,51,0.39215686274509803,0
42,81,0.519,16,27,0.593,5,8,0.625,4,38,42,28,2,5,12,23,26,54,0.48148148148148145,1
38,84,0.452,16,38,0.421,27,31,0.871,10,27,37,16,8,3,10,23,22,46,0.4782608695652174,0
45,89,0.506,16,39,0.41,19,23,0.826,13,33,46,21,5,3,14,25,29,50,0.58,1
44,76,0.579,13,31,0.419,17,18,0.944,7,32,39,24,4,4,11,21,31,45,0.6888888888888889,1
38,86,0.442,20,39,0.513,12,18,0.667,13,20,33,17,4,2,10,17,18,47,0.3829787234042553,0
40,81,0.494,19,43,0.442,22,27,0.815,7,36,43,17,4,7,13,18,21,38,0.5526315789473685,1
43,100,0.43,13,41,0.317,12,14,0.857,16,34,50,23,7,1,9,22,30,59,0.5084745762711864,0
46,99,0.465,13,42,0.31,15,18,0.833,15,41,56,29,5,4,11,18,33,57,0.5789473684210527,1
40,91,0.44,11,33,0.333,12,14,0.857,8,32,40,25,6,3,12,20,29,58,0.5,0
32,94,0.34,13,44,0.295,18,22,0.818,14,33,47,20,5,5,9,18,19,50,0.38,0
42,84,0.5,12,33,0.364,19,25,0.76,4,40,44,24,6,7,6,21,30,51,0.5882352941176471,1
51,87,0.586,17,33,0.515,13,20,0.65,7,44,51,31,7,5,16,25,34,54,0.6296296296296297,1
38,96,0.396,8,35,0.229,19,25,0.76,13,28,41,18,5,3,8,18,30,61,0.4918032786885246,0
34,81,0.42,9,29,0.31,19,23,0.826,6,33,39,24,7,2,9,20,25,52,0.4807692307692308,0
36,82,0.439,15,39,0.385,26,28,0.929,9,39,48,24,4,2,11,22,21,43,0.4883720930232558,1
48,83,0.578,16,27,0.593,29,30,0.967,9,27,36,29,8,9,10,28,32,56,0.5714285714285714,1
37,84,0.44,14,40,0.35,38,42,0.905,11,23,34,24,8,4,11,21,23,44,0.5227272727272727,0
37,77,0.481,13,33,0.394,19,25,0.76,9,44,53,16,7,6,12,25,24,44,0.5454545454545454,1
31,89,0.348,5,30,0.167,14,22,0.636,10,31,41,15,3,1,8,20,26,59,0.4406779661016949,0
37,85,0.435,10,35,0.286,16,21,0.762,9,40,49,24,12,4,10,20,27,50,0.54,1
32,81,0.395,13,40,0.325,15,21,0.714,9,41,50,19,3,5,16,18,19,41,0.4634146341463415,0
39,85,0.459,17,34,0.5,25,28,0.893,7,35,42,23,7,4,11,16,22,51,0.43137254901960786,1
43,92,0.467,10,35,0.286,17,20,0.85,7,35,42,26,8,4,9,21,33,57,0.5789473684210527,0
40,96,0.417,12,38,0.316,22,34,0.647,12,36,48,21,7,6,11,30,28,58,0.4827586206896552,0
40,88,0.455,9,24,0.375,33,42,0.786,13,44,57,24,8,12,14,27,31,64,0.484375,1
40,92,0.435,11,40,0.275,18,23,0.783,13,31,44,18,3,12,11,21,29,52,0.5576923076923077,0
43,84,0.512,15,32,0.469,22,25,0.88,7,32,39,26,6,7,9,21,28,52,0.5384615384615384,1
47,103,0.456,21,48,0.438,25,29,0.862,10,35,45,25,6,6,14,31,26,55,0.4727272727272727,0
50,104,0.481,20,44,0.455,27,32,0.844,13,39,52,33,5,5,11,24,30,60,0.5,1
29,84,0.345,12,35,0.343,15,21,0.714,10,41,51,14,3,1,17,25,17,49,0.3469387755102041,0
43,94,0.457,14,42,0.333,15,21,0.714,3,44,47,29,7,4,4,22,29,52,0.5576923076923077,1
37,89,0.416,14,36,0.389,17,19,0.895,11,34,45,21,9,2,9,23,23,53,0.4339622641509434,1
33,80,0.413,14,38,0.368,20,25,0.8,10,37,47,25,5,10,12,20,19,42,0.4523809523809524,0
37,87,0.425,9,34,0.265,20,26,0.769,14,34,48,17,7,8,11,16,28,53,0.5283018867924528,1
31,82,0.378,12,30,0.4,15,18,0.833,14,31,45,19,5,4,17,22,19,52,0.36538461538461536,0
39,79,0.494,8,20,0.4,26,33,0.788,7,31,38,22,4,3,15,30,31,59,0.5254237288135594,0
43,84,0.512,9,27,0.333,34,43,0.791,8,32,40,28,9,6,9,25,34,57,0.5964912280701754,1
44,95,0.463,14,39,0.359,8,9,0.889,8,31,39,23,7,6,14,12,30,56,0.5357142857142857,0
49,95,0.516,17,44,0.386,11,12,0.917,11,40,51,27,10,5,15,16,32,51,0.6274509803921569,1
37,73,0.507,18,35,0.514,21,22,0.955,8,34,42,24,5,9,14,17,19,38,0.5,1
38,91,0.418,10,35,0.286,14,16,0.875,11,24,35,21,5,3,7,20,28,56,0.5,0
44,86,0.512,15,34,0.441,23,27,0.852,10,29,39,28,8,3,12,18,29,52,0.5576923076923077,1
40,79,0.506,15,36,0.417,20,22,0.909,8,29,37,24,7,7,17,22,25,43,0.5813953488372093,0
36,77,0.468,10,34,0.294,22,28,0.786,6,36,42,18,7,3,14,14,26,43,0.6046511627906976,1
37,89,0.416,11,34,0.324,12,14,0.857,8,34,42,23,9,2,12,21,26,55,0.4727272727272727,0
45,101,0.446,6,30,0.2,11,19,0.579,15,43,58,21,4,3,14,15,39,71,0.5492957746478874,0
46,98,0.469,15,39,0.385,8,9,0.889,6,41,47,25,7,6,9,21,31,59,0.5254237288135594,1
45,91,0.495,10,36,0.278,11,17,0.647,16,31,47,22,4,1,14,21,35,55,0.6363636363636364,0
41,82,0.5,20,43,0.465,24,24,1.0,8,27,35,30,11,2,9,21,21,39,0.5384615384615384,1
44,86,0.512,20,47,0.426,20,21,0.952,3,32,35,23,10,3,17,26,24,39,0.6153846153846154,1
45,82,0.549,10,29,0.345,24,35,0.686,8,33,41,25,12,5,19,22,35,53,0.660377358490566,0
37,84,0.44,8,27,0.296,4,9,0.444,11,33,44,14,2,3,16,12,29,57,0.5087719298245614,0
49,94,0.521,21,42,0.5,6,7,0.857,9,33,42,27,8,3,9,17,28,52,0.5384615384615384,1
43,92,0.467,14,40,0.35,5,6,0.833,11,30,41,26,10,4,12,17,29,52,0.5576923076923077,0
46,85,0.541,13,34,0.382,17,20,0.85,7,37,44,30,8,4,10,12,33,51,0.6470588235294118,1
38,83,0.458,11,30,0.367,15,18,0.833,12,33,45,20,2,5,18,21,27,53,0.5094339622641509,0
46,87,0.529,12,26,0.462,14,22,0.636,6,31,37,29,10,8,9,18,34,61,0.5573770491803278,1
36,85,0.424,16,42,0.381,21,24,0.875,9,33,42,22,3,6,9,24,20,43,0.46511627906976744,0
37,91,0.407,17,50,0.34,21,26,0.808,12,34,46,18,5,6,7,24,20,41,0.4878048780487805,1
36,90,0.4,14,43,0.326,12,20,0.6,11,35,46,24,4,6,11,21,22,47,0.46808510638297873,0
45,94,0.479,18,38,0.474,15,17,0.882,8,44,52,27,3,4,7,18,27,56,0.48214285714285715,1
34,94,0.362,8,32,0.25,7,8,0.875,7,43,50,15,8,5,8,22,26,62,0.41935483870967744,0
34,90,0.378,6,31,0.194,12,19,0.632,7,49,56,12,3,8,11,12,28,59,0.4745762711864407,1
40,85,0.471,11,30,0.367,20,23,0.87,7,30,37,19,6,3,12,25,29,55,0.5272727272727272,0
42,76,0.553,20,39,0.513,13,21,0.619,2,34,36,15,4,3,16,23,22,37,0.5945945945945946,1
46,79,0.582,10,21,0.476,25,39,0.641,10,26,36,28,8,4,11,26,36,58,0.6206896551724138,1
39,82,0.476,6,23,0.261,27,32,0.844,11,25,36,15,6,1,11,28,33,59,0.559322033898305,0
43,81,0.531,12,26,0.462,18,20,0.9,4,34,38,26,10,2,12,13,31,55,0.5636363636363636,1
39,95,0.411,14,41,0.341,10,16,0.625,18,28,46,21,4,3,14,21,25,54,0.46296296296296297,0
36,84,0.429,19,44,0.432,15,17,0.882,9,29,38,15,7,1,16,22,17,40,0.425,0
50,89,0.562,19,36,0.528,13,16,0.813,10,31,41,21,6,2,9,18,31,53,0.5849056603773585,1
44,85,0.518,8,22,0.364,29,31,0.935,7,41,48,18,6,6,15,21,36,63,0.5714285714285714,1
45,98,0.459,14,37,0.378,14,21,0.667,7,30,37,22,6,3,8,24,31,61,0.5081967213114754,0
36,83,0.434,10,33,0.303,14,18,0.778,3,40,43,20,7,3,17,20,26,50,0.52,0
39,88,0.443,16,47,0.34,13,20,0.65,4,38,42,27,10,7,14,22,23,41,0.5609756097560976,1
37,85,0.435,11,27,0.407,15,21,0.714,8,47,55,23,2,6,12,18,26,58,0.4482758620689655,0
37,101,0.366,12,40,0.3,17,21,0.81,12,37,49,24,5,4,4,18,25,61,0.4098360655737705,1
33,77,0.429,17,42,0.405,21,26,0.808,8,31,39,19,4,3,11,32,16,35,0.45714285714285713,0
36,77,0.468,15,37,0.405,31,38,0.816,10,34,44,19,8,7,11,24,21,40,0.525,1
41,83,0.494,13,32,0.406,13,17,0.765,4,31,35,18,6,5,12,24,28,51,0.5490196078431373,0
38,77,0.494,16,43,0.372,22,25,0.88,2,34,36,27,4,4,10,19,22,34,0.6470588235294118,1
39,85,0.459,9,26,0.346,22,28,0.786,10,30,40,14,10,4,11,28,30,59,0.5084745762711864,1
35,75,0.467,13,30,0.433,23,38,0.605,7,37,44,20,7,6,16,21,22,45,0.4888888888888889,0
41,80,0.513,16,40,0.4,21,25,0.84,8,31,39,17,11,3,14,22,25,40,0.625,1
36,80,0.45,20,54,0.37,19,27,0.704,7,29,36,15,7,1,14,21,16,26,0.6153846153846154,0
36,81,0.444,9,30,0.3,8,14,0.571,9,30,39,14,11,1,16,18,27,51,0.5294117647058824,0
37,82,0.451,7,33,0.212,23,28,0.821,15,36,51,14,12,6,15,13,30,49,0.6122448979591837,1
38,93,0.409,12,29,0.414,16,23,0.696,14,37,51,15,7,5,11,24,26,64,0.40625,1
38,92,0.413,10,31,0.323,13,24,0.542,8,39,47,19,6,3,12,22,28,61,0.45901639344262296,0
42,86,0.488,21,44,0.477,14,19,0.737,16,27,43,19,4,0,16,19,21,42,0.5,0
48,85,0.565,20,39,0.513,15,17,0.882,10,23,33,27,13,6,8,16,28,46,0.6086956521739131,1
43,98,0.439,15,36,0.417,14,21,0.667,18,30,48,20,9,7,8,20,28,62,0.45161290322580644,1
39,84,0.464,12,39,0.308,21,25,0.84,11,35,46,23,4,3,13,20,27,45,0.6,0
36,81,0.444,7,27,0.259,24,32,0.75,6,38,44,22,9,1,10,23,29,54,0.5370370370370371,1
34,80,0.425,9,28,0.321,19,25,0.76,7,41,48,26,7,4,17,28,25,52,0.4807692307692308,0
40,88,0.455,20,47,0.426,14,17,0.824,10,29,39,23,6,3,9,17,20,41,0.4878048780487805,0
49,89,0.551,13,32,0.406,9,9,1.0,7,36,43,31,5,3,7,16,36,57,0.631578947368421,1
36,80,0.45,13,34,0.382,18,24,0.75,7,32,39,18,3,4,10,19,23,46,0.5,0
41,82,0.5,6,26,0.231,16,18,0.889,7,32,39,24,5,3,9,20,35,56,0.625,1
47,95,0.495,8,32,0.25,14,16,0.875,12,39,51,19,5,2,13,17,39,63,0.6190476190476191,1
47,102,0.461,8,36,0.222,11,14,0.786,12,33,45,27,6,4,8,14,39,66,0.5909090909090909,0
35,90,0.389,10,32,0.313,12,13,0.923,11,32,43,24,5,3,11,19,25,58,0.43103448275862066,0
37,82,0.451,12,34,0.353,20,24,0.833,10,41,51,20,8,5,12,15,25,48,0.5208333333333334,1
34,82,0.415,9,36,0.25,14,17,0.824,7,27,34,13,8,4,20,22,25,46,0.5434782608695652,0
50,96,0.521,15,41,0.366,10,16,0.625,16,31,47,29,14,3,16,20,35,55,0.6363636363636364,1
31,86,0.36,4,20,0.2,18,21,0.857,17,42,59,16,4,8,14,27,27,66,0.4090909090909091,1
27,83,0.325,5,31,0.161,21,32,0.656,15,36,51,13,4,2,12,19,22,52,0.4230769230769231,0
45,88,0.511,11,29,0.379,12,21,0.571,15,35,50,27,8,5,12,18,34,59,0.576271186440678,1
39,84,0.464,15,37,0.405,9,16,0.563,9,26,35,20,8,7,12,22,24,47,0.5106382978723404,0
46,84,0.548,10,30,0.333,14,15,0.933,2,38,40,20,8,2,10,16,36,54,0.6666666666666666,1
38,84,0.452,9,26,0.346,17,20,0.85,7,34,41,22,6,1,14,19,29,58,0.5,0
33,84,0.393,8,39,0.205,14,19,0.737,12,31,43,19,6,3,15,18,25,45,0.5555555555555556,0
43,85,0.506,13,38,0.342,11,13,0.846,8,35,43,26,11,4,12,22,30,47,0.6382978723404256,1
53,94,0.564,17,31,0.548,7,11,0.636,10,37,47,27,5,4,10,21,36,63,0.5714285714285714,1
33,79,0.418,12,39,0.308,25,32,0.781,7,25,32,18,5,3,10,11,21,40,0.525,0
41,90,0.456,15,38,0.395,15,19,0.789,13,27,40,24,6,5,14,22,26,52,0.5,0
48,95,0.505,9,29,0.31,18,25,0.72,14,33,47,28,11,5,9,17,39,66,0.5909090909090909,1
41,89,0.461,17,45,0.378,19,21,0.905,12,34,46,24,11,5,15,23,24,44,0.5454545454545454,1
38,92,0.413,12,32,0.375,19,23,0.826,13,30,43,22,11,2,16,16,26,60,0.43333333333333335,0
40,88,0.455,16,36,0.444,9,16,0.563,9,38,47,21,4,2,14,18,24,52,0.46153846153846156,0
41,88,0.466,11,34,0.324,25,26,0.962,6,37,43,18,9,1,9,14,30,54,0.5555555555555556,1
42,93,0.452,9,31,0.29,15,23,0.652,18,28,46,21,8,7,9,17,33,62,0.532258064516129,0
43,88,0.489,20,40,0.5,12,14,0.857,11,32,43,26,7,2,13,19,23,48,0.4791666666666667,1
40,83,0.482,9,31,0.29,11,16,0.688,6,30,36,21,3,3,15,24,31,52,0.5961538461538461,0
43,90,0.478,14,36,0.389,20,26,0.769,13,34,47,28,8,2,9,18,29,54,0.5370370370370371,1
40,78,0.513,7,23,0.304,16,19,0.842,5,35,40,18,3,9,17,24,33,55,0.6,0
39,97,0.402,7,29,0.241,24,29,0.828,17,31,48,22,11,3,5,18,32,68,0.47058823529411764,1
50,87,0.575,14,28,0.5,9,17,0.529,11,26,37,26,7,1,12,17,36,59,0.6101694915254238,1
48,87,0.552,13,19,0.684,10,11,0.909,8,27,35,23,9,5,9,20,35,68,0.5147058823529411,0
38,86,0.442,6,25,0.24,16,19,0.842,6,31,37,14,11,4,15,21,32,61,0.5245901639344263,0
37,82,0.451,6,27,0.222,25,29,0.862,11,42,53,20,10,6,19,17,31,55,0.5636363636363636,1
41,93,0.441,14,39,0.359,25,30,0.833,9,41,50,30,9,2,17,18,27,54,0.5,1
45,95,0.474,15,42,0.357,9,19,0.474,5,40,45,21,7,4,18,25,30,53,0.5660377358490566,0
37,84,0.44,17,32,0.531,13,23,0.565,5,39,44,19,3,9,13,17,20,52,0.38461538461538464,0
48,105,0.457,17,45,0.378,14,18,0.778,13,41,54,25,8,9,8,19,31,60,0.5166666666666667,1
42,90,0.467,17,47,0.362,21,24,0.875,8,43,51,29,2,10,17,24,25,43,0.5813953488372093,0
46,107,0.43,13,31,0.419,18,27,0.667,12,34,46,29,9,5,8,21,33,76,0.4342105263157895,1
37,86,0.43,7,23,0.304,13,15,0.867,9,39,48,18,8,5,17,19,30,63,0.47619047619047616,1
36,90,0.4,6,28,0.214,10,13,0.769,11,36,47,17,7,5,17,16,30,62,0.4838709677419355,0
47,93,0.505,14,38,0.368,13,18,0.722,7,29,36,38,6,5,11,17,33,55,0.6,0
53,100,0.53,14,33,0.424,12,12,1.0,13,40,53,28,8,8,12,15,39,67,0.582089552238806,1
40,88,0.455,11,33,0.333,15,22,0.682,12,29,41,21,13,3,24,25,29,55,0.5272727272727272,0
42,87,0.483,16,38,0.421,24,31,0.774,13,33,46,26,18,12,18,22,26,49,0.5306122448979592,1
44,85,0.518,13,25,0.52,16,20,0.8,6,41,47,24,9,5,13,11,31,60,0.5166666666666667,1
39,93,0.419,13,30,0.433,6,9,0.667,10,34,44,28,5,6,14,16,26,63,0.4126984126984127,0
48,117,0.41,21,57,0.368,17,23,0.739,15,41,56,34,13,9,18,24,27,60,0.45,0
51,105,0.486,17,45,0.378,19,27,0.704,7,48,55,27,9,10,19,22,34,60,0.5666666666666667,1
44,83,0.53,17,39,0.436,5,9,0.556,6,40,46,25,9,1,19,20,27,44,0.6136363636363636,1
36,87,0.414,14,37,0.378,12,17,0.706,11,34,45,23,9,3,18,18,22,50,0.44,0
42,92,0.457,17,41,0.415,23,29,0.793,7,36,43,24,6,4,10,22,25,51,0.49019607843137253,1
45,93,0.484,12,35,0.343,19,22,0.864,9,40,49,25,5,5,13,22,33,58,0.5689655172413793,0
35,86,0.407,9,29,0.31,18,23,0.783,13,31,44,17,6,6,16,20,26,57,0.45614035087719296,0
49,98,0.5,13,30,0.433,12,18,0.667,13,30,43,32,8,3,8,22,36,68,0.5294117647058824,1
36,81,0.444,5,27,0.185,21,26,0.808,7,44,51,20,14,8,22,17,31,54,0.5740740740740741,1
30,97,0.309,7,34,0.206,16,22,0.727,19,35,54,14,10,4,19,21,23,63,0.36507936507936506,0
34,91,0.374,7,35,0.2,11,18,0.611,15,35,50,19,4,2,15,15,27,56,0.48214285714285715,0
40,91,0.44,14,47,0.298,13,15,0.867,12,41,53,18,6,5,10,19,26,44,0.5909090909090909,1
31,93,0.333,13,43,0.302,12,13,0.923,10,40,50,16,7,3,15,21,18,50,0.36,0
45,94,0.479,15,35,0.429,8,9,0.889,6,49,55,31,8,9,13,16,30,59,0.5084745762711864,1
42,96,0.438,14,40,0.35,15,21,0.714,8,31,39,24,9,2,7,25,28,56,0.5,0
43,83,0.518,15,31,0.484,14,22,0.636,10,43,53,27,5,4,21,20,28,52,0.5384615384615384,1
32,84,0.381,12,42,0.286,19,29,0.655,5,33,38,19,6,0,15,26,20,42,0.47619047619047616,0
51,96,0.531,15,35,0.429,20,31,0.645,11,47,58,28,8,2,11,26,36,61,0.5901639344262295,1
42,100,0.42,10,35,0.286,21,21,1.0,21,39,60,22,16,2,12,13,32,65,0.49230769230769234,1
32,82,0.39,11,34,0.324,8,11,0.727,10,32,42,19,6,12,25,19,21,48,0.4375,0
42,87,0.483,15,29,0.517,13,16,0.813,9,33,42,26,7,5,17,20,27,58,0.46551724137931033,0
47,89,0.528,14,28,0.5,20,25,0.8,11,35,46,32,9,7,14,14,33,61,0.5409836065573771,1
48,91,0.527,13,32,0.406,14,17,0.824,11,35,46,32,13,1,18,16,35,59,0.5932203389830508,1
43,84,0.512,9,31,0.29,17,20,0.85,7,29,36,26,9,3,19,15,34,53,0.6415094339622641,0
40,84,0.476,6,24,0.25,10,14,0.714,7,32,39,24,11,2,20,17,34,60,0.5666666666666667,0
44,86,0.512,9,30,0.3,5,8,0.625,8,33,41,26,10,2,21,21,35,56,0.625,1
34,91,0.374,14,43,0.326,9,16,0.563,8,31,39,22,9,4,19,21,20,48,0.4166666666666667,0
48,95,0.505,17,38,0.447,11,14,0.786,10,44,54,29,12,10,17,18,31,57,0.543859649122807,1
42,86,0.488,10,32,0.313,21,28,0.75,7,40,47,31,8,2,12,22,32,54,0.5925925925925926,1
34,86,0.395,15,34,0.441,22,29,0.759,12,34,46,25,7,3,16,26,19,52,0.36538461538461536,0
44,88,0.5,24,54,0.444,9,17,0.529,6,32,38,34,10,4,11,19,20,34,0.5882352941176471,1
33,83,0.398,17,43,0.395,13,15,0.867,9,37,46,24,5,3,19,18,16,40,0.4,0
41,88,0.466,12,38,0.316,20,24,0.833,11,36,47,26,6,6,13,16,29,50,0.58,1
43,91,0.473,14,36,0.389,9,11,0.818,5,30,35,17,8,9,10,21,29,55,0.5272727272727272,0
37,90,0.411,16,42,0.381,20,23,0.87,13,38,51,16,14,3,19,17,21,48,0.4375,1
39,99,0.394,8,36,0.222,15,21,0.714,16,36,52,20,15,5,15,22,31,63,0.49206349206349204,0
52,97,0.536,15,34,0.441,15,20,0.75,7,35,42,28,5,6,12,22,37,63,0.5873015873015873,0
49,94,0.521,19,38,0.5,18,19,0.947,6,32,38,24,5,6,9,21,30,56,0.5357142857142857,1
34,88,0.386,5,28,0.179,9,15,0.6,11,42,53,14,9,8,23,17,29,60,0.48333333333333334,0
35,84,0.417,11,26,0.423,16,19,0.842,3,39,42,24,13,11,13,17,24,58,0.41379310344827586,1
38,99,0.384,10,34,0.294,9,15,0.6,17,37,54,20,5,3,9,23,28,65,0.4307692307692308,0
37,89,0.416,7,28,0.25,20,27,0.741,12,42,54,23,6,6,10,16,30,61,0.4918032786885246,1
35,91,0.385,9,33,0.273,12,14,0.857,10,45,55,18,4,2,22,25,26,58,0.4482758620689655,0
38,97,0.392,10,39,0.256,16,21,0.762,14,41,55,18,10,5,16,18,28,58,0.4827586206896552,1
42,90,0.467,15,36,0.417,21,25,0.84,13,35,48,26,5,3,11,19,27,54,0.5,1
43,99,0.434,13,39,0.333,15,17,0.882,14,30,44,23,7,4,7,21,30,60,0.5,0
31,89,0.348,9,40,0.225,18,23,0.783,21,40,61,15,10,5,30,22,22,49,0.4489795918367347,0
39,96,0.406,12,38,0.316,6,10,0.6,13,34,47,22,13,8,20,25,27,58,0.46551724137931033,1
43,89,0.483,9,28,0.321,10,15,0.667,7,31,38,27,6,1,14,19,34,61,0.5573770491803278,0
51,94,0.543,21,50,0.42,11,17,0.647,8,40,48,24,8,5,9,15,30,44,0.6818181818181818,1
44,83,0.53,15,35,0.429,18,22,0.818,7,37,44,21,6,5,22,15,29,48,0.6041666666666666,1
48,99,0.485,10,39,0.256,5,6,0.833,10,28,38,29,10,4,13,18,38,60,0.6333333333333333,0
38,91,0.418,14,42,0.333,13,18,0.722,13,37,50,24,6,6,9,22,24,49,0.4897959183673469,1
34,85,0.4,11,37,0.297,16,23,0.696,11,38,49,17,7,6,12,23,23,48,0.4791666666666667,0
43,94,0.457,10,30,0.333,15,19,0.789,10,38,48,26,10,5,12,17,33,64,0.515625,1
38,87,0.437,9,35,0.257,10,12,0.833,9,35,44,18,10,8,17,19,29,52,0.5576923076923077,0
38,86,0.442,15,47,0.319,16,20,0.8,6,37,43,22,10,6,12,22,23,39,0.5897435897435898,1
32,75,0.427,14,32,0.438,19,24,0.792,5,35,40,20,7,4,20,20,18,43,0.4186046511627907,0
45,100,0.45,13,35,0.371,15,18,0.833,18,31,49,25,13,4,17,20,32,65,0.49230769230769234,0
45,84,0.536,16,30,0.533,15,22,0.682,9,27,36,29,10,12,17,14,29,54,0.5370370370370371,1
36,88,0.409,12,43,0.279,26,34,0.765,10,47,57,22,7,4,13,25,24,45,0.5333333333333333,1
37,100,0.37,13,48,0.271,17,25,0.68,16,36,52,20,8,8,12,21,24,52,0.46153846153846156,0
41,88,0.466,17,41,0.415,16,20,0.8,12,35,47,25,4,9,12,17,24,47,0.5106382978723404,1
40,84,0.476,8,31,0.258,15,19,0.789,6,36,42,24,9,4,11,17,32,53,0.6037735849056604,0
43,97,0.443,13,37,0.351,20,24,0.833,14,29,43,26,12,3,7,13,30,60,0.5,1
42,86,0.488,15,46,0.326,8,13,0.615,10,37,47,26,0,4,19,16,27,40,0.675,0
40,91,0.44,9,33,0.273,15,18,0.833,11,25,36,26,7,6,14,15,31,58,0.5344827586206896,0
46,90,0.511,12,32,0.375,18,21,0.857,10,39,49,24,11,3,16,19,34,58,0.5862068965517241,1
33,95,0.347,9,39,0.231,15,20,0.75,10,43,53,16,5,5,12,17,24,56,0.42857142857142855,0
40,94,0.426,10,35,0.286,14,17,0.824,7,47,54,23,6,4,9,19,30,59,0.5084745762711864,1
50,101,0.495,19,50,0.38,21,25,0.84,11,42,53,33,8,9,12,23,31,51,0.6078431372549019,1
46,103,0.447,19,44,0.432,18,28,0.643,14,38,52,26,4,6,14,25,27,59,0.4576271186440678,0
38,82,0.463,7,25,0.28,16,20,0.8,11,38,49,26,8,5,16,18,31,57,0.543859649122807,1
35,86,0.407,9,38,0.237,8,12,0.667,11,36,47,21,10,3,22,22,26,48,0.5416666666666666,0
41,85,0.482,11,32,0.344,26,31,0.839,7,35,42,24,13,6,14,19,30,53,0.5660377358490566,1
40,90,0.444,14,36,0.389,15,17,0.882,12,35,47,23,6,1,19,24,26,54,0.48148148148148145,0
32,85,0.376,8,37,0.216,14,18,0.778,7,40,47,15,11,4,30,18,24,48,0.5,0
44,93,0.473,14,43,0.326,14,19,0.737,5,38,43,37,21,6,17,23,30,50,0.6,1
33,81,0.407,12,44,0.273,12,19,0.632,6,33,39,21,7,6,18,22,21,37,0.5675675675675675,0
41,87,0.471,6,27,0.222,19,19,1.0,9,33,42,28,10,2,11,19,35,60,0.5833333333333334,1
39,87,0.448,10,30,0.333,19,23,0.826,15,45,60,19,5,5,20,20,29,57,0.5087719298245614,1
31,90,0.344,15,50,0.3,21,27,0.778,11,30,41,20,10,7,11,19,16,40,0.4,0
39,81,0.481,12,27,0.444,21,22,0.955,5,24,29,24,11,3,13,16,27,54,0.5,1
40,83,0.482,12,30,0.4,16,20,0.8,13,34,47,27,8,1,21,18,28,53,0.5283018867924528,0
36,86,0.419,16,39,0.41,18,26,0.692,11,38,49,24,7,3,17,21,20,47,0.425531914893617,0
43,93,0.462,12,43,0.279,18,25,0.72,14,36,50,25,9,7,15,22,31,50,0.62,1
36,82,0.439,12,41,0.293,15,17,0.882,12,28,40,24,9,4,15,14,24,41,0.5853658536585366,0
41,87,0.471,16,37,0.432,14,15,0.933,13,32,45,24,7,5,15,18,25,50,0.5,1
39,83,0.47,14,40,0.35,14,18,0.778,7,39,46,30,9,8,15,20,25,43,0.5813953488372093,1
36,86,0.419,12,34,0.353,14,17,0.824,9,33,42,19,7,3,14,18,24,52,0.46153846153846156,0
50,105,0.476,8,30,0.267,17,22,0.773,9,47,56,20,8,10,13,21,42,75,0.56,1
48,108,0.444,13,36,0.361,12,22,0.545,16,43,59,33,10,6,16,22,35,72,0.4861111111111111,0
42,83,0.506,10,28,0.357,16,24,0.667,5,30,35,19,9,3,13,23,32,55,0.5818181818181818,0
44,85,0.518,12,39,0.308,22,29,0.759,8,33,41,20,5,6,14,22,32,46,0.6956521739130435,1
43,84,0.512,9,25,0.36,21,29,0.724,11,36,47,18,8,7,16,20,34,59,0.576271186440678,1
37,85,0.435,10,29,0.345,23,28,0.821,10,27,37,18,9,5,13,21,27,56,0.48214285714285715,0
38,96,0.396,8,29,0.276,22,26,0.846,17,45,62,21,6,2,15,19,30,67,0.44776119402985076,1
33,85,0.388,14,43,0.326,13,14,0.929,4,38,42,21,7,7,16,24,19,42,0.4523809523809524,0
33,81,0.407,3,20,0.15,23,27,0.852,14,43,57,12,9,3,21,14,30,61,0.4918032786885246,1
31,87,0.356,9,41,0.22,8,13,0.615,9,27,36,19,13,2,14,24,22,46,0.4782608695652174,0
43,91,0.473,13,45,0.289,14,17,0.824,10,39,49,29,5,4,17,20,30,46,0.6521739130434783,1
39,95,0.411,14,51,0.275,16,21,0.762,13,30,43,22,10,3,9,18,25,44,0.5681818181818182,0
40,96,0.417,8,30,0.267,14,17,0.824,21,34,55,21,4,4,11,14,32,66,0.48484848484848486,1
40,93,0.43,11,36,0.306,8,9,0.889,9,35,44,24,5,6,10,19,29,57,0.5087719298245614,0
46,92,0.5,11,35,0.314,12,14,0.857,10,30,40,29,8,2,17,22,35,57,0.6140350877192983,0
43,86,0.5,15,37,0.405,22,29,0.759,10,32,42,21,8,3,16,16,28,49,0.5714285714285714,1
43,83,0.518,14,30,0.467,20,24,0.833,10,30,40,22,14,4,17,14,29,53,0.5471698113207547,1
43,88,0.489,15,40,0.375,10,13,0.769,8,25,33,22,6,2,19,21,28,48,0.5833333333333334,0
42,95,0.442,15,38,0.395,11,15,0.733,8,32,40,28,7,6,12,20,27,57,0.47368421052631576,1
42,93,0.452,6,22,0.273,17,24,0.708,14,42,56,23,6,6,11,16,36,71,0.5070422535211268,0
35,96,0.365,17,50,0.34,9,19,0.474,21,29,50,27,9,3,22,25,18,46,0.391304347826087,0
39,84,0.464,15,36,0.417,23,31,0.742,13,35,48,22,11,6,14,20,24,48,0.5,1
38,79,0.481,10,29,0.345,14,17,0.824,9,31,40,19,6,7,23,19,28,50,0.56,0
46,100,0.46,14,30,0.467,12,19,0.632,16,25,41,22,18,6,12,20,32,70,0.45714285714285713,1
39,85,0.459,11,29,0.379,15,20,0.75,11,38,49,16,5,7,13,21,28,56,0.5,1
36,84,0.429,11,32,0.344,20,22,0.909,5,32,37,25,6,5,7,18,25,52,0.4807692307692308,0
39,88,0.443,12,30,0.4,9,15,0.6,11,37,48,21,6,11,15,16,27,58,0.46551724137931033,0
41,89,0.461,18,45,0.4,4,13,0.308,9,36,45,18,4,7,13,19,23,44,0.5227272727272727,1
39,97,0.402,12,48,0.25,14,14,1.0,10,41,51,25,17,9,18,14,27,49,0.5510204081632653,1
39,90,0.433,14,40,0.35,9,12,0.75,7,41,48,29,8,7,23,17,25,50,0.5,0
41,85,0.482,16,46,0.348,24,30,0.8,10,48,58,24,8,4,20,23,25,39,0.6410256410256411,1
31,95,0.326,9,44,0.205,20,23,0.87,13,28,41,15,8,3,11,24,22,51,0.43137254901960786,0
35,86,0.407,13,39,0.333,19,27,0.704,10,27,37,22,11,4,14,22,22,47,0.46808510638297873,0
38,76,0.5,12,27,0.444,22,24,0.917,6,40,46,22,7,9,21,23,26,49,0.5306122448979592,1
48,88,0.545,6,21,0.286,9,14,0.643,6,37,43,26,4,3,13,16,42,67,0.6268656716417911,0
46,99,0.465,13,34,0.382,17,21,0.81,14,37,51,26,6,4,9,16,33,65,0.5076923076923077,1
37,93,0.398,8,29,0.276,16,23,0.696,11,35,46,20,9,7,14,27,29,64,0.453125,0
34,76,0.447,6,26,0.231,31,41,0.756,10,40,50,20,9,6,18,21,28,50,0.56,1
23,78,0.295,8,37,0.216,21,27,0.778,6,30,36,14,8,3,15,17,15,41,0.36585365853658536,0
43,83,0.518,11,36,0.306,9,13,0.692,5,46,51,28,8,3,20,24,32,47,0.6808510638297872,1
37,87,0.425,12,34,0.353,15,22,0.682,16,20,36,28,10,1,15,13,25,53,0.4716981132075472,0
46,84,0.548,12,27,0.444,9,10,0.9,11,31,42,24,9,6,22,20,34,57,0.5964912280701754,1
35,90,0.389,13,37,0.351,16,22,0.727,11,26,37,21,8,6,11,17,22,53,0.41509433962264153,0
43,91,0.473,9,35,0.257,19,19,1.0,16,44,60,23,6,3,18,20,34,56,0.6071428571428571,1
40,80,0.5,9,27,0.333,24,25,0.96,3,42,45,19,4,5,14,20,31,53,0.5849056603773585,1
42,98,0.429,9,34,0.265,16,25,0.64,13,36,49,18,9,6,10,22,33,64,0.515625,0
34,87,0.391,15,42,0.357,9,16,0.563,6,37,43,17,7,5,13,14,19,45,0.4222222222222222,0
41,98,0.418,19,41,0.463,10,16,0.625,16,47,63,21,8,6,14,19,22,57,0.38596491228070173,1
41,87,0.471,16,34,0.471,11,16,0.688,12,34,46,24,1,5,17,24,25,53,0.4716981132075472,0
43,86,0.5,9,30,0.3,15,22,0.682,9,31,40,18,11,2,8,18,34,56,0.6071428571428571,1
35,92,0.38,11,38,0.289,18,19,0.947,14,40,54,15,5,7,20,21,24,54,0.4444444444444444,0
39,91,0.429,5,21,0.238,24,30,0.8,9,36,45,16,8,5,9,19,34,70,0.4857142857142857,1
38,87,0.437,16,32,0.5,11,15,0.733,12,34,46,21,5,6,18,21,22,55,0.4,0
36,89,0.404,14,43,0.326,24,30,0.8,17,31,48,26,12,6,16,18,22,46,0.4782608695652174,1
29,83,0.349,8,39,0.205,16,21,0.762,3,42,45,14,8,6,16,8,21,44,0.4772727272727273,0
39,92,0.424,21,54,0.389,4,8,0.5,10,46,56,30,9,8,16,21,18,38,0.47368421052631576,1
39,92,0.424,11,32,0.344,8,12,0.667,12,36,48,18,8,4,18,17,28,60,0.4666666666666667,1
35,81,0.432,13,43,0.302,11,16,0.688,8,32,40,25,8,10,20,17,22,38,0.5789473684210527,0
46,88,0.523,21,37,0.568,16,19,0.842,11,39,50,31,12,2,18,17,25,51,0.49019607843137253,1
34,88,0.386,16,50,0.32,19,21,0.905,8,24,32,26,14,7,14,17,18,38,0.47368421052631576,0
39,95,0.411,7,31,0.226,17,24,0.708,8,41,49,28,12,3,10,13,32,64,0.5,1
36,89,0.404,10,39,0.256,11,16,0.688,9,43,52,20,6,2,21,18,26,50,0.52,0
36,88,0.409,9,37,0.243,12,16,0.75,14,34,48,24,11,10,18,15,27,51,0.5294117647058824,1
35,89,0.393,13,41,0.317,8,9,0.889,15,31,46,21,8,6,20,23,22,48,0.4583333333333333,0
42,81,0.519,19,33,0.576,20,25,0.8,5,32,37,22,7,4,12,21,23,48,0.4791666666666667,1
42,92,0.457,11,33,0.333,22,24,0.917,12,31,43,30,7,3,12,24,31,59,0.5254237288135594,0
36,95,0.379,8,22,0.364,14,19,0.737,20,29,49,24,6,1,19,17,28,73,0.3835616438356164,0
46,86,0.535,12,38,0.316,18,19,0.947,5,32,37,24,11,6,12,24,34,48,0.7083333333333334,1
36,91,0.396,14,44,0.318,6,7,0.857,10,37,47,21,8,3,19,21,22,47,0.46808510638297873,0
39,84,0.464,6,26,0.231,17,27,0.63,8,44,52,27,12,3,15,14,33,58,0.5689655172413793,1
44,107,0.411,2,26,0.077,22,25,0.88,8,46,54,23,8,10,12,32,42,81,0.5185185185185185,0
38,104,0.365,10,36,0.278,29,36,0.806,12,50,62,19,6,7,13,22,28,68,0.4117647058823529,1
32,79,0.405,12,33,0.364,15,22,0.682,7,22,29,21,12,3,15,18,20,46,0.43478260869565216,0
47,72,0.653,13,25,0.52,10,16,0.625,2,39,41,30,7,2,20,19,34,47,0.723404255319149,1
43,97,0.443,17,54,0.315,10,11,0.909,15,32,47,30,4,5,12,18,26,43,0.6046511627906976,0
46,89,0.517,20,42,0.476,13,21,0.619,10,34,44,36,4,6,9,18,26,47,0.5531914893617021,1
38,96,0.396,7,36,0.194,16,20,0.8,17,39,56,20,6,3,13,19,31,60,0.5166666666666667,0
40,90,0.444,12,37,0.324,13,20,0.65,10,35,45,24,8,4,10,20,28,53,0.5283018867924528,1
32,76,0.421,6,28,0.214,15,29,0.517,10,45,55,18,8,3,27,18,26,48,0.5416666666666666,0
39,96,0.406,9,31,0.29,8,13,0.615,10,33,43,22,15,9,14,20,30,65,0.46153846153846156,1
35,75,0.467,12,37,0.324,25,27,0.926,7,37,44,13,6,10,13,10,23,38,0.6052631578947368,1
39,96,0.406,12,41,0.293,5,6,0.833,13,31,44,16,7,3,11,22,27,55,0.4909090909090909,0
41,86,0.477,13,39,0.333,16,16,1.0,7,29,36,27,7,4,12,24,28,47,0.5957446808510638,0
38,83,0.458,13,34,0.382,29,29,1.0,13,34,47,24,9,5,11,17,25,49,0.5102040816326531,1
49,86,0.57,13,31,0.419,17,18,0.944,10,40,50,30,7,8,18,19,36,55,0.6545454545454545,1
42,96,0.438,15,33,0.455,15,20,0.75,13,25,38,20,10,1,9,15,27,63,0.42857142857142855,0
39,90,0.433,9,28,0.321,26,38,0.684,17,32,49,21,12,7,16,14,30,62,0.4838709677419355,1
42,101,0.416,15,39,0.385,11,15,0.733,20,26,46,27,12,12,17,23,27,62,0.43548387096774194,0
47,89,0.528,14,28,0.5,10,14,0.714,8,28,36,34,6,4,17,9,33,61,0.5409836065573771,0
52,91,0.571,18,38,0.474,9,12,0.75,10,29,39,37,11,4,16,19,34,53,0.6415094339622641,1
35,90,0.389,11,37,0.297,13,16,0.813,10,41,51,17,8,6,16,18,24,53,0.4528301886792453,0
35,92,0.38,15,42,0.357,14,19,0.737,13,38,51,18,8,5,14,14,20,50,0.4,1
39,88,0.443,9,38,0.237,10,15,0.667,6,34,40,27,8,8,12,10,30,50,0.6,0
44,97,0.454,13,34,0.382,5,7,0.714,11,44,55,20,8,4,13,18,31,63,0.49206349206349204,1
37,82,0.451,17,43,0.395,24,30,0.8,12,39,51,21,5,7,16,19,20,39,0.5128205128205128,1
36,97,0.371,14,51,0.275,11,19,0.579,16,31,47,21,8,1,14,20,22,46,0.4782608695652174,0
43,99,0.434,14,42,0.333,13,14,0.929,13,35,48,24,12,4,9,20,29,57,0.5087719298245614,1
35,76,0.461,16,38,0.421,18,24,0.75,7,34,41,20,3,4,17,13,19,38,0.5,0
40,84,0.476,12,34,0.353,11,18,0.611,13,32,45,21,5,2,15,15,28,50,0.56,0
43,83,0.518,13,36,0.361,14,16,0.875,7,27,34,34,11,6,11,18,30,47,0.6382978723404256,1
43,83,0.518,13,25,0.52,26,30,0.867,9,36,45,25,6,5,7,25,30,58,0.5172413793103449,1
37,84,0.44,14,42,0.333,22,31,0.71,11,30,41,17,1,3,10,21,23,42,0.5476190476190477,0
42,84,0.5,17,37,0.459,16,21,0.762,9,43,52,28,7,8,17,23,25,47,0.5319148936170213,1
30,93,0.323,8,47,0.17,21,30,0.7,14,29,43,21,5,5,14,22,22,46,0.4782608695652174,0
48,91,0.527,16,42,0.381,5,12,0.417,11,27,38,27,8,4,25,21,32,49,0.6530612244897959,0
49,93,0.527,6,25,0.24,15,20,0.75,11,32,43,26,10,4,17,19,43,68,0.6323529411764706,1
36,91,0.396,13,39,0.333,15,16,0.938,14,29,43,21,17,6,18,16,23,52,0.4423076923076923,0
43,82,0.524,9,26,0.346,17,18,0.944,7,35,42,32,8,4,19,17,34,56,0.6071428571428571,1
42,93,0.452,12,31,0.387,17,24,0.708,6,32,38,24,8,8,11,24,30,62,0.4838709677419355,0
43,98,0.439,14,48,0.292,19,27,0.704,15,44,59,16,7,6,17,23,29,50,0.58,1
41,94,0.436,13,35,0.371,13,15,0.867,12,40,52,23,8,4,14,16,28,59,0.4745762711864407,0
43,88,0.489,22,48,0.458,9,12,0.75,7,35,42,34,7,8,16,18,21,40,0.525,1
40,90,0.444,13,37,0.351,11,17,0.647,10,29,39,24,12,6,9,19,27,53,0.5094339622641509,0
39,74,0.527,15,30,0.5,14,18,0.778,5,38,43,29,4,2,19,14,24,44,0.5454545454545454,1
34,91,0.374,10,36,0.278,14,19,0.737,9,40,49,18,10,2,16,14,24,55,0.43636363636363634,0
42,86,0.488,18,45,0.4,12,18,0.667,7,46,53,33,14,4,17,17,24,41,0.5853658536585366,1
36,87,0.414,5,24,0.208,21,27,0.778,14,32,46,23,7,6,10,19,31,63,0.49206349206349204,0
42,91,0.462,16,41,0.39,11,14,0.786,10,39,49,26,7,7,13,22,26,50,0.52,1
43,91,0.473,8,27,0.296,12,13,0.923,11,33,44,24,7,4,12,16,35,64,0.546875,0
42,81,0.519,16,34,0.471,8,14,0.571,3,33,36,28,9,7,12,16,26,47,0.5531914893617021,1
47,78,0.603,21,36,0.583,11,12,0.917,3,32,35,33,6,7,21,14,26,42,0.6190476190476191,1
43,94,0.457,14,40,0.35,15,16,0.938,15,24,39,27,11,2,17,16,29,54,0.5370370370370371,0
33,79,0.418,10,37,0.27,16,25,0.64,9,41,50,24,7,9,11,20,23,42,0.5476190476190477,1
27,84,0.321,9,43,0.209,16,20,0.8,8,38,46,15,8,1,15,20,18,41,0.43902439024390244,0
38,82,0.463,6,21,0.286,16,18,0.889,9,38,47,19,11,4,16,17,32,61,0.5245901639344263,0
38,77,0.494,12,28,0.429,15,21,0.714,5,30,35,24,9,4,14,15,26,49,0.5306122448979592,1
37,86,0.43,12,34,0.353,13,15,0.867,8,32,40,24,1,3,17,16,25,52,0.4807692307692308,0
42,80,0.525,10,30,0.333,18,22,0.818,4,33,37,27,8,7,8,21,32,50,0.64,1
40,93,0.43,8,34,0.235,21,29,0.724,15,41,56,21,10,4,19,23,32,59,0.5423728813559322,1
43,88,0.489,7,21,0.333,15,20,0.75,5,35,40,25,10,10,15,24,36,67,0.5373134328358209,0
41,88,0.466,10,25,0.4,17,20,0.85,10,32,42,17,10,3,12,23,31,63,0.49206349206349204,1
34,78,0.436,8,32,0.25,24,30,0.8,10,34,44,19,6,7,13,15,26,46,0.5652173913043478,0
41,81,0.506,17,41,0.415,17,23,0.739,8,38,46,30,6,4,17,20,24,40,0.6,1
35,82,0.427,7,28,0.25,21,26,0.808,5,27,32,18,11,4,9,24,28,54,0.5185185185185185,0
41,83,0.494,12,32,0.375,15,22,0.682,15,34,49,22,8,3,15,17,29,51,0.5686274509803921,1
35,87,0.402,11,36,0.306,17,19,0.895,12,29,41,21,6,2,11,18,24,51,0.47058823529411764,0
37,87,0.425,15,41,0.366,18,26,0.692,12,38,50,23,7,2,16,16,22,46,0.4782608695652174,1
39,94,0.415,12,33,0.364,14,17,0.824,16,33,49,22,8,5,14,21,27,61,0.4426229508196721,0
31,78,0.397,16,41,0.39,17,20,0.85,11,35,46,16,7,4,16,16,15,37,0.40540540540540543,1
28,81,0.346,9,41,0.22,13,19,0.684,13,32,45,18,8,0,18,19,19,40,0.475,0
38,88,0.432,11,32,0.344,24,28,0.857,7,36,43,25,4,4,19,21,27,56,0.48214285714285715,0
44,93,0.473,14,31,0.452,21,23,0.913,13,33,46,29,12,8,12,24,30,62,0.4838709677419355,1
36,80,0.45,11,27,0.407,13,14,0.929,4,41,45,25,3,4,17,21,25,53,0.4716981132075472,1
33,87,0.379,11,34,0.324,13,18,0.722,7,37,44,17,11,6,14,22,22,53,0.41509433962264153,0
31,88,0.352,11,44,0.25,12,16,0.75,11,31,42,23,6,3,19,18,20,44,0.45454545454545453,0
47,91,0.516,20,50,0.4,12,14,0.857,9,40,49,36,10,4,11,16,27,41,0.6585365853658537,1
41,96,0.427,10,40,0.25,21,26,0.808,20,39,59,16,12,4,15,17,31,56,0.5535714285714286,1
33,82,0.402,16,43,0.372,16,21,0.762,7,30,37,19,5,5,15,20,17,39,0.4358974358974359,0
36,88,0.409,6,28,0.214,26,32,0.813,15,47,62,18,12,4,17,16,30,60,0.5,1
31,89,0.348,17,52,0.327,5,7,0.714,7,35,42,17,8,7,22,33,14,37,0.3783783783783784,0
40,90,0.444,6,19,0.316,16,18,0.889,5,43,48,23,11,7,13,14,34,71,0.4788732394366197,1
35,89,0.393,12,41,0.293,7,10,0.7,7,36,43,23,9,12,18,13,23,48,0.4791666666666667,0
43,88,0.489,14,42,0.333,6,10,0.6,7,33,40,28,8,2,11,18,29,46,0.6304347826086957,0
40,82,0.488,17,39,0.436,13,15,0.867,6,36,42,27,7,4,14,15,23,43,0.5348837209302325,1
43,92,0.467,11,35,0.314,13,21,0.619,7,21,28,29,8,5,10,19,32,57,0.5614035087719298,0
48,87,0.552,22,44,0.5,22,26,0.846,13,43,56,29,5,1,18,21,26,43,0.6046511627906976,1
38,83,0.458,10,30,0.333,16,19,0.842,11,28,39,22,4,3,18,13,28,53,0.5283018867924528,1
42,99,0.424,12,27,0.444,5,9,0.556,19,26,45,20,10,8,10,19,30,72,0.4166666666666667,0
34,96,0.354,6,31,0.194,13,17,0.765,12,27,39,19,12,4,9,15,28,65,0.4307692307692308,0
49,84,0.583,10,25,0.4,7,13,0.538,5,48,53,34,4,6,19,13,39,59,0.6610169491525424,1
43,81,0.531,13,26,0.5,15,19,0.789,6,35,41,22,6,5,14,22,30,55,0.5454545454545454,1
37,92,0.402,7,29,0.241,24,30,0.8,18,28,46,20,7,1,9,19,30,63,0.47619047619047616,0
42,86,0.488,9,31,0.29,11,16,0.688,8,28,36,20,6,2,11,14,33,55,0.6,0
41,78,0.526,13,39,0.333,12,14,0.857,7,33,40,19,7,6,15,18,28,39,0.717948717948718,1
35,75,0.467,8,28,0.286,16,24,0.667,7,40,47,19,8,6,17,16,27,47,0.574468085106383,0
36,89,0.404,9,40,0.225,14,17,0.824,10,35,45,19,10,5,11,20,27,49,0.5510204081632653,1
43,83,0.518,15,45,0.333,14,19,0.737,7,24,31,26,10,3,6,19,28,38,0.7368421052631579,0
47,78,0.603,11,21,0.524,13,17,0.765,7,29,36,30,3,1,14,18,36,57,0.631578947368421,1
42,97,0.433,13,33,0.394,20,23,0.87,14,36,50,18,3,1,12,16,29,64,0.453125,0
45,88,0.511,14,43,0.326,17,21,0.81,5,37,42,26,8,6,12,22,31,45,0.6888888888888889,1
31,90,0.344,9,32,0.281,19,24,0.792,11,48,59,20,8,5,19,17,22,58,0.3793103448275862,0
36,95,0.379,15,55,0.273,18,24,0.75,12,40,52,22,14,7,12,21,21,40,0.525,1
36,79,0.456,10,33,0.303,25,37,0.676,12,30,42,17,11,3,21,16,26,46,0.5652173913043478,0
44,85,0.518,15,46,0.326,17,20,0.85,7,34,41,31,12,3,17,28,29,39,0.7435897435897436,1
41,101,0.406,10,33,0.303,14,18,0.778,12,32,44,20,13,2,13,21,31,68,0.45588235294117646,0
41,86,0.477,18,48,0.375,20,21,0.952,7,43,50,24,8,5,20,16,23,38,0.6052631578947368,1
49,90,0.544,19,35,0.543,9,11,0.818,11,37,48,31,8,2,17,18,30,55,0.5454545454545454,1
39,85,0.459,9,31,0.29,22,24,0.917,7,25,32,21,9,9,11,14,30,54,0.5555555555555556,0
41,100,0.41,6,30,0.2,6,9,0.667,11,35,46,29,9,10,10,16,35,70,0.5,0
35,94,0.372,12,42,0.286,17,20,0.85,15,42,57,21,5,7,15,14,23,52,0.4423076923076923,1
34,89,0.382,8,42,0.19,24,29,0.828,16,34,50,21,10,7,18,17,26,47,0.5531914893617021,0
43,87,0.494,12,32,0.375,9,11,0.818,7,32,39,24,8,8,13,22,31,55,0.5636363636363636,1
37,83,0.446,6,25,0.24,14,18,0.778,13,41,54,13,8,7,21,24,31,58,0.5344827586206896,1
31,84,0.369,10,34,0.294,19,22,0.864,8,25,33,20,14,6,12,18,21,50,0.42,0
41,80,0.513,17,38,0.447,17,20,0.85,12,36,48,29,3,0,16,15,24,42,0.5714285714285714,1
41,87,0.471,7,30,0.233,14,18,0.778,8,27,35,23,10,6,8,16,34,57,0.5964912280701754,0
37,94,0.394,10,36,0.278,10,18,0.556,16,33,49,17,14,3,13,10,27,58,0.46551724137931033,0
41,81,0.506,11,27,0.407,8,13,0.615,4,38,42,24,8,8,19,16,30,54,0.5555555555555556,1
34,86,0.395,11,33,0.333,16,19,0.842,6,36,42,19,6,7,15,16,23,53,0.4339622641509434,0
46,98,0.469,9,31,0.29,17,20,0.85,15,41,56,21,8,5,9,17,37,67,0.5522388059701493,1
37,87,0.425,9,34,0.265,9,11,0.818,9,30,39,27,7,0,14,16,28,53,0.5283018867924528,0
43,85,0.506,14,35,0.4,8,13,0.615,9,37,46,27,7,3,13,15,29,50,0.58,1
31,78,0.397,13,36,0.361,21,25,0.84,6,31,37,22,3,3,13,20,18,42,0.42857142857142855,0
42,91,0.462,12,41,0.293,17,24,0.708,12,37,49,28,7,5,10,23,30,50,0.6,1
38,82,0.463,17,43,0.395,20,26,0.769,3,32,35,21,6,2,18,16,21,39,0.5384615384615384,0
44,92,0.478,18,44,0.409,21,22,0.955,10,29,39,31,13,4,14,22,26,48,0.5416666666666666,1
43,99,0.434,14,42,0.333,23,28,0.821,14,41,55,23,5,3,18,23,29,57,0.5087719298245614,0
44,91,0.484,13,32,0.406,25,35,0.714,8,43,51,30,11,8,15,23,31,59,0.5254237288135594,1
41,97,0.423,17,45,0.378,19,23,0.826,15,30,45,23,7,8,16,27,24,52,0.46153846153846156,0
46,92,0.5,11,28,0.393,22,26,0.846,15,36,51,28,7,8,16,22,35,64,0.546875,1
40,91,0.44,13,40,0.325,10,13,0.769,14,41,55,25,4,4,13,18,27,51,0.5294117647058824,1
35,91,0.385,13,40,0.325,13,16,0.813,12,35,47,20,7,6,9,13,22,51,0.43137254901960786,0
44,93,0.473,12,30,0.4,9,11,0.818,5,33,38,28,14,9,15,21,32,63,0.5079365079365079,1
37,82,0.451,10,24,0.417,20,26,0.769,8,38,46,18,6,6,24,18,27,58,0.46551724137931033,0
43,91,0.473,14,37,0.378,9,12,0.75,9,34,43,29,6,5,10,15,29,54,0.5370370370370371,0
44,85,0.518,16,30,0.533,13,19,0.684,5,38,43,25,5,0,8,17,28,55,0.509090909090909,1
44,95,0.463,15,39,0.385,15,21,0.714,12,40,52,21,5,6,9,10,29,56,0.5178571428571429,1
42,103,0.408,14,43,0.326,11,12,0.917,13,33,46,21,7,7,7,20,28,60,0.4666666666666667,0
37,85,0.435,18,35,0.514,6,10,0.6,6,26,32,22,6,5,13,18,19,50,0.38,0
41,81,0.506,15,38,0.395,13,16,0.813,8,36,44,21,8,4,15,20,26,43,0.6046511627906976,1
33,77,0.429,6,25,0.24,16,19,0.842,6,35,41,20,8,8,18,17,27,52,0.5192307692307693,0
42,94,0.447,10,29,0.345,10,15,0.667,12,32,44,21,10,5,15,13,32,65,0.49230769230769234,1
38,83,0.458,12,33,0.364,19,24,0.792,8,35,43,23,9,4,12,16,26,50,0.52,0
45,89,0.506,15,31,0.484,12,14,0.857,8,38,46,26,9,2,11,15,30,58,0.5172413793103449,1
35,84,0.417,10,28,0.357,17,17,1.0,12,37,49,25,9,2,12,20,25,56,0.44642857142857145,1
35,76,0.461,9,31,0.29,15,21,0.714,6,34,40,21,7,4,15,18,26,45,0.5777777777777777,0
40,84,0.476,11,31,0.355,7,11,0.636,10,38,48,22,5,11,15,19,29,53,0.5471698113207547,0
36,84,0.429,12,30,0.4,17,20,0.85,11,28,39,19,5,4,10,14,24,54,0.4444444444444444,1
39,95,0.411,17,44,0.386,15,20,0.75,17,23,40,30,8,4,17,28,22,51,0.43137254901960786,0
40,85,0.471,11,40,0.275,32,40,0.8,20,33,53,23,14,6,16,21,29,45,0.6444444444444445,1
42,97,0.433,16,48,0.333,12,18,0.667,16,33,49,23,6,6,14,26,26,49,0.5306122448979592,1
35,82,0.427,12,34,0.353,22,34,0.647,8,34,42,17,5,5,16,20,23,48,0.4791666666666667,0
40,96,0.417,10,37,0.27,27,35,0.771,11,36,47,26,14,2,14,25,30,59,0.5084745762711864,0
46,92,0.5,18,38,0.474,10,16,0.625,9,41,50,26,5,6,23,27,28,54,0.5185185185185185,1
41,90,0.456,15,36,0.417,21,24,0.875,9,40,49,32,13,7,17,16,26,54,0.48148148148148145,1
45,107,0.421,9,38,0.237,9,15,0.6,20,37,57,27,14,8,16,18,36,69,0.5217391304347826,0
37,87,0.425,10,34,0.294,24,30,0.8,13,43,56,23,6,4,18,23,27,53,0.5094339622641509,1
34,97,0.351,9,35,0.257,23,32,0.719,19,31,50,24,13,5,10,20,25,62,0.4032258064516129,0
40,90,0.444,26,50,0.52,6,9,0.667,13,37,50,29,4,4,15,17,14,40,0.35,1
36,83,0.434,16,37,0.432,12,17,0.706,7,31,38,19,9,10,11,17,20,46,0.43478260869565216,0
44,91,0.484,7,30,0.233,14,16,0.875,14,32,46,24,5,2,16,21,37,61,0.6065573770491803,0
49,94,0.521,11,28,0.393,10,12,0.833,9,30,39,27,6,6,11,20,38,66,0.5757575757575758,1
47,91,0.516,10,36,0.278,13,16,0.813,11,33,44,20,4,6,15,26,37,55,0.6727272727272727,0
49,92,0.533,18,32,0.563,20,31,0.645,12,31,43,34,11,3,8,16,31,60,0.5166666666666667,1
43,97,0.443,9,41,0.22,14,17,0.824,18,32,50,18,9,4,15,21,34,56,0.6071428571428571,0
43,91,0.473,11,37,0.297,15,17,0.882,9,33,42,20,9,9,12,14,32,54,0.5925925925925926,1
42,96,0.438,14,33,0.424,17,17,1.0,16,31,47,25,10,7,12,18,28,63,0.4444444444444444,1
40,88,0.455,11,34,0.324,18,19,0.947,9,30,39,29,8,8,12,16,29,54,0.5370370370370371,0
43,96,0.448,11,31,0.355,14,19,0.737,15,38,53,19,7,5,13,23,32,65,0.49230769230769234,1
39,83,0.47,9,32,0.281,13,23,0.565,7,30,37,22,6,4,12,16,30,51,0.5882352941176471,0
44,98,0.449,16,47,0.34,9,11,0.818,12,27,39,23,7,3,13,19,28,51,0.5490196078431373,0
47,96,0.49,12,41,0.293,16,18,0.889,16,37,53,22,5,7,17,12,35,55,0.6363636363636364,1
36,93,0.387,13,35,0.371,11,18,0.611,14,37,51,17,8,5,19,22,23,58,0.39655172413793105,0
39,90,0.433,10,36,0.278,16,24,0.667,12,37,49,25,10,5,14,18,29,54,0.5370370370370371,1
29,79,0.367,9,30,0.3,11,13,0.846,10,33,43,18,12,5,23,13,20,49,0.40816326530612246,0
39,82,0.476,14,41,0.341,6,9,0.667,8,32,40,27,12,6,21,11,25,41,0.6097560975609756,1
38,93,0.409,5,28,0.179,15,21,0.714,14,36,50,20,2,5,8,20,33,65,0.5076923076923077,0
40,90,0.444,10,35,0.286,15,20,0.75,10,39,49,26,6,5,8,21,30,55,0.5454545454545454,1
34,78,0.436,8,27,0.296,17,22,0.773,7,31,38,18,9,2,20,16,26,51,0.5098039215686274,0
45,93,0.484,15,46,0.326,14,16,0.875,12,35,47,27,15,3,16,15,30,47,0.6382978723404256,1
34,87,0.391,11,36,0.306,25,31,0.806,11,41,52,21,10,4,14,27,23,51,0.45098039215686275,1
34,85,0.4,7,32,0.219,17,27,0.63,9,40,49,13,6,6,13,23,27,53,0.5094339622641509,0
43,94,0.457,12,37,0.324,9,12,0.75,14,40,54,24,10,4,16,21,31,57,0.543859649122807,1
29,82,0.354,9,41,0.22,16,20,0.8,11,33,44,17,12,8,20,14,20,41,0.4878048780487805,0
46,94,0.489,18,37,0.486,9,9,1.0,4,42,46,28,12,6,12,22,28,57,0.49122807017543857,1
37,98,0.378,7,33,0.212,13,23,0.565,17,42,59,19,6,6,15,16,30,65,0.46153846153846156,0
41,82,0.5,18,34,0.529,20,27,0.741,7,27,34,27,9,4,12,20,23,48,0.4791666666666667,1
43,88,0.489,13,32,0.406,13,16,0.813,12,31,43,26,6,5,16,26,30,56,0.5357142857142857,0
38,95,0.4,14,41,0.341,13,17,0.765,11,38,49,20,5,7,14,12,24,54,0.4444444444444444,0
42,99,0.424,10,30,0.333,11,15,0.733,16,36,52,13,8,6,10,18,32,69,0.463768115942029,1
46,100,0.46,18,45,0.4,13,19,0.684,10,38,48,30,9,7,6,18,28,55,0.509090909090909,1
41,84,0.488,13,30,0.433,14,20,0.7,3,38,41,30,3,3,13,17,28,54,0.5185185185185185,0
33,78,0.423,6,23,0.261,17,18,0.944,10,37,47,20,7,3,20,16,27,55,0.4909090909090909,0
31,81,0.383,10,38,0.263,19,22,0.864,9,30,39,17,10,4,11,19,21,43,0.4883720930232558,1
38,89,0.427,12,23,0.522,25,29,0.862,18,28,46,16,11,2,14,22,26,66,0.3939393939393939,0
47,82,0.573,14,28,0.5,10,15,0.667,7,30,37,33,7,10,15,21,33,54,0.6111111111111112,1
40,102,0.392,11,36,0.306,11,16,0.688,12,29,41,25,8,6,11,15,29,66,0.4393939393939394,0
53,99,0.535,16,40,0.4,7,9,0.778,11,46,57,35,6,8,14,17,37,59,0.6271186440677966,1
38,88,0.432,8,24,0.333,17,21,0.81,13,26,39,21,6,6,9,19,30,64,0.46875,0
38,79,0.481,14,29,0.483,22,25,0.88,8,29,37,29,5,6,14,22,24,50,0.48,1
42,84,0.5,12,35,0.343,8,10,0.8,7,41,48,29,6,7,16,17,30,49,0.6122448979591837,1
31,92,0.337,13,40,0.325,17,20,0.85,14,30,44,21,7,5,13,15,18,52,0.34615384615384615,0
43,79,0.544,15,35,0.429,26,30,0.867,9,25,34,34,5,6,14,23,28,44,0.6363636363636364,1
44,87,0.506,13,34,0.382,20,31,0.645,15,24,39,21,9,1,13,25,31,53,0.5849056603773585,0
42,85,0.494,13,33,0.394,14,16,0.875,13,35,48,23,6,3,21,25,29,52,0.5576923076923077,1
35,85,0.412,17,53,0.321,18,25,0.72,12,26,38,23,13,2,17,19,18,32,0.5625,0
38,84,0.452,14,41,0.341,10,16,0.625,4,26,30,24,8,3,11,17,24,43,0.5581395348837209,0
47,97,0.485,15,35,0.429,11,13,0.846,15,36,51,21,6,1,13,19,32,62,0.5161290322580645,1
38,90,0.422,9,39,0.231,17,25,0.68,11,38,49,31,8,7,15,17,29,51,0.5686274509803921,0
42,88,0.477,14,36,0.389,8,12,0.667,4,35,39,23,10,2,13,21,28,52,0.5384615384615384,1
35,80,0.438,13,39,0.333,12,13,0.923,8,28,36,22,8,4,13,15,22,41,0.5365853658536586,0
47,90,0.522,19,40,0.475,11,14,0.786,14,35,49,29,9,1,11,14,28,50,0.56,1
42,97,0.433,14,40,0.35,17,20,0.85,12,40,52,19,16,7,10,19,28,57,0.49122807017543857,1
35,85,0.412,7,32,0.219,12,18,0.667,9,39,48,19,7,5,23,19,28,53,0.5283018867924528,0
38,86,0.442,11,29,0.379,13,14,0.929,7,38,45,19,9,4,15,20,27,57,0.47368421052631576,1
29,81,0.358,11,34,0.324,21,21,1.0,9,35,44,16,7,7,20,15,18,47,0.3829787234042553,0
40,90,0.444,16,36,0.444,10,15,0.667,11,32,43,28,9,2,15,17,24,54,0.4444444444444444,0
43,83,0.518,15,31,0.484,13,17,0.765,9,37,46,28,6,5,16,16,28,52,0.5384615384615384,1
41,82,0.5,18,43,0.419,20,21,0.952,7,37,44,31,8,3,15,15,23,39,0.5897435897435898,1
36,90,0.4,14,45,0.311,10,11,0.909,10,34,44,20,9,2,14,22,22,45,0.4888888888888889,0
43,95,0.453,16,43,0.372,9,14,0.643,12,29,41,30,8,5,16,27,27,52,0.5192307692307693,0
47,85,0.553,14,30,0.467,21,32,0.656,9,37,46,32,10,7,11,17,33,55,0.6,1
36,78,0.462,10,29,0.345,16,20,0.8,6,40,46,23,7,6,14,16,26,49,0.5306122448979592,1
32,83,0.386,16,40,0.4,12,16,0.75,7,35,42,18,6,3,14,18,16,43,0.37209302325581395,0
40,84,0.476,9,32,0.281,12,17,0.706,10,36,46,20,4,5,12,16,31,52,0.5961538461538461,0
45,90,0.5,14,36,0.389,7,10,0.7,10,34,44,30,7,2,9,19,31,54,0.5740740740740741,1
52,98,0.531,16,33,0.485,9,11,0.818,11,36,47,32,11,5,14,17,36,65,0.5538461538461539,1
39,96,0.406,13,47,0.277,16,17,0.941,16,31,47,23,7,2,18,10,26,49,0.5306122448979592,0
49,89,0.551,15,34,0.441,8,11,0.727,4,32,36,31,9,2,17,21,34,55,0.6181818181818182,1
36,79,0.456,6,32,0.188,25,31,0.806,8,35,43,19,10,5,19,15,30,47,0.6382978723404256,0
36,95,0.379,11,38,0.289,19,26,0.731,14,32,46,24,6,5,18,16,25,57,0.43859649122807015,0
52,96,0.542,16,41,0.39,16,20,0.8,7,42,49,33,14,8,10,21,36,55,0.6545454545454545,1
32,85,0.376,7,31,0.226,28,36,0.778,14,38,52,21,8,2,15,23,25,54,0.46296296296296297,1
31,85,0.365,13,44,0.295,21,27,0.778,13,41,54,18,8,3,21,28,18,41,0.43902439024390244,0
32,86,0.372,8,37,0.216,12,16,0.75,9,35,44,16,6,6,9,15,24,49,0.4897959183673469,0
37,86,0.43,11,34,0.324,7,10,0.7,8,38,46,22,1,5,12,15,26,52,0.5,1
37,82,0.451,18,40,0.45,11,13,0.846,8,37,45,22,11,5,19,13,19,42,0.4523809523809524,1
34,83,0.41,15,41,0.366,7,10,0.7,9,33,42,26,6,10,20,15,19,42,0.4523809523809524,0
41,89,0.461,15,33,0.455,16,18,0.889,12,27,39,20,7,2,11,17,26,56,0.4642857142857143,0
46,82,0.561,16,36,0.444,10,14,0.714,7,32,39,25,6,7,14,15,30,46,0.6521739130434783,1
30,74,0.405,11,21,0.524,29,34,0.853,7,38,45,20,2,3,12,25,19,53,0.3584905660377358,0
39,84,0.464,10,28,0.357,17,25,0.68,6,36,42,23,9,4,6,22,29,56,0.5178571428571429,1
41,79,0.519,13,40,0.325,22,28,0.786,9,44,53,25,4,8,22,27,28,39,0.717948717948718,1
34,88,0.386,10,36,0.278,21,27,0.778,9,29,38,21,12,2,12,23,24,52,0.46153846153846156,0
41,95,0.432,5,22,0.227,5,7,0.714,6,35,41,26,10,4,16,17,36,73,0.4931506849315068,0
37,85,0.435,12,38,0.316,20,22,0.909,6,46,52,16,9,3,21,13,25,47,0.5319148936170213,1
33,90,0.367,6,29,0.207,13,17,0.765,6,36,42,19,5,5,9,16,27,61,0.4426229508196721,0
46,89,0.517,16,38,0.421,12,19,0.632,6,50,56,27,5,8,11,20,30,51,0.5882352941176471,1
37,84,0.44,11,41,0.268,14,17,0.824,12,30,42,24,9,2,14,17,26,43,0.6046511627906976,0
41,81,0.506,13,37,0.351,15,18,0.833,6,34,40,28,9,4,14,17,28,44,0.6363636363636364,1
35,89,0.393,11,44,0.25,18,21,0.857,12,38,50,20,9,1,14,17,24,45,0.5333333333333333,0
38,83,0.458,12,32,0.375,21,25,0.84,8,39,47,29,7,3,12,20,26,51,0.5098039215686274,1
33,90,0.367,8,42,0.19,13,16,0.813,11,37,48,23,7,5,11,12,25,48,0.5208333333333334,0
42,96,0.438,10,32,0.313,3,6,0.5,16,43,59,30,6,8,11,16,32,64,0.5,1
33,79,0.418,9,37,0.243,14,19,0.737,7,36,43,14,5,5,18,22,24,42,0.5714285714285714,0
34,80,0.425,8,28,0.286,21,28,0.75,8,34,42,16,13,5,13,20,26,52,0.5,1
33,75,0.44,10,35,0.286,22,28,0.786,10,28,38,18,6,3,17,21,23,40,0.575,0
42,87,0.483,15,40,0.375,14,17,0.824,10,29,39,29,6,2,11,25,27,47,0.574468085106383,1
40,96,0.417,12,43,0.279,10,12,0.833,11,37,48,24,8,4,13,19,28,53,0.5283018867924528,0
40,87,0.46,12,37,0.324,17,24,0.708,9,43,52,22,9,4,15,10,28,50,0.56,1
34,93,0.366,10,38,0.263,19,25,0.76,20,27,47,19,7,3,20,22,24,55,0.43636363636363634,0
41,82,0.5,10,36,0.278,15,18,0.833,10,25,35,20,8,10,17,24,31,46,0.6739130434782609,1
39,96,0.406,11,38,0.289,15,18,0.833,14,37,51,20,7,3,15,19,28,58,0.4827586206896552,1
37,88,0.42,16,49,0.327,8,12,0.667,11,34,45,25,5,7,18,20,21,39,0.5384615384615384,0
32,90,0.356,12,42,0.286,13,19,0.684,9,37,46,16,6,4,14,14,20,48,0.4166666666666667,0
41,92,0.446,10,39,0.256,9,16,0.563,9,47,56,18,10,6,14,19,31,53,0.5849056603773585,1
38,91,0.418,16,32,0.5,6,6,1.0,8,41,49,28,5,2,10,14,22,59,0.3728813559322034,0
41,93,0.441,13,39,0.333,10,14,0.714,8,41,49,27,6,7,8,9,28,54,0.5185185185185185,1
39,83,0.47,13,29,0.448,16,20,0.8,10,26,36,23,7,9,15,23,26,54,0.48148148148148145,0
37,84,0.44,11,31,0.355,27,28,0.964,12,32,44,26,10,5,17,19,26,53,0.49056603773584906,1
41,83,0.494,15,43,0.349,7,8,0.875,5,29,34,36,12,2,11,17,26,40,0.65,1
34,80,0.425,12,39,0.308,9,16,0.563,13,29,42,22,6,3,20,11,22,41,0.5365853658536586,0
43,85,0.506,11,29,0.379,6,12,0.5,6,39,45,22,5,7,10,18,32,56,0.5714285714285714,1
32,89,0.36,12,36,0.333,13,16,0.813,10,36,46,22,6,4,11,14,20,53,0.37735849056603776,0
42,90,0.467,16,39,0.41,8,8,1.0,7,27,34,24,6,6,14,15,26,51,0.5098039215686274,0
52,96,0.542,11,26,0.423,5,6,0.833,12,35,47,28,8,7,12,17,41,70,0.5857142857142857,1
38,77,0.494,15,36,0.417,6,10,0.6,5,32,37,25,4,3,17,19,23,41,0.5609756097560976,0
41,82,0.5,10,26,0.385,20,24,0.833,7,34,41,27,10,1,6,13,31,56,0.5535714285714286,1
35,84,0.417,6,32,0.188,14,19,0.737,11,31,42,26,7,6,12,12,29,52,0.5576923076923077,0
41,86,0.477,21,49,0.429,12,15,0.8,12,35,47,30,5,9,13,17,20,37,0.5405405405405406,1
39,94,0.415,10,38,0.263,15,17,0.882,14,21,35,24,10,3,13,13,29,56,0.5178571428571429,0
44,80,0.55,19,46,0.413,12,13,0.923,10,36,46,34,8,9,24,18,25,34,0.7352941176470589,1
39,84,0.464,12,30,0.4,18,24,0.75,7,26,33,20,5,6,12,29,27,54,0.5,0
44,88,0.5,11,30,0.367,31,38,0.816,12,39,51,22,7,2,14,20,33,58,0.5689655172413793,1
40,89,0.449,14,38,0.368,19,25,0.76,11,34,45,26,7,6,13,25,26,51,0.5098039215686274,0
41,91,0.451,10,33,0.303,23,25,0.92,14,29,43,19,6,13,11,19,31,58,0.5344827586206896,1
41,88,0.466,11,36,0.306,25,32,0.781,8,30,38,19,10,6,10,24,30,52,0.5769230769230769,0
44,81,0.543,12,31,0.387,21,28,0.75,6,39,45,28,8,7,17,26,32,50,0.64,1
41,93,0.441,8,31,0.258,24,24,1.0,17,33,50,19,7,3,11,20,33,62,0.532258064516129,1
39,82,0.476,14,37,0.378,16,20,0.8,7,31,38,24,5,5,14,22,25,45,0.5555555555555556,0
38,80,0.475,12,30,0.4,17,21,0.81,14,34,48,22,8,4,19,23,26,50,0.52,1
32,80,0.4,14,42,0.333,24,30,0.8,11,24,35,21,11,7,13,22,18,38,0.47368421052631576,0
32,91,0.352,12,48,0.25,13,21,0.619,11,42,53,17,6,4,12,22,20,43,0.46511627906976744,0
31,83,0.373,12,41,0.293,22,26,0.846,6,47,53,21,9,5,13,18,19,42,0.4523809523809524,1
34,90,0.378,9,37,0.243,4,5,0.8,8,35,43,22,7,4,12,12,25,53,0.4716981132075472,0
38,87,0.437,13,30,0.433,5,8,0.625,12,43,55,19,9,1,13,12,25,57,0.43859649122807015,1
37,90,0.411,12,40,0.3,18,23,0.783,10,30,40,25,15,1,10,17,25,50,0.5,0
44,85,0.518,14,29,0.483,10,14,0.714,10,43,53,28,7,4,18,22,30,56,0.5357142857142857,1
38,84,0.452,12,31,0.387,20,24,0.833,13,40,53,20,9,9,17,24,26,53,0.49056603773584906,1
32,84,0.381,9,37,0.243,16,25,0.64,11,29,40,15,8,4,15,18,23,47,0.48936170212765956,0
43,102,0.422,10,40,0.25,9,15,0.6,20,31,51,26,6,2,10,22,33,62,0.532258064516129,0
43,82,0.524,12,34,0.353,17,21,0.81,8,38,46,24,6,6,12,22,31,48,0.6458333333333334,1
39,96,0.406,18,42,0.429,9,16,0.563,15,39,54,23,5,0,10,15,21,54,0.3888888888888889,0
41,88,0.466,17,39,0.436,12,14,0.857,8,40,48,28,4,7,7,11,24,49,0.4897959183673469,1
35,88,0.398,6,18,0.333,18,19,0.947,11,41,52,17,7,5,16,14,29,70,0.4142857142857143,0
42,91,0.462,14,38,0.368,13,18,0.722,8,38,46,28,11,9,11,16,28,53,0.5283018867924528,1
39,98,0.398,19,51,0.373,11,14,0.786,6,33,39,26,5,3,10,24,20,47,0.425531914893617,0
37,82,0.451,19,40,0.475,24,37,0.649,11,49,60,25,6,5,14,18,18,42,0.42857142857142855,1
29,83,0.349,9,32,0.281,28,35,0.8,10,23,33,21,7,5,16,24,20,51,0.39215686274509803,0
49,91,0.538,20,41,0.488,20,28,0.714,18,32,50,28,12,6,13,26,29,50,0.58,1
38,84,0.452,10,39,0.256,13,22,0.591,13,35,48,21,5,8,22,21,28,45,0.6222222222222222,0
33,78,0.423,18,41,0.439,22,26,0.846,4,33,37,25,12,7,15,23,15,37,0.40540540540540543,1
41,81,0.506,10,28,0.357,19,21,0.905,3,29,32,24,7,4,12,24,31,53,0.5849056603773585,0
40,80,0.5,15,34,0.441,23,23,1.0,5,33,38,23,6,7,13,21,25,46,0.5434782608695652,1
46,91,0.505,17,39,0.436,14,17,0.824,14,38,52,20,5,2,13,16,29,52,0.5576923076923077,1
41,91,0.451,10,31,0.323,13,21,0.619,8,27,35,20,8,5,8,14,31,60,0.5166666666666667,0
38,81,0.469,7,27,0.259,17,20,0.85,10,27,37,21,7,3,14,26,31,54,0.5740740740740741,0
36,74,0.486,11,30,0.367,20,23,0.87,9,26,35,22,6,2,20,19,25,44,0.5681818181818182,1
35,84,0.417,7,27,0.259,26,31,0.839,12,32,44,16,4,11,14,25,28,57,0.49122807017543857,0
37,88,0.42,11,29,0.379,24,27,0.889,11,33,44,21,5,1,10,26,26,59,0.4406779661016949,1
45,92,0.489,10,31,0.323,21,27,0.778,12,39,51,29,7,8,13,21,35,61,0.5737704918032787,1
43,97,0.443,14,40,0.35,16,21,0.762,8,31,39,27,7,6,11,24,29,57,0.5087719298245614,0
39,99,0.394,15,37,0.405,11,20,0.55,18,29,47,25,7,4,11,21,24,62,0.3870967741935484,0
39,79,0.494,22,45,0.489,19,24,0.792,8,39,47,31,5,7,16,18,17,34,0.5,1
34,83,0.41,6,30,0.2,17,18,0.944,8,31,39,21,6,5,10,21,28,53,0.5283018867924528,0
36,75,0.48,12,29,0.414,13,18,0.722,8,34,42,18,5,2,15,15,24,46,0.5217391304347826,1
33,90,0.367,11,38,0.289,20,28,0.714,12,30,42,20,5,1,10,22,22,52,0.4230769230769231,0
46,87,0.529,11,36,0.306,23,26,0.885,10,41,51,34,7,3,13,20,35,51,0.6862745098039216,1
39,97,0.402,10,38,0.263,13,14,0.929,16,34,50,24,5,5,10,15,29,59,0.4915254237288136,0
42,87,0.483,14,34,0.412,15,16,0.938,8,36,44,25,6,6,8,16,28,53,0.5283018867924528,1
31,83,0.373,11,42,0.262,17,24,0.708,4,38,42,19,5,4,15,20,20,41,0.4878048780487805,0
39,92,0.424,12,35,0.343,18,19,0.947,11,47,58,19,10,3,15,24,27,57,0.47368421052631576,1
40,90,0.444,13,31,0.419,16,18,0.889,11,48,59,27,7,12,13,15,27,59,0.4576271186440678,1
31,85,0.365,6,28,0.214,9,15,0.6,5,33,38,13,6,2,9,16,25,57,0.43859649122807015,0
45,95,0.474,11,35,0.314,16,18,0.889,8,34,42,32,6,6,10,23,34,60,0.5666666666666667,1
36,93,0.387,14,44,0.318,26,29,0.897,14,39,53,24,6,5,15,16,22,49,0.4489795918367347,0
34,93,0.366,11,41,0.268,13,18,0.722,15,32,47,16,6,4,16,17,23,52,0.4423076923076923,0
44,94,0.468,18,45,0.4,17,24,0.708,13,42,55,28,10,7,13,22,26,49,0.5306122448979592,1
40,100,0.4,10,44,0.227,20,28,0.714,21,28,49,21,14,9,12,20,30,56,0.5357142857142857,1
37,88,0.42,6,32,0.188,16,18,0.889,15,33,48,24,6,6,23,23,31,56,0.5535714285714286,0
36,85,0.424,9,32,0.281,21,27,0.778,11,34,45,19,9,6,7,20,27,53,0.5094339622641509,1
33,80,0.413,7,31,0.226,21,29,0.724,11,38,49,17,4,0,14,19,26,49,0.5306122448979592,0
45,88,0.511,12,27,0.444,13,16,0.813,11,33,44,25,10,0,15,18,33,61,0.5409836065573771,1
49,93,0.527,5,20,0.25,8,16,0.5,11,33,44,23,9,4,15,16,44,73,0.6027397260273972,0
42,95,0.442,13,35,0.371,22,27,0.815,16,34,50,24,10,4,7,20,29,60,0.48333333333333334,1
41,87,0.471,17,43,0.395,19,25,0.76,10,36,46,26,5,10,14,20,24,44,0.5454545454545454,0
40,91,0.44,15,31,0.484,14,24,0.583,6,30,36,21,11,4,10,22,25,60,0.4166666666666667,1
36,94,0.383,9,37,0.243,22,27,0.815,20,45,65,23,6,6,18,20,27,57,0.47368421052631576,0
35,76,0.461,9,29,0.31,21,29,0.724,12,39,51,22,9,3,17,19,26,47,0.5531914893617021,1
35,84,0.417,10,38,0.263,12,14,0.857,9,26,35,22,7,1,15,23,25,46,0.5434782608695652,0
39,89,0.438,12,39,0.308,22,27,0.815,12,30,42,22,11,5,15,23,27,50,0.54,1
35,85,0.412,10,32,0.313,24,29,0.828,12,35,47,17,5,3,19,24,25,53,0.4716981132075472,0
34,91,0.374,11,36,0.306,21,30,0.7,13,37,50,23,8,3,12,17,23,55,0.41818181818181815,0
37,82,0.451,15,34,0.441,17,21,0.81,7,45,52,23,7,4,17,23,22,48,0.4583333333333333,1
38,78,0.487,15,33,0.455,9,11,0.818,7,30,37,26,6,5,19,15,23,45,0.5111111111111111,0
45,88,0.511,15,39,0.385,14,20,0.7,12,31,43,25,12,7,9,18,30,49,0.6122448979591837,1
43,85,0.506,14,35,0.4,23,30,0.767,10,40,50,29,8,4,10,23,29,50,0.58,1
34,91,0.374,11,48,0.229,25,28,0.893,15,30,45,25,6,5,11,24,23,43,0.5348837209302325,0
45,86,0.523,8,22,0.364,22,28,0.786,10,37,47,26,4,2,15,23,37,64,0.578125,1
43,97,0.443,12,39,0.308,17,25,0.68,13,31,44,22,7,0,10,23,31,58,0.5344827586206896,0
34,80,0.425,8,28,0.286,20,22,0.909,8,33,41,17,10,7,21,22,26,52,0.5,0
42,80,0.525,15,38,0.395,17,24,0.708,4,37,41,32,7,5,16,21,27,42,0.6428571428571429,1
44,96,0.458,15,35,0.429,10,12,0.833,8,32,40,26,12,6,14,22,29,61,0.47540983606557374,0
42,84,0.5,17,36,0.472,17,22,0.773,7,39,46,27,5,6,22,16,25,48,0.5208333333333334,1
42,95,0.442,15,37,0.405,25,29,0.862,9,43,52,20,5,4,12,21,27,58,0.46551724137931033,1
42,104,0.404,13,46,0.283,19,24,0.792,14,38,52,25,3,5,11,25,29,58,0.5,0
47,89,0.528,14,30,0.467,18,21,0.857,11,23,34,25,8,4,10,20,33,59,0.559322033898305,1
42,82,0.512,9,29,0.31,20,26,0.769,11,29,40,25,6,3,15,20,33,53,0.6226415094339622,0
34,95,0.358,11,45,0.244,14,19,0.737,9,35,44,16,7,1,9,18,23,50,0.46,0
42,87,0.483,15,36,0.417,15,17,0.882,10,46,56,23,5,6,16,18,27,51,0.5294117647058824,1
33,74,0.446,15,42,0.357,20,29,0.69,4,36,40,25,6,2,21,25,18,32,0.5625,0
38,93,0.409,18,55,0.327,19,21,0.905,15,37,52,24,10,7,18,26,20,38,0.5263157894736842,1
36,84,0.429,7,31,0.226,23,36,0.639,13,32,45,23,5,3,19,23,29,53,0.5471698113207547,0
44,96,0.458,12,29,0.414,27,32,0.844,12,40,52,33,13,2,11,26,32,67,0.47761194029850745,1
39,86,0.453,15,47,0.319,17,20,0.85,7,36,43,19,11,8,10,15,24,39,0.6153846153846154,1
37,82,0.451,15,36,0.417,15,22,0.682,4,39,43,21,7,4,13,18,22,46,0.4782608695652174,0
39,93,0.419,12,40,0.3,16,21,0.762,12,37,49,26,11,11,10,16,27,53,0.5094339622641509,1
38,93,0.409,15,42,0.357,8,10,0.8,10,41,51,23,5,1,15,19,23,51,0.45098039215686275,0
44,94,0.468,12,38,0.316,21,25,0.84,13,30,43,27,9,1,15,26,32,56,0.5714285714285714,0
45,86,0.523,12,33,0.364,23,34,0.676,14,29,43,21,4,4,14,21,33,53,0.6226415094339622,1
45,88,0.511,12,26,0.462,22,24,0.917,8,36,44,26,10,5,11,11,33,62,0.532258064516129,1
43,100,0.43,12,33,0.364,8,10,0.8,15,29,44,27,8,4,12,16,31,67,0.4626865671641791,0
45,100,0.45,11,35,0.314,14,19,0.737,15,30,45,24,8,6,12,20,34,65,0.5230769230769231,0
49,88,0.557,23,40,0.575,12,15,0.8,7,37,44,32,5,7,16,21,26,48,0.5416666666666666,1
46,73,0.63,16,33,0.485,12,20,0.6,5,39,44,24,3,7,22,14,30,40,0.75,1
40,92,0.435,17,47,0.362,12,14,0.857,9,22,31,24,9,2,8,19,23,45,0.5111111111111111,0
36,86,0.419,13,38,0.342,18,23,0.783,7,30,37,23,7,2,10,13,23,48,0.4791666666666667,0
47,87,0.54,12,37,0.324,12,16,0.75,11,37,48,31,8,5,15,19,35,50,0.7,1
37,89,0.416,7,30,0.233,16,22,0.727,13,28,41,17,8,3,11,18,30,59,0.5084745762711864,0
47,97,0.485,11,39,0.282,9,11,0.818,17,36,53,31,6,4,13,19,36,58,0.6206896551724138,1
33,90,0.367,8,33,0.242,22,26,0.846,13,39,52,17,8,4,15,19,25,57,0.43859649122807015,0
39,91,0.429,11,38,0.289,18,19,0.947,11,43,54,26,9,4,15,27,28,53,0.5283018867924528,1
54,120,0.45,14,45,0.311,19,29,0.655,16,40,56,32,11,4,15,26,40,75,0.5333333333333333,1
51,102,0.5,15,44,0.341,20,28,0.714,9,42,51,32,9,6,19,27,36,58,0.6206896551724138,0
52,89,0.584,13,27,0.481,15,21,0.714,9,40,49,33,8,5,12,15,39,62,0.6290322580645161,1
37,91,0.407,12,38,0.316,14,19,0.737,10,26,36,27,8,7,13,19,25,53,0.4716981132075472,0
44,79,0.557,13,28,0.464,17,21,0.81,1,34,35,28,10,2,11,19,31,51,0.6078431372549019,1
34,92,0.37,12,39,0.308,17,22,0.773,17,34,51,13,7,1,16,20,22,53,0.41509433962264153,0
38,79,0.481,10,29,0.345,15,15,1.0,5,38,43,17,2,12,15,15,28,50,0.56,1
38,94,0.404,11,33,0.333,12,14,0.857,10,31,41,23,7,4,10,15,27,61,0.4426229508196721,0
48,86,0.558,17,34,0.5,10,16,0.625,6,41,47,32,11,1,14,24,31,52,0.5961538461538461,1
30,80,0.375,7,32,0.219,21,30,0.7,5,31,36,18,7,5,15,16,23,48,0.4791666666666667,0
34,92,0.37,10,34,0.294,10,15,0.667,12,39,51,20,4,8,11,20,24,58,0.41379310344827586,0
38,87,0.437,6,24,0.25,14,19,0.737,8,45,53,21,7,6,11,15,32,63,0.5079365079365079,1
38,89,0.427,11,27,0.407,11,13,0.846,6,33,39,27,8,4,14,21,27,62,0.43548387096774194,1
36,80,0.45,13,33,0.394,12,18,0.667,9,34,43,17,6,8,18,22,23,47,0.48936170212765956,0
36,82,0.439,11,29,0.379,16,22,0.727,8,42,50,20,4,3,10,17,25,53,0.4716981132075472,1
33,93,0.355,9,37,0.243,15,20,0.75,13,39,52,18,8,6,7,17,24,56,0.42857142857142855,0
41,92,0.446,13,38,0.342,18,21,0.857,11,30,41,17,11,1,13,17,28,54,0.5185185185185185,1
42,84,0.5,7,23,0.304,16,21,0.762,10,37,47,25,7,5,20,15,35,61,0.5737704918032787,0
37,86,0.43,14,40,0.35,19,22,0.864,9,27,36,23,13,1,10,19,23,46,0.5,1
38,81,0.469,11,39,0.282,17,21,0.81,10,37,47,22,6,4,23,20,27,42,0.6428571428571429,0
35,88,0.398,8,32,0.25,14,23,0.609,8,35,43,21,11,5,9,16,27,56,0.48214285714285715,0
41,90,0.456,14,39,0.359,9,12,0.75,10,41,51,28,3,9,13,18,27,51,0.5294117647058824,1
45,78,0.577,9,24,0.375,21,26,0.808,7,36,43,28,4,4,15,18,36,54,0.6666666666666666,1
42,89,0.472,14,38,0.368,16,22,0.727,9,26,35,23,7,4,7,21,28,51,0.5490196078431373,0
48,103,0.466,20,50,0.4,27,30,0.9,16,23,39,31,10,5,11,23,28,53,0.5283018867924528,0
51,95,0.537,23,49,0.469,21,31,0.677,10,31,41,36,5,4,15,25,28,46,0.6086956521739131,1
48,96,0.5,14,36,0.389,11,16,0.688,11,43,54,22,7,6,21,31,34,60,0.5666666666666667,1
39,93,0.419,12,34,0.353,30,39,0.769,12,32,44,27,13,5,16,25,27,59,0.4576271186440678,0
40,93,0.43,8,35,0.229,17,21,0.81,14,31,45,27,8,3,15,20,32,58,0.5517241379310345,0
45,80,0.563,20,35,0.571,17,22,0.773,7,34,41,24,9,4,18,25,25,45,0.5555555555555556,1
46,90,0.511,8,35,0.229,18,22,0.818,13,39,52,27,7,3,14,14,38,55,0.6909090909090909,1
38,92,0.413,12,45,0.267,12,16,0.75,12,33,45,21,6,2,13,21,26,47,0.5531914893617021,0
38,86,0.442,17,40,0.425,12,22,0.545,11,32,43,25,19,2,17,27,21,46,0.45652173913043476,1
32,80,0.4,9,28,0.321,17,25,0.68,15,32,47,18,8,3,25,21,23,52,0.4423076923076923,0
38,89,0.427,13,33,0.394,17,19,0.895,12,41,53,29,5,4,17,20,25,56,0.44642857142857145,0
43,86,0.5,9,32,0.281,15,25,0.6,6,36,42,32,11,8,12,18,34,54,0.6296296296296297,1
33,97,0.34,9,42,0.214,26,37,0.703,12,37,49,17,5,8,8,18,24,55,0.43636363636363634,0
50,104,0.481,13,39,0.333,15,20,0.75,14,54,68,30,4,11,10,25,37,65,0.5692307692307692,1
34,82,0.415,12,34,0.353,29,31,0.935,12,41,53,24,5,3,18,19,22,48,0.4583333333333333,1
35,93,0.376,13,42,0.31,14,16,0.875,14,30,44,19,6,5,11,24,22,51,0.43137254901960786,0
42,88,0.477,18,39,0.462,17,21,0.81,5,29,34,23,7,9,9,14,24,49,0.4897959183673469,0
53,89,0.596,14,30,0.467,13,19,0.684,5,36,41,35,3,5,11,19,39,59,0.6610169491525424,1
45,80,0.563,10,19,0.526,14,18,0.778,5,43,48,29,3,4,20,22,35,61,0.5737704918032787,1
39,89,0.438,12,39,0.308,6,15,0.4,7,26,33,20,8,7,10,15,27,50,0.54,0
31,87,0.356,7,43,0.163,20,26,0.769,4,41,45,16,10,10,13,14,24,44,0.5454545454545454,0
40,96,0.417,15,46,0.326,7,11,0.636,9,51,60,31,7,5,14,19,25,50,0.5,1
48,94,0.511,14,35,0.4,13,16,0.813,14,33,47,30,11,1,8,21,34,59,0.576271186440678,1
37,72,0.514,14,36,0.389,16,21,0.762,4,31,35,17,2,2,15,16,23,36,0.6388888888888888,0
43,74,0.581,18,35,0.514,16,21,0.762,5,30,35,32,2,1,13,18,25,39,0.6410256410256411,1
43,91,0.473,15,44,0.341,10,15,0.667,12,27,39,32,2,1,9,18,28,47,0.5957446808510638,0
36,91,0.396,9,37,0.243,17,21,0.81,8,39,47,27,6,3,14,18,27,54,0.5,0
36,82,0.439,9,35,0.257,19,26,0.731,8,39,47,25,8,5,14,25,27,47,0.574468085106383,1
37,90,0.411,8,33,0.242,14,18,0.778,8,47,55,20,7,6,12,21,29,57,0.5087719298245614,0
39,97,0.402,10,33,0.303,13,18,0.722,12,43,55,24,7,6,11,19,29,64,0.453125,1
41,92,0.446,9,31,0.29,8,13,0.615,12,28,40,26,5,3,7,15,32,61,0.5245901639344263,0
49,92,0.533,8,18,0.444,10,16,0.625,15,36,51,28,4,6,10,15,41,74,0.5540540540540541,1
42,91,0.462,11,31,0.355,12,17,0.706,12,30,42,19,1,3,9,18,31,60,0.5166666666666667,0
47,89,0.528,19,46,0.413,16,23,0.696,8,35,43,30,6,3,5,19,28,43,0.6511627906976745,1
44,91,0.484,11,32,0.344,11,12,0.917,10,32,42,27,5,2,11,21,33,59,0.559322033898305,0
41,85,0.482,8,28,0.286,22,25,0.88,9,29,38,27,7,7,9,14,33,57,0.5789473684210527,1
36,86,0.419,14,40,0.35,10,14,0.714,15,36,51,25,7,5,23,13,22,46,0.4782608695652174,0
43,87,0.494,12,30,0.4,6,11,0.545,8,27,35,28,12,4,13,12,31,57,0.543859649122807,1
29,76,0.382,9,35,0.257,25,30,0.833,7,38,45,17,4,7,19,20,20,41,0.4878048780487805,0
41,96,0.427,14,42,0.333,14,18,0.778,10,33,43,24,8,5,11,22,27,54,0.5,1
46,92,0.5,11,28,0.393,14,20,0.7,10,37,47,21,10,6,15,20,35,64,0.546875,1
35,79,0.443,6,29,0.207,16,22,0.727,9,31,40,22,11,4,20,21,29,50,0.58,0
36,93,0.387,10,34,0.294,16,19,0.842,18,36,54,18,13,10,17,15,26,59,0.4406779661016949,1
36,91,0.396,10,39,0.256,9,12,0.75,11,33,44,14,7,9,18,21,26,52,0.5,0
33,89,0.371,8,31,0.258,13,17,0.765,8,38,46,20,7,9,7,17,25,58,0.43103448275862066,0
33,79,0.418,11,28,0.393,11,15,0.733,4,42,46,18,5,8,13,15,22,51,0.43137254901960786,1
44,86,0.512,16,33,0.485,10,12,0.833,7,34,41,24,4,8,13,15,28,53,0.5283018867924528,1
44,90,0.489,10,33,0.303,13,16,0.813,8,32,40,23,8,4,10,18,34,57,0.5964912280701754,0
46,88,0.523,15,38,0.395,17,20,0.85,7,31,38,28,8,1,12,16,31,50,0.62,1
47,100,0.47,9,31,0.29,12,16,0.75,17,32,49,35,8,6,13,15,38,69,0.5507246376811594,0
37,68,0.544,16,31,0.516,21,23,0.913,6,40,46,27,8,14,21,15,21,37,0.5675675675675675,1
32,85,0.376,12,37,0.324,9,13,0.692,9,19,28,21,8,4,13,17,20,48,0.4166666666666667,0
43,87,0.494,21,51,0.412,18,21,0.857,3,33,36,30,8,9,17,21,22,36,0.6111111111111112,0
46,94,0.489,14,36,0.389,21,26,0.808,9,36,45,29,10,1,13,20,32,58,0.5517241379310345,1
57,83,0.687,18,34,0.529,7,9,0.778,9,25,34,32,7,2,18,19,39,49,0.7959183673469388,1
40,89,0.449,13,37,0.351,14,16,0.875,16,16,32,22,10,1,16,12,27,52,0.5192307692307693,0
40,79,0.506,15,37,0.405,19,22,0.864,8,32,40,25,9,12,19,25,25,42,0.5952380952380952,1
40,85,0.471,8,32,0.25,22,29,0.759,10,25,35,16,9,6,13,21,32,53,0.6037735849056604,0
39,80,0.488,10,34,0.294,15,21,0.714,1,34,35,22,5,4,15,19,29,46,0.6304347826086957,0
44,81,0.543,6,27,0.222,14,19,0.737,1,38,39,26,8,6,13,15,38,54,0.7037037037037037,1
37,88,0.42,11,37,0.297,22,26,0.846,12,27,39,15,3,6,13,23,26,51,0.5098039215686274,0
45,91,0.495,10,32,0.313,15,21,0.714,14,38,52,34,6,7,14,23,35,59,0.5932203389830508,1
25,76,0.329,11,38,0.289,18,22,0.818,8,18,26,14,2,5,20,14,14,38,0.3684210526315789,0
60,96,0.625,19,36,0.528,13,18,0.722,14,39,53,41,16,9,10,15,41,60,0.6833333333333333,1
44,89,0.494,11,29,0.379,20,21,0.952,13,26,39,24,10,8,15,22,33,60,0.55,1
42,82,0.512,9,26,0.346,22,27,0.815,10,29,39,19,10,8,18,20,33,56,0.5892857142857143,0
36,80,0.45,11,27,0.407,20,26,0.769,7,29,36,20,6,6,13,22,25,53,0.4716981132075472,0
43,79,0.544,12,21,0.571,16,23,0.696,6,38,44,23,8,3,15,20,31,58,0.5344827586206896,1
44,91,0.484,14,36,0.389,12,16,0.75,6,42,48,32,10,5,14,15,30,55,0.5454545454545454,1
29,82,0.354,12,34,0.353,13,17,0.765,8,33,41,19,8,6,18,20,17,48,0.3541666666666667,0
32,85,0.376,11,31,0.355,18,25,0.72,16,31,47,16,4,4,15,12,21,54,0.3888888888888889,0
37,88,0.42,14,40,0.35,9,14,0.643,15,32,47,23,10,7,14,24,23,48,0.4791666666666667,1
38,81,0.469,9,22,0.409,13,17,0.765,6,34,40,22,8,5,11,24,29,59,0.4915254237288136,1
31,76,0.408,10,28,0.357,24,30,0.8,11,36,47,20,5,3,15,20,21,48,0.4375,0
36,93,0.387,13,42,0.31,20,24,0.833,16,28,44,22,5,4,18,25,23,51,0.45098039215686275,0
36,76,0.474,6,23,0.261,32,41,0.78,7,34,41,26,4,4,17,31,30,53,0.5660377358490566,1
37,90,0.411,12,30,0.4,21,28,0.75,13,42,55,30,5,5,10,26,25,60,0.4166666666666667,1
32,79,0.405,10,34,0.294,17,26,0.654,5,37,42,17,4,3,15,23,22,45,0.4888888888888889,0
31,81,0.383,8,22,0.364,26,35,0.743,9,29,38,23,9,3,16,15,23,59,0.3898305084745763,0
45,92,0.489,19,39,0.487,9,12,0.75,11,40,51,30,10,8,17,29,26,53,0.49056603773584906,1
42,86,0.488,13,37,0.351,19,21,0.905,10,35,45,24,6,4,18,21,29,49,0.5918367346938775,0
44,92,0.478,17,47,0.362,13,15,0.867,7,28,35,33,7,5,12,16,27,45,0.6,1
43,81,0.531,16,34,0.471,11,13,0.846,9,29,38,24,5,6,13,22,27,47,0.574468085106383,1
35,80,0.438,9,36,0.25,25,33,0.758,12,27,39,20,7,3,13,19,26,44,0.5909090909090909,0
41,81,0.506,16,35,0.457,21,24,0.875,6,28,34,28,5,3,10,19,25,46,0.5434782608695652,1
45,90,0.5,12,33,0.364,13,21,0.619,13,30,43,28,8,3,12,19,33,57,0.5789473684210527,0
47,91,0.516,14,39,0.359,22,22,1.0,5,25,30,23,9,3,6,22,33,52,0.6346153846153846,0
45,81,0.556,27,51,0.529,20,23,0.87,9,35,44,26,3,3,20,27,18,30,0.6,1
42,89,0.472,13,30,0.433,19,25,0.76,15,39,54,30,2,5,16,19,29,59,0.4915254237288136,1
38,82,0.463,10,31,0.323,15,19,0.789,3,30,33,21,5,4,10,22,28,51,0.5490196078431373,0
41,86,0.477,10,31,0.323,19,27,0.704,7,40,47,22,4,10,9,12,31,55,0.5636363636363636,1
46,111,0.414,8,25,0.32,7,9,0.778,15,40,55,28,8,6,7,19,38,86,0.4418604651162791,0
37,76,0.487,9,26,0.346,14,24,0.583,10,42,52,20,10,5,23,23,28,50,0.56,1
31,92,0.337,15,43,0.349,13,19,0.684,14,28,42,19,10,1,15,21,16,49,0.32653061224489793,0
42,88,0.477,12,35,0.343,16,19,0.842,11,34,45,24,10,4,12,17,30,53,0.5660377358490566,1
40,90,0.444,13,39,0.333,14,21,0.667,11,34,45,26,6,2,13,18,27,51,0.5294117647058824,0
34,84,0.405,17,43,0.395,17,24,0.708,9,30,39,29,6,5,15,17,17,41,0.4146341463414634,0
44,98,0.449,18,50,0.36,18,20,0.9,19,38,57,32,3,6,14,22,26,48,0.5416666666666666,1
44,84,0.524,20,43,0.465,5,5,1.0,8,34,42,30,10,5,13,19,24,41,0.5853658536585366,1
35,88,0.398,12,40,0.3,17,21,0.81,16,24,40,23,7,3,11,12,23,48,0.4791666666666667,0
49,87,0.563,21,37,0.568,26,29,0.897,12,34,46,26,5,7,12,21,28,50,0.56,1
42,89,0.472,8,29,0.276,25,32,0.781,9,23,32,22,7,2,9,21,34,60,0.5666666666666667,0
34,89,0.382,13,34,0.382,18,27,0.667,9,38,47,23,7,3,18,24,21,55,0.38181818181818183,0
36,86,0.419,12,34,0.353,20,25,0.8,11,40,51,19,8,8,17,25,24,52,0.46153846153846156,1
46,86,0.535,17,37,0.459,21,28,0.75,7,32,39,21,9,3,6,18,29,49,0.5918367346938775,1
48,93,0.516,17,37,0.459,14,18,0.778,10,35,45,29,4,3,11,19,31,56,0.5535714285714286,0
40,90,0.444,20,48,0.417,9,10,0.9,14,32,46,24,8,5,17,14,20,42,0.47619047619047616,1
42,91,0.462,14,38,0.368,10,13,0.769,15,30,45,20,12,5,14,8,28,53,0.5283018867924528,0
40,94,0.426,10,38,0.263,18,25,0.72,22,28,50,19,9,9,8,26,30,56,0.5357142857142857,0
39,79,0.494,17,40,0.425,23,29,0.793,11,29,40,24,3,3,14,23,22,39,0.5641025641025641,1
30,73,0.411,8,25,0.32,22,29,0.759,6,37,43,20,4,5,10,22,22,48,0.4583333333333333,0
38,85,0.447,8,23,0.348,18,24,0.75,10,37,47,22,3,1,8,24,30,62,0.4838709677419355,1
38,96,0.396,11,32,0.344,10,15,0.667,11,39,50,30,5,2,11,17,27,64,0.421875,0
41,91,0.451,13,35,0.371,14,20,0.7,13,42,55,25,4,7,11,15,28,56,0.5,1
46,87,0.529,15,36,0.417,20,27,0.741,8,41,49,28,6,9,15,19,31,51,0.6078431372549019,1
48,107,0.449,16,46,0.348,12,17,0.706,13,29,42,31,6,6,8,18,32,61,0.5245901639344263,0
41,82,0.5,9,25,0.36,23,30,0.767,6,34,40,22,10,11,11,13,32,57,0.5614035087719298,1
41,99,0.414,16,41,0.39,5,6,0.833,16,36,52,21,8,7,17,26,25,58,0.43103448275862066,0
33,76,0.434,11,38,0.289,18,22,0.818,5,33,38,18,10,4,23,20,22,38,0.5789473684210527,0
43,87,0.494,20,40,0.5,20,29,0.69,7,36,43,28,15,2,15,19,23,47,0.48936170212765956,1
43,81,0.531,7,15,0.467,17,21,0.81,9,21,30,25,11,2,12,19,36,66,0.5454545454545454,0
43,82,0.524,9,23,0.391,21,22,0.955,13,27,40,25,10,10,16,20,34,59,0.576271186440678,1
38,89,0.427,13,33,0.394,16,21,0.762,16,31,47,26,11,6,19,18,25,56,0.44642857142857145,1
35,76,0.461,6,22,0.273,14,17,0.824,7,29,36,26,11,6,23,19,29,54,0.5370370370370371,0
35,90,0.389,15,46,0.326,19,20,0.95,7,32,39,27,8,4,10,17,20,44,0.45454545454545453,0
40,86,0.465,13,32,0.406,19,24,0.792,8,45,53,21,7,5,17,20,27,54,0.5,1
40,90,0.444,25,49,0.51,16,19,0.842,11,38,49,31,5,8,12,20,15,41,0.36585365853658536,1
39,98,0.398,17,40,0.425,15,19,0.789,16,34,50,22,9,5,8,17,22,58,0.3793103448275862,0
40,93,0.43,11,29,0.379,13,19,0.684,9,32,41,31,12,6,15,18,29,64,0.453125,0
43,94,0.457,10,29,0.345,12,18,0.667,15,34,49,27,6,4,17,20,33,65,0.5076923076923077,1
41,92,0.446,11,36,0.306,9,14,0.643,7,30,37,18,8,7,13,21,30,56,0.5357142857142857,1
35,79,0.443,5,22,0.227,15,20,0.75,7,38,45,16,6,6,18,19,30,57,0.5263157894736842,0
42,83,0.506,8,26,0.308,10,13,0.769,8,42,50,28,3,4,12,22,34,57,0.5964912280701754,1
36,90,0.4,9,46,0.196,18,22,0.818,10,29,39,21,6,2,4,15,27,44,0.6136363636363636,0
36,82,0.439,10,33,0.303,20,29,0.69,7,27,34,27,8,4,13,16,26,49,0.5306122448979592,0
48,93,0.516,8,27,0.296,13,17,0.765,13,38,51,25,7,4,16,21,40,66,0.6060606060606061,1
43,91,0.473,18,38,0.474,17,19,0.895,17,35,52,22,7,5,11,19,25,53,0.4716981132075472,1
41,92,0.446,12,31,0.387,15,20,0.75,13,30,43,30,5,4,10,18,29,61,0.47540983606557374,0
36,75,0.48,13,34,0.382,25,30,0.833,8,28,36,23,6,4,17,21,23,41,0.5609756097560976,1
39,80,0.488,10,29,0.345,18,21,0.857,8,27,35,22,7,4,19,24,29,51,0.5686274509803921,0
35,84,0.417,7,26,0.269,15,21,0.714,11,26,37,21,6,3,18,17,28,58,0.4827586206896552,0
44,80,0.55,13,28,0.464,14,16,0.875,5,37,42,28,10,8,16,22,31,52,0.5961538461538461,1
42,88,0.477,12,32,0.375,23,28,0.821,13,32,45,27,6,8,17,21,30,56,0.5357142857142857,1
37,79,0.468,13,24,0.542,29,35,0.829,7,30,37,22,9,4,16,26,24,55,0.43636363636363634,0
33,80,0.413,8,30,0.267,20,28,0.714,7,35,42,24,5,3,16,24,25,50,0.5,0
33,83,0.398,14,46,0.304,24,31,0.774,10,37,47,22,9,3,16,19,19,37,0.5135135135135135,1
35,89,0.393,8,33,0.242,26,31,0.839,14,30,44,18,7,3,13,23,27,56,0.48214285714285715,0
40,81,0.494,14,41,0.341,20,29,0.69,9,29,38,23,9,9,14,23,26,40,0.65,1
36,86,0.419,9,30,0.3,21,23,0.913,11,25,36,17,6,8,13,20,27,56,0.48214285714285715,0
46,86,0.535,10,27,0.37,20,25,0.8,9,33,42,27,8,4,11,19,36,59,0.6101694915254238,1
41,86,0.477,10,32,0.313,19,21,0.905,14,33,47,26,11,3,23,21,31,54,0.5740740740740741,0
40,85,0.471,14,32,0.438,20,22,0.909,9,29,38,20,13,7,20,18,26,53,0.49056603773584906,1
37,77,0.481,12,33,0.364,18,23,0.783,10,37,47,24,5,6,19,21,25,44,0.5681818181818182,1
36,90,0.4,9,31,0.29,15,25,0.6,12,28,40,23,14,3,13,23,27,59,0.4576271186440678,0
36,85,0.424,12,39,0.308,20,27,0.741,12,29,41,18,11,4,19,20,24,46,0.5217391304347826,0
40,77,0.519,22,47,0.468,11,12,0.917,6,36,42,32,6,6,22,23,18,30,0.6,1
50,88,0.568,25,54,0.463,11,15,0.733,6,42,48,26,6,4,15,20,25,34,0.7352941176470589,1
38,95,0.4,17,47,0.362,11,17,0.647,9,28,37,19,9,3,16,17,21,48,0.4375,0
45,88,0.511,9,32,0.281,21,27,0.778,5,28,33,28,12,4,12,19,36,56,0.6428571428571429,1
47,90,0.522,11,30,0.367,9,12,0.75,10,36,46,32,8,5,25,22,36,60,0.6,0
48,97,0.495,16,34,0.471,18,23,0.783,17,26,43,29,2,5,13,18,32,63,0.5079365079365079,0
53,97,0.546,15,34,0.441,21,25,0.84,12,31,43,24,8,7,8,22,38,63,0.6031746031746031,1
38,84,0.452,17,40,0.425,17,20,0.85,7,33,40,28,12,3,14,18,21,44,0.4772727272727273,1
42,93,0.452,15,41,0.366,10,15,0.667,13,33,46,27,6,5,13,19,27,52,0.5192307692307693,0
36,78,0.462,12,30,0.4,11,17,0.647,7,38,45,26,8,6,22,15,24,48,0.5,0
41,94,0.436,14,42,0.333,12,18,0.667,14,33,47,28,18,5,13,14,27,52,0.5192307692307693,1
43,91,0.473,15,40,0.375,17,24,0.708,16,36,52,22,7,5,12,14,28,51,0.5490196078431373,1
38,88,0.432,6,33,0.182,14,15,0.933,6,28,34,17,9,4,12,20,32,55,0.5818181818181818,0
42,94,0.447,15,39,0.385,12,13,0.923,5,28,33,29,7,5,9,21,27,55,0.4909090909090909,0
46,88,0.523,15,35,0.429,16,22,0.727,14,40,54,32,5,7,14,21,31,53,0.5849056603773585,1
46,93,0.495,6,23,0.261,15,16,0.938,9,32,41,26,9,7,14,22,40,70,0.5714285714285714,1
37,94,0.394,11,34,0.324,20,24,0.833,16,33,49,21,10,3,15,19,26,60,0.43333333333333335,0
48,101,0.475,14,41,0.341,13,17,0.765,20,28,48,22,11,4,14,20,34,60,0.5666666666666667,0
48,87,0.552,14,35,0.4,14,20,0.7,11,28,39,29,9,8,16,20,34,52,0.6538461538461539,1
42,83,0.506,15,39,0.385,24,32,0.75,13,35,48,19,11,8,15,21,27,44,0.6136363636363636,1
42,89,0.472,19,46,0.413,11,20,0.55,12,28,40,30,9,4,16,28,23,43,0.5348837209302325,0
39,84,0.464,4,29,0.138,11,12,0.917,12,25,37,18,7,2,14,18,35,55,0.6363636363636364,0
41,87,0.471,13,36,0.361,11,12,0.917,13,31,44,28,7,3,13,19,28,51,0.5490196078431373,1
46,85,0.541,13,33,0.394,18,22,0.818,6,41,47,34,8,7,17,23,33,52,0.6346153846153846,1
36,92,0.391,11,39,0.282,23,28,0.821,10,30,40,24,9,5,14,19,25,53,0.4716981132075472,0
35,90,0.389,12,37,0.324,11,12,0.917,7,31,38,22,7,6,13,15,23,53,0.4339622641509434,0
41,95,0.432,13,37,0.351,14,16,0.875,15,45,60,29,6,4,16,16,28,58,0.4827586206896552,1
41,87,0.471,19,42,0.452,15,20,0.75,12,35,47,23,12,3,16,14,22,45,0.4888888888888889,1
38,96,0.396,10,44,0.227,9,14,0.643,19,32,51,21,9,3,15,17,28,52,0.5384615384615384,0
35,93,0.376,4,26,0.154,16,24,0.667,15,31,46,13,7,6,13,17,31,67,0.4626865671641791,0
43,96,0.448,14,38,0.368,11,11,1.0,14,39,53,25,4,9,12,21,29,58,0.5,1
29,81,0.358,9,34,0.265,20,24,0.833,14,41,55,18,4,2,15,17,20,47,0.425531914893617,0
30,87,0.345,12,35,0.343,18,23,0.783,12,36,48,21,9,7,8,19,18,52,0.34615384615384615,1
41,93,0.441,7,28,0.25,14,22,0.636,11,37,48,19,8,6,17,21,34,65,0.5230769230769231,0
41,88,0.466,12,31,0.387,23,28,0.821,7,40,47,27,13,6,14,24,29,57,0.5087719298245614,1
35,80,0.438,12,33,0.364,22,24,0.917,10,35,45,21,4,5,11,11,23,47,0.48936170212765956,0
42,92,0.457,18,36,0.5,4,6,0.667,12,33,45,27,7,1,8,17,24,56,0.42857142857142855,1
38,77,0.494,11,33,0.333,19,29,0.655,12,28,40,25,5,6,16,25,27,44,0.6136363636363636,0
40,80,0.5,11,29,0.379,22,36,0.611,9,29,38,22,10,3,11,24,29,51,0.5686274509803921,1
31,83,0.373,17,40,0.425,13,20,0.65,7,27,34,22,5,3,16,15,14,43,0.32558139534883723,0
46,93,0.495,19,43,0.442,7,9,0.778,12,38,50,37,8,6,10,21,27,50,0.54,1
34,85,0.4,12,48,0.25,13,18,0.722,10,32,42,21,5,5,13,22,22,37,0.5945945945945946,0
35,76,0.461,9,27,0.333,23,26,0.885,5,39,44,19,7,5,13,16,26,49,0.5306122448979592,1
47,93,0.505,20,43,0.465,13,14,0.929,10,31,41,33,9,8,12,25,27,50,0.54,1
41,89,0.461,10,27,0.37,20,29,0.69,14,31,45,28,4,4,17,18,31,62,0.5,0
48,93,0.516,13,39,0.333,14,17,0.824,12,37,49,28,5,5,9,14,35,54,0.6481481481481481,1
41,89,0.461,8,25,0.32,8,14,0.571,9,30,39,17,3,3,13,15,33,64,0.515625,0
41,87,0.471,11,28,0.393,23,25,0.92,8,35,43,28,8,6,18,20,30,59,0.5084745762711864,1
39,92,0.424,14,37,0.378,12,18,0.667,8,32,40,24,11,5,21,22,25,55,0.45454545454545453,0
33,88,0.375,13,38,0.342,15,19,0.789,14,33,47,17,6,4,19,13,20,50,0.4,0
41,84,0.488,13,28,0.464,11,17,0.647,6,38,44,24,12,11,14,17,28,56,0.5,1
42,88,0.477,14,41,0.341,14,17,0.824,12,34,46,27,11,1,15,12,28,47,0.5957446808510638,1
35,82,0.427,17,49,0.347,10,13,0.769,8,29,37,27,12,2,17,16,18,33,0.5454545454545454,0
38,90,0.422,9,33,0.273,18,23,0.783,10,44,54,25,5,5,9,18,29,57,0.5087719298245614,1
30,80,0.375,13,37,0.351,11,16,0.688,3,36,39,19,3,7,11,25,17,43,0.3953488372093023,0
38,85,0.447,14,36,0.389,26,32,0.813,10,32,42,23,9,2,17,22,24,49,0.4897959183673469,1
37,81,0.457,18,48,0.375,19,28,0.679,12,33,45,25,9,8,19,25,19,33,0.5757575757575758,0
40,94,0.426,8,29,0.276,9,15,0.6,11,31,42,24,8,4,14,17,32,65,0.49230769230769234,0
45,91,0.495,7,25,0.28,15,20,0.75,15,40,55,31,11,5,14,19,38,66,0.5757575757575758,1
46,96,0.479,19,46,0.413,21,27,0.778,12,33,45,27,8,5,11,24,27,50,0.54,1
42,85,0.494,15,39,0.385,27,31,0.871,8,32,40,20,9,6,12,26,27,46,0.5869565217391305,0
40,90,0.444,11,36,0.306,12,15,0.8,11,34,45,22,8,3,14,14,29,54,0.5370370370370371,0
43,86,0.5,20,47,0.426,11,13,0.846,7,33,40,31,6,5,13,15,23,39,0.5897435897435898,1
38,85,0.447,13,40,0.325,5,9,0.556,11,28,39,26,4,4,16,15,25,45,0.5555555555555556,0
36,81,0.444,16,36,0.444,17,18,0.944,8,34,42,24,6,1,14,16,20,45,0.4444444444444444,1
34,86,0.395,13,37,0.351,15,24,0.625,18,20,38,22,8,2,10,18,21,49,0.42857142857142855,0
43,83,0.518,19,41,0.463,15,17,0.882,14,36,50,28,4,8,13,19,24,42,0.5714285714285714,1
41,90,0.456,12,34,0.353,13,21,0.619,6,35,41,25,7,5,10,26,29,56,0.5178571428571429,0
37,79,0.468,10,32,0.313,29,33,0.879,4,45,49,26,8,2,13,19,27,47,0.574468085106383,1
42,84,0.5,8,30,0.267,10,14,0.714,9,38,47,21,6,6,18,25,34,54,0.6296296296296297,1
35,87,0.402,7,30,0.233,23,31,0.742,13,29,42,16,11,5,10,18,28,57,0.49122807017543857,0
36,96,0.375,7,29,0.241,16,19,0.842,13,28,41,22,10,3,11,23,29,67,0.43283582089552236,0
43,78,0.551,9,21,0.429,16,23,0.696,8,37,45,24,5,7,17,20,34,57,0.5964912280701754,1
37,83,0.446,4,22,0.182,13,19,0.684,5,33,38,22,5,10,15,19,33,61,0.5409836065573771,0
47,89,0.528,14,34,0.412,18,23,0.783,11,39,50,29,12,6,11,20,33,55,0.6,1
38,94,0.404,11,34,0.324,14,21,0.667,19,34,53,21,5,4,17,16,27,60,0.45,0
53,98,0.541,11,31,0.355,7,10,0.7,8,38,46,28,10,8,10,19,42,67,0.6268656716417911,1
48,105,0.457,18,52,0.346,15,19,0.789,13,28,41,26,6,6,12,21,30,53,0.5660377358490566,0
50,103,0.485,14,39,0.359,17,23,0.739,19,41,60,28,7,5,18,20,36,64,0.5625,1
35,77,0.455,15,40,0.375,20,27,0.741,7,42,49,28,3,6,12,22,20,37,0.5405405405405406,1
30,83,0.361,16,42,0.381,20,22,0.909,4,31,35,18,6,6,9,21,14,41,0.34146341463414637,0
44,93,0.473,11,31,0.355,12,15,0.8,8,41,49,30,7,0,14,24,33,62,0.532258064516129,1
40,96,0.417,13,41,0.317,14,22,0.636,12,36,48,23,7,3,14,18,27,55,0.4909090909090909,0
30,78,0.385,5,29,0.172,24,35,0.686,10,31,41,20,13,1,17,21,25,49,0.5102040816326531,0
45,80,0.563,18,40,0.45,16,24,0.667,9,35,44,26,6,5,17,25,27,40,0.675,1
39,90,0.433,15,39,0.385,14,18,0.778,4,42,46,24,8,2,14,20,24,51,0.47058823529411764,1
39,98,0.398,12,44,0.273,14,17,0.824,8,43,51,22,4,3,11,21,27,54,0.5,0
45,88,0.511,23,48,0.479,11,16,0.688,6,33,39,24,10,5,12,23,22,40,0.55,1
38,84,0.452,14,39,0.359,17,23,0.739,9,33,42,33,5,3,18,15,24,45,0.5333333333333333,0
39,83,0.47,11,38,0.289,10,11,0.909,11,34,45,24,6,6,19,16,28,45,0.6222222222222222,0
44,90,0.489,14,29,0.483,12,15,0.8,10,28,38,25,10,3,9,11,30,61,0.4918032786885246,1
39,80,0.488,11,28,0.393,24,36,0.667,10,39,49,23,6,3,12,19,28,52,0.5384615384615384,1
39,93,0.419,13,35,0.371,19,19,1.0,8,34,42,22,8,4,8,25,26,58,0.4482758620689655,0
42,85,0.494,11,31,0.355,16,16,1.0,6,34,40,25,11,5,13,16,31,54,0.5740740740740741,1
35,90,0.389,10,35,0.286,19,21,0.905,12,34,46,25,4,2,17,17,25,55,0.45454545454545453,0
35,78,0.449,18,44,0.409,13,17,0.765,9,35,44,25,5,3,18,18,17,34,0.5,1
35,79,0.443,12,37,0.324,14,17,0.824,4,31,35,26,9,5,11,19,23,42,0.5476190476190477,0
39,82,0.476,11,32,0.344,24,30,0.8,11,42,53,22,10,5,16,21,28,50,0.56,1
31,82,0.378,15,38,0.395,26,28,0.929,5,33,38,18,9,6,15,21,16,44,0.36363636363636365,0
42,89,0.472,5,24,0.208,16,21,0.762,7,32,39,20,8,3,11,22,37,65,0.5692307692307692,0
45,82,0.549,8,26,0.308,21,29,0.724,6,33,39,25,7,6,11,21,37,56,0.6607142857142857,1
51,86,0.593,18,34,0.529,11,16,0.688,9,39,48,34,3,4,13,16,33,52,0.6346153846153846,1
39,90,0.433,12,37,0.324,25,25,1.0,11,27,38,27,5,3,8,14,27,53,0.5094339622641509,0
40,85,0.471,10,30,0.333,13,20,0.65,8,34,42,24,6,5,16,22,30,55,0.5454545454545454,0
47,89,0.528,15,37,0.405,15,20,0.75,8,36,44,26,11,4,10,18,32,52,0.6153846153846154,1
39,89,0.438,10,34,0.294,17,20,0.85,5,33,38,19,10,4,9,22,29,55,0.5272727272727272,0
44,89,0.494,11,23,0.478,15,16,0.938,10,38,48,21,4,3,15,15,33,66,0.5,1
39,83,0.47,17,36,0.472,21,25,0.84,15,25,40,25,8,6,12,26,22,47,0.46808510638297873,1
34,68,0.5,11,32,0.344,24,30,0.8,5,24,29,29,4,4,19,25,23,36,0.6388888888888888,0
40,81,0.494,7,25,0.28,26,30,0.867,6,31,37,20,6,4,12,23,33,56,0.5892857142857143,0
45,91,0.495,7,32,0.219,25,28,0.893,8,33,41,26,6,7,9,21,38,59,0.6440677966101694,1
40,82,0.488,6,21,0.286,12,19,0.632,6,26,32,22,11,3,16,21,34,61,0.5573770491803278,0
42,79,0.532,9,29,0.31,25,26,0.962,9,38,47,25,9,2,20,23,33,50,0.66,1
50,86,0.581,17,38,0.447,16,18,0.889,4,34,38,35,9,7,17,22,33,48,0.6875,1
41,88,0.466,7,24,0.292,26,34,0.765,10,27,37,22,6,3,15,17,34,64,0.53125,0
39,90,0.433,16,46,0.348,17,21,0.81,12,33,45,27,9,8,14,25,23,44,0.5227272727272727,1
36,82,0.439,15,41,0.366,20,29,0.69,11,34,45,20,5,2,16,19,21,41,0.5121951219512195,0
30,78,0.385,12,43,0.279,20,29,0.69,1,35,36,26,6,7,18,22,18,35,0.5142857142857142,0
41,98,0.418,12,44,0.273,16,24,0.667,15,46,61,23,13,6,15,25,29,54,0.5370370370370371,1
45,104,0.433,14,47,0.298,8,10,0.8,12,32,44,16,12,5,13,19,31,57,0.543859649122807,0
42,89,0.472,13,37,0.351,19,30,0.633,13,44,57,34,10,3,20,13,29,52,0.5576923076923077,1
41,82,0.5,19,35,0.543,14,19,0.737,14,32,46,25,5,5,17,14,22,47,0.46808510638297873,1
43,89,0.483,11,32,0.344,8,10,0.8,9,27,36,23,10,5,11,19,32,57,0.5614035087719298,0
44,92,0.478,13,37,0.351,15,18,0.833,10,28,38,29,8,4,13,19,31,55,0.5636363636363636,0
44,85,0.518,21,47,0.447,16,18,0.889,7,34,41,27,7,6,17,20,23,38,0.6052631578947368,1
45,97,0.464,13,24,0.542,21,27,0.778,12,38,50,25,11,3,13,21,32,73,0.4383561643835616,1
36,88,0.409,13,35,0.371,20,26,0.769,10,35,45,21,5,6,18,20,23,53,0.4339622641509434,0
50,100,0.5,15,41,0.366,13,18,0.722,11,32,43,27,8,4,7,18,35,59,0.5932203389830508,1
46,93,0.495,13,37,0.351,21,26,0.808,13,37,50,26,5,6,13,18,33,56,0.5892857142857143,0
35,80,0.438,13,36,0.361,24,30,0.8,8,34,42,18,8,6,14,21,22,44,0.5,0
42,89,0.472,17,45,0.378,13,17,0.765,12,33,45,23,6,3,13,20,25,44,0.5681818181818182,1
39,94,0.415,10,31,0.323,12,13,0.923,12,38,50,20,6,4,16,14,29,63,0.4603174603174603,1
39,102,0.382,9,46,0.196,6,8,0.75,16,35,51,24,8,8,16,14,30,56,0.5357142857142857,0
46,93,0.495,14,38,0.368,10,17,0.588,13,34,47,27,15,5,19,18,32,55,0.5818181818181818,1
43,93,0.462,10,36,0.278,11,16,0.688,15,27,42,29,8,6,21,24,33,57,0.5789473684210527,0
45,90,0.5,16,45,0.356,13,14,0.929,9,37,46,36,11,3,15,13,29,45,0.6444444444444445,1
35,89,0.393,12,38,0.316,8,11,0.727,13,31,44,18,8,4,17,15,23,51,0.45098039215686275,0
37,83,0.446,16,39,0.41,13,19,0.684,7,32,39,26,11,3,13,16,21,44,0.4772727272727273,0
43,92,0.467,12,31,0.387,6,10,0.6,17,38,55,23,4,4,16,18,31,61,0.5081967213114754,1
37,79,0.468,11,36,0.306,15,21,0.714,11,36,47,26,5,5,20,21,26,43,0.6046511627906976,0
45,90,0.5,14,38,0.368,15,23,0.652,12,29,41,26,13,3,11,21,31,52,0.5961538461538461,1
42,94,0.447,9,31,0.29,16,20,0.8,11,36,47,27,7,4,9,23,33,63,0.5238095238095238,1
35,81,0.432,14,44,0.318,19,30,0.633,8,38,46,17,5,6,16,23,21,37,0.5675675675675675,0
42,82,0.512,12,34,0.353,14,22,0.636,9,37,46,25,6,8,20,25,30,48,0.625,0
40,93,0.43,10,30,0.333,25,31,0.806,16,27,43,20,10,3,10,17,30,63,0.47619047619047616,1
28,74,0.378,13,43,0.302,21,33,0.636,8,31,39,23,4,3,13,27,15,31,0.4838709677419355,0
35,75,0.467,8,32,0.25,22,30,0.733,6,41,47,24,4,2,15,28,27,43,0.627906976744186,1
35,74,0.473,11,32,0.344,24,28,0.857,9,42,51,17,4,9,25,18,24,42,0.5714285714285714,1
35,91,0.385,9,34,0.265,21,25,0.84,10,23,33,22,13,5,8,22,26,57,0.45614035087719296,0
36,82,0.439,12,41,0.293,21,22,0.955,7,34,41,27,5,2,12,25,24,41,0.5853658536585366,0
36,77,0.468,15,34,0.441,24,31,0.774,6,31,37,26,6,3,9,22,21,43,0.4883720930232558,1
36,100,0.36,10,45,0.222,24,28,0.857,13,30,43,26,12,6,9,12,26,55,0.4727272727272727,0
54,95,0.568,20,41,0.488,9,13,0.692,10,47,57,35,5,8,18,21,34,54,0.6296296296296297,1
45,91,0.495,12,25,0.48,12,13,0.923,13,31,44,24,7,8,14,12,33,66,0.5,0
46,91,0.505,14,25,0.56,15,18,0.833,11,29,40,23,11,3,12,19,32,66,0.48484848484848486,1
36,72,0.5,10,25,0.4,26,31,0.839,2,32,34,20,11,7,17,23,26,47,0.5531914893617021,1
38,82,0.463,7,27,0.259,20,25,0.8,11,31,42,16,9,5,18,23,31,55,0.5636363636363636,0
44,78,0.564,12,33,0.364,18,24,0.75,7,28,35,27,4,4,14,17,32,45,0.7111111111111111,0
47,88,0.534,16,35,0.457,23,24,0.958,9,25,34,33,7,5,8,23,31,53,0.5849056603773585,1
37,83,0.446,13,32,0.406,11,16,0.688,6,31,37,23,10,3,21,9,24,51,0.47058823529411764,0
46,88,0.523,15,37,0.405,6,9,0.667,10,32,42,28,12,9,16,18,31,51,0.6078431372549019,1
50,114,0.439,12,37,0.324,4,6,0.667,23,43,66,37,11,4,12,19,38,77,0.4935064935064935,1
34,87,0.391,9,32,0.281,15,20,0.75,9,34,43,18,6,5,15,15,25,55,0.45454545454545453,0
36,84,0.429,11,38,0.289,19,28,0.679,9,38,47,24,7,7,14,17,25,46,0.5434782608695652,1
39,101,0.386,11,32,0.344,10,13,0.769,17,34,51,24,9,2,12,21,28,69,0.4057971014492754,0
39,101,0.386,15,43,0.349,9,9,1.0,11,40,51,27,7,4,13,25,24,58,0.41379310344827586,0
34,96,0.354,16,53,0.302,28,37,0.757,22,46,68,21,4,6,17,14,18,43,0.4186046511627907,1
36,79,0.456,13,40,0.325,17,20,0.85,9,30,39,26,4,5,17,22,23,39,0.5897435897435898,0
42,86,0.488,11,34,0.324,19,23,0.826,10,34,44,30,11,3,11,22,31,52,0.5961538461538461,1
41,93,0.441,12,41,0.293,14,15,0.933,8,45,53,29,11,4,16,18,29,52,0.5576923076923077,1
34,87,0.391,7,35,0.2,15,23,0.652,6,41,47,14,9,3,15,18,27,52,0.5192307692307693,0
31,87,0.356,11,31,0.355,23,28,0.821,11,31,42,22,6,3,12,13,20,56,0.35714285714285715,0
47,95,0.495,22,49,0.449,9,11,0.818,15,38,53,30,5,5,11,21,25,46,0.5434782608695652,1
35,78,0.449,13,34,0.382,14,19,0.737,7,24,31,18,12,4,11,17,22,44,0.5,0
42,80,0.525,12,33,0.364,15,18,0.833,8,36,44,27,5,3,16,19,30,47,0.6382978723404256,1
34,94,0.362,8,33,0.242,15,19,0.789,10,38,48,22,9,4,14,18,26,61,0.4262295081967213,0
40,90,0.444,11,33,0.333,14,19,0.737,13,39,52,22,5,7,13,19,29,57,0.5087719298245614,1
38,85,0.447,11,37,0.297,17,23,0.739,8,32,40,27,11,5,10,24,27,48,0.5625,1
32,80,0.4,12,31,0.387,22,29,0.759,13,36,49,21,4,8,14,19,20,49,0.40816326530612246,0
36,92,0.391,9,38,0.237,20,24,0.833,15,38,53,17,8,3,16,15,27,54,0.5,0
43,92,0.467,11,30,0.367,14,18,0.778,12,36,48,24,12,5,13,24,32,62,0.5161290322580645,1
36,86,0.419,13,45,0.289,21,31,0.677,13,39,52,23,0,7,15,21,23,41,0.5609756097560976,0
45,103,0.437,17,46,0.37,19,21,0.905,14,34,48,25,8,2,7,24,28,57,0.49122807017543857,1
33,84,0.393,13,44,0.295,15,26,0.577,4,35,39,21,7,5,11,18,20,40,0.5,0
42,94,0.447,8,34,0.235,16,19,0.842,15,45,60,22,7,4,11,25,34,60,0.5666666666666667,1
42,82,0.512,7,24,0.292,14,16,0.875,6,37,43,26,10,3,13,15,35,58,0.603448275862069,1
34,85,0.4,12,38,0.316,9,12,0.75,7,33,40,24,7,5,19,15,22,47,0.46808510638297873,0
37,82,0.451,10,36,0.278,18,22,0.818,6,41,47,26,7,5,12,16,27,46,0.5869565217391305,1
35,86,0.407,12,45,0.267,13,17,0.765,8,35,43,25,6,2,11,21,23,41,0.5609756097560976,0
39,94,0.415,16,47,0.34,21,24,0.875,12,38,50,28,10,8,11,21,23,47,0.48936170212765956,1
40,96,0.417,14,40,0.35,13,17,0.765,10,44,54,23,7,2,15,22,26,56,0.4642857142857143,0
38,90,0.422,8,26,0.308,20,24,0.833,14,28,42,18,10,6,13,20,30,64,0.46875,0
40,82,0.488,19,40,0.475,14,18,0.778,8,31,39,30,9,9,19,19,21,42,0.5,1
35,80,0.438,15,37,0.405,21,26,0.808,8,20,28,16,9,6,13,17,20,43,0.46511627906976744,0
46,88,0.523,13,38,0.342,13,19,0.684,15,32,47,27,6,6,15,21,33,50,0.66,1
46,95,0.484,18,39,0.462,28,33,0.848,12,38,50,33,7,5,6,21,28,56,0.5,1
44,94,0.468,5,27,0.185,17,30,0.567,14,34,48,21,4,6,14,20,39,67,0.582089552238806,0
36,80,0.45,18,40,0.45,22,25,0.88,6,37,43,23,9,5,16,25,18,40,0.45,0
43,88,0.489,12,32,0.375,17,19,0.895,6,37,43,23,4,0,13,25,31,56,0.5535714285714286,1
42,75,0.56,16,37,0.432,24,32,0.75,5,33,38,30,4,6,11,18,26,38,0.6842105263157895,1
42,93,0.452,13,42,0.31,20,23,0.87,14,30,44,17,2,1,7,21,29,51,0.5686274509803921,0
37,86,0.43,13,30,0.433,23,26,0.885,12,34,46,21,4,2,10,13,24,56,0.42857142857142855,1
38,88,0.432,9,32,0.281,19,21,0.905,10,34,44,19,6,11,9,26,29,56,0.5178571428571429,0
37,82,0.451,7,24,0.292,17,19,0.895,11,35,46,20,5,4,16,19,30,58,0.5172413793103449,1
33,80,0.413,6,27,0.222,24,26,0.923,8,30,38,20,8,7,8,13,27,53,0.5094339622641509,0
37,96,0.385,11,41,0.268,16,21,0.762,11,33,44,17,6,5,13,10,26,55,0.4727272727272727,0
45,93,0.484,15,39,0.385,8,13,0.615,11,41,52,26,9,8,14,22,30,54,0.5555555555555556,1
45,101,0.446,17,45,0.378,9,12,0.75,15,29,44,29,7,4,14,19,28,56,0.5,0
48,90,0.533,16,39,0.41,16,22,0.727,10,35,45,31,7,7,15,17,32,51,0.6274509803921569,1
43,89,0.483,14,32,0.438,22,27,0.815,6,35,41,31,6,9,12,25,29,57,0.5087719298245614,1
40,96,0.417,10,35,0.286,25,28,0.893,12,35,47,29,8,5,14,23,30,61,0.4918032786885246,0
38,89,0.427,17,45,0.378,20,24,0.833,11,33,44,24,9,8,14,23,21,44,0.4772727272727273,0
43,91,0.473,12,33,0.364,19,27,0.704,15,33,48,24,7,6,13,20,31,58,0.5344827586206896,1
33,87,0.379,13,38,0.342,8,14,0.571,8,38,46,23,8,5,12,12,20,49,0.40816326530612246,0
38,85,0.447,20,50,0.4,5,12,0.417,9,41,50,28,6,6,10,13,18,35,0.5142857142857142,1
42,85,0.494,14,37,0.378,18,21,0.857,12,30,42,28,11,7,11,22,28,48,0.5833333333333334,1
40,83,0.482,11,30,0.367,16,16,1.0,9,28,37,20,5,2,13,17,29,53,0.5471698113207547,0
38,89,0.427,10,30,0.333,30,35,0.857,8,35,43,19,7,3,14,31,28,59,0.4745762711864407,0
40,90,0.444,12,36,0.333,28,37,0.757,13,36,49,24,9,6,14,24,28,54,0.5185185185185185,1
41,94,0.436,8,30,0.267,15,21,0.714,14,31,45,23,9,5,9,16,33,64,0.515625,0
43,76,0.566,11,23,0.478,16,22,0.727,2,38,40,17,5,6,15,20,32,53,0.6037735849056604,1
37,89,0.416,9,36,0.25,16,23,0.696,11,32,43,24,11,3,21,13,28,53,0.5283018867924528,0
56,106,0.528,22,52,0.423,10,12,0.833,13,39,52,39,12,5,15,17,34,54,0.6296296296296297,1
39,95,0.411,15,41,0.366,10,11,0.909,10,38,48,29,7,4,14,20,24,54,0.4444444444444444,1
40,86,0.465,8,26,0.308,12,18,0.667,8,38,46,26,8,7,14,22,32,60,0.5333333333333333,0
31,72,0.431,10,32,0.313,11,17,0.647,8,35,43,17,6,4,19,19,21,40,0.525,0
36,89,0.404,10,34,0.294,11,18,0.611,20,31,51,28,7,1,14,19,26,55,0.4727272727272727,1
39,94,0.415,10,41,0.244,24,28,0.857,11,38,49,26,10,4,11,19,29,53,0.5471698113207547,0
41,86,0.477,13,36,0.361,22,31,0.71,7,40,47,24,8,5,12,23,28,50,0.56,1
47,100,0.47,9,30,0.3,24,30,0.8,19,34,53,33,11,6,12,19,38,70,0.5428571428571428,1
34,81,0.42,10,29,0.345,24,27,0.889,9,29,38,22,7,9,18,23,24,52,0.46153846153846156,0
38,98,0.388,8,32,0.25,25,34,0.735,14,28,42,16,10,5,14,30,30,66,0.45454545454545453,0
51,91,0.56,13,27,0.481,29,37,0.784,9,43,52,39,6,5,19,28,38,64,0.59375,1
43,86,0.5,12,31,0.387,19,22,0.864,10,40,50,25,6,8,13,23,31,55,0.5636363636363636,1
35,90,0.389,8,33,0.242,18,28,0.643,14,29,43,22,6,1,8,18,27,57,0.47368421052631576,0
51,94,0.543,18,37,0.486,10,14,0.714,9,35,44,29,5,6,10,19,33,57,0.5789473684210527,1
40,89,0.449,15,34,0.441,23,26,0.885,11,34,45,22,3,5,10,14,25,55,0.45454545454545453,0
36,87,0.414,15,46,0.326,12,18,0.667,13,31,44,20,9,3,21,15,21,41,0.5121951219512195,0
47,88,0.534,18,41,0.439,11,14,0.786,7,32,39,33,13,4,16,18,29,47,0.6170212765957447,1
50,88,0.568,13,34,0.382,11,16,0.688,7,40,47,31,7,8,15,25,37,54,0.6851851851851852,1
37,97,0.381,14,37,0.378,20,27,0.741,17,28,45,25,7,4,12,17,23,60,0.38333333333333336,0
33,89,0.371,16,47,0.34,21,28,0.75,15,38,53,23,8,10,14,16,17,42,0.40476190476190477,0
40,90,0.444,14,34,0.412,14,19,0.737,11,42,53,30,7,5,14,17,26,56,0.4642857142857143,1
45,88,0.511,11,29,0.379,13,17,0.765,15,35,50,22,10,6,19,23,34,59,0.576271186440678,1
41,90,0.456,11,31,0.355,20,23,0.87,10,25,35,25,11,2,11,16,30,59,0.5084745762711864,0
48,84,0.571,12,33,0.364,24,33,0.727,10,31,41,38,6,4,13,31,36,51,0.7058823529411765,1
35,82,0.427,12,40,0.3,35,42,0.833,8,25,33,19,4,5,11,28,23,42,0.5476190476190477,0
39,86,0.453,9,31,0.29,23,30,0.767,7,48,55,19,9,4,15,15,30,55,0.5454545454545454,1
45,100,0.45,10,30,0.333,4,9,0.444,9,35,44,26,8,3,10,24,35,70,0.5,0
34,83,0.41,8,33,0.242,13,20,0.65,13,31,44,24,10,5,16,19,26,50,0.52,1
30,72,0.417,10,32,0.313,16,31,0.516,8,35,43,20,8,2,17,20,20,40,0.5,0
48,92,0.522,14,34,0.412,22,29,0.759,14,34,48,27,8,6,12,23,34,58,0.5862068965517241,1
44,83,0.53,16,35,0.457,19,25,0.76,4,26,30,24,10,7,14,20,28,48,0.5833333333333334,0
42,85,0.494,17,42,0.405,11,14,0.786,13,34,47,27,5,3,18,20,25,43,0.5813953488372093,0
41,92,0.446,16,34,0.471,21,23,0.913,14,28,42,26,14,5,8,13,25,58,0.43103448275862066,1
37,90,0.411,16,40,0.4,6,16,0.375,15,39,54,20,5,4,16,20,21,50,0.42,1
34,85,0.4,7,38,0.184,13,20,0.65,10,35,45,22,6,11,11,22,27,47,0.574468085106383,0
37,88,0.42,14,41,0.341,16,19,0.842,11,31,42,27,6,3,8,19,23,47,0.48936170212765956,0
36,80,0.45,16,36,0.444,20,26,0.769,8,36,44,24,3,8,13,16,20,44,0.45454545454545453,1
47,85,0.553,17,37,0.459,16,22,0.727,7,33,40,31,4,3,13,20,30,48,0.625,1
38,83,0.458,12,39,0.308,22,26,0.846,7,30,37,24,7,4,13,25,26,44,0.5909090909090909,0
35,90,0.389,11,33,0.333,30,36,0.833,8,37,45,16,6,6,9,21,24,57,0.42105263157894735,0
40,95,0.421,17,39,0.436,20,27,0.741,11,46,57,25,3,9,10,22,23,56,0.4107142857142857,1
34,77,0.442,14,30,0.467,32,38,0.842,8,34,42,23,6,4,8,18,20,47,0.425531914893617,1
38,87,0.437,15,41,0.366,18,22,0.818,9,34,43,24,7,5,10,24,23,46,0.5,0
33,81,0.407,11,28,0.393,14,17,0.824,9,40,49,17,5,4,16,12,22,53,0.41509433962264153,1
35,101,0.347,4,42,0.095,8,11,0.727,21,29,50,19,8,8,8,16,31,59,0.5254237288135594,0
44,92,0.478,11,26,0.423,18,26,0.692,10,27,37,26,6,3,11,17,33,66,0.5,0
52,84,0.619,10,22,0.455,17,22,0.773,6,35,41,38,9,6,15,18,42,62,0.6774193548387096,1
31,81,0.383,8,31,0.258,24,27,0.889,11,37,48,19,11,5,17,14,23,50,0.46,1
30,81,0.37,12,35,0.343,13,17,0.765,8,35,43,19,11,5,17,23,18,46,0.391304347826087,0
44,85,0.518,9,26,0.346,19,32,0.594,8,40,48,27,12,5,14,20,35,59,0.5932203389830508,1
36,86,0.419,17,45,0.378,19,29,0.655,10,35,45,25,8,6,18,20,19,41,0.4634146341463415,0
39,86,0.453,15,41,0.366,6,8,0.75,7,32,39,24,5,5,18,25,24,45,0.5333333333333333,0
35,85,0.412,10,30,0.333,24,29,0.828,13,30,43,18,13,5,13,11,25,55,0.45454545454545453,1
38,96,0.396,7,35,0.2,14,16,0.875,14,31,45,19,6,1,12,24,31,61,0.5081967213114754,0
41,89,0.461,12,34,0.353,21,28,0.75,18,38,56,22,7,7,15,15,29,55,0.5272727272727272,1
46,87,0.529,8,29,0.276,20,32,0.625,13,33,46,22,6,3,11,20,38,58,0.6551724137931034,1
37,88,0.42,14,40,0.35,17,24,0.708,11,34,45,23,6,3,11,28,23,48,0.4791666666666667,0
38,81,0.469,9,24,0.375,9,13,0.692,7,29,36,23,7,5,13,19,29,57,0.5087719298245614,0
36,75,0.48,10,26,0.385,13,15,0.867,7,31,38,21,5,2,15,21,26,49,0.5306122448979592,1
42,100,0.42,13,32,0.406,13,20,0.65,14,29,43,22,10,4,8,20,29,68,0.4264705882352941,1
37,81,0.457,7,27,0.259,21,27,0.778,12,40,52,21,4,9,18,22,30,54,0.5555555555555556,0
45,91,0.495,13,33,0.394,33,36,0.917,14,36,50,24,7,6,13,19,32,58,0.5517241379310345,1
42,87,0.483,13,36,0.361,21,27,0.778,6,27,33,26,5,1,10,26,29,51,0.5686274509803921,0
35,83,0.422,8,28,0.286,15,23,0.652,8,36,44,20,4,3,13,17,27,55,0.4909090909090909,0
45,90,0.5,9,29,0.31,11,17,0.647,10,37,47,27,7,8,8,19,36,61,0.5901639344262295,1
41,100,0.41,11,35,0.314,15,16,0.938,15,22,37,20,10,2,10,21,30,65,0.46153846153846156,0
45,83,0.542,10,27,0.37,23,26,0.885,13,38,51,28,6,7,18,18,35,56,0.625,1
43,97,0.443,16,38,0.421,19,21,0.905,14,30,44,23,8,4,2,23,27,59,0.4576271186440678,1
48,84,0.571,8,25,0.32,14,24,0.583,8,38,46,27,1,8,9,18,40,59,0.6779661016949152,0
40,86,0.465,14,33,0.424,26,31,0.839,11,32,43,21,7,6,14,16,26,53,0.49056603773584906,1
41,93,0.441,14,42,0.333,14,17,0.824,15,31,46,21,9,4,18,27,27,51,0.5294117647058824,0
35,86,0.407,12,27,0.444,26,30,0.867,8,34,42,22,11,5,11,19,23,59,0.3898305084745763,1
38,91,0.418,8,31,0.258,22,29,0.759,17,38,55,23,7,8,17,22,30,60,0.5,0
36,102,0.353,12,42,0.286,22,27,0.815,21,33,54,19,4,2,9,22,24,60,0.4,0
47,85,0.553,19,41,0.463,26,30,0.867,5,42,47,27,6,9,7,21,28,44,0.6363636363636364,1
39,90,0.433,12,35,0.343,15,24,0.625,11,36,47,24,3,8,11,15,27,55,0.4909090909090909,0
49,102,0.48,10,26,0.385,10,16,0.625,16,42,58,28,7,11,10,18,39,76,0.5131578947368421,1
30,81,0.37,8,41,0.195,12,22,0.545,5,43,48,12,6,3,10,12,22,40,0.55,0
36,87,0.414,18,43,0.419,5,7,0.714,7,42,49,21,6,3,10,17,18,44,0.4090909090909091,1
42,81,0.519,9,22,0.409,19,22,0.864,10,37,47,30,5,7,13,14,33,59,0.559322033898305,1
38,91,0.418,10,29,0.345,10,12,0.833,8,25,33,25,7,4,10,16,28,62,0.45161290322580644,0
38,78,0.487,15,34,0.441,17,19,0.895,3,34,37,27,6,7,13,24,23,44,0.5227272727272727,0
40,96,0.417,11,35,0.314,25,33,0.758,18,36,54,19,8,4,7,18,29,61,0.47540983606557374,1
40,93,0.43,14,41,0.341,14,22,0.636,11,30,41,23,9,5,10,30,26,52,0.5,0
37,78,0.474,11,29,0.379,35,41,0.854,10,39,49,18,4,5,18,20,26,49,0.5306122448979592,1
42,86,0.488,14,36,0.389,22,31,0.71,7,33,40,23,7,6,11,19,28,50,0.56,1
42,97,0.433,11,33,0.333,21,25,0.84,17,40,57,26,9,2,15,20,31,64,0.484375,0
42,102,0.412,12,40,0.3,20,28,0.714,13,35,48,30,8,3,17,27,30,62,0.4838709677419355,0
41,101,0.406,9,35,0.257,26,33,0.788,22,41,63,18,12,6,21,23,32,66,0.48484848484848486,1
46,86,0.535,10,32,0.313,22,27,0.815,13,33,46,33,10,6,18,23,36,54,0.6666666666666666,1
37,85,0.435,16,42,0.381,21,24,0.875,13,23,36,20,10,4,18,24,21,43,0.4883720930232558,0
39,95,0.411,16,51,0.314,19,30,0.633,14,36,50,28,10,5,15,16,23,44,0.5227272727272727,0
49,92,0.533,23,48,0.479,15,18,0.833,4,44,48,27,10,4,14,20,26,44,0.5909090909090909,1
46,86,0.535,17,32,0.531,14,21,0.667,7,33,40,39,10,2,15,24,29,54,0.5370370370370371,1
40,92,0.435,14,44,0.318,22,28,0.786,15,30,45,19,7,0,13,21,26,48,0.5416666666666666,0
41,84,0.488,17,34,0.5,21,25,0.84,6,38,44,17,4,4,15,24,24,50,0.48,1
46,87,0.529,6,27,0.222,21,26,0.808,6,37,43,26,9,3,12,22,40,60,0.6666666666666666,0
40,95,0.421,9,27,0.333,22,27,0.815,10,35,45,17,12,3,16,24,31,68,0.45588235294117646,0
39,86,0.453,13,36,0.361,25,28,0.893,9,37,46,25,5,10,22,23,26,50,0.52,1
52,103,0.505,17,41,0.415,12,12,1.0,14,39,53,36,15,4,17,21,35,62,0.5645161290322581,1
39,85,0.459,9,35,0.257,12,21,0.571,5,29,34,27,10,9,18,15,30,50,0.6,0
37,83,0.446,19,46,0.413,11,14,0.786,9,30,39,24,6,6,14,24,18,37,0.4864864864864865,0
41,88,0.466,6,26,0.231,20,28,0.714,12,36,48,26,6,4,11,11,35,62,0.5645161290322581,1
41,92,0.446,9,38,0.237,12,16,0.75,20,36,56,21,9,2,24,22,32,54,0.5925925925925926,0
36,75,0.48,13,41,0.317,23,29,0.793,4,24,28,20,13,5,18,16,23,34,0.6764705882352942,1
38,85,0.447,14,39,0.359,5,7,0.714,7,41,48,28,9,3,16,12,24,46,0.5217391304347826,1
35,85,0.412,10,30,0.333,6,9,0.667,7,34,41,20,11,4,11,16,25,55,0.45454545454545453,0
46,105,0.438,9,33,0.273,12,12,1.0,18,31,49,26,4,3,9,18,37,72,0.5138888888888888,0
40,78,0.513,13,34,0.382,22,27,0.815,7,32,39,31,3,2,16,18,27,44,0.6136363636363636,1
35,78,0.449,12,36,0.333,23,28,0.821,7,23,30,22,11,4,18,26,23,42,0.5476190476190477,0
41,86,0.477,13,34,0.382,25,30,0.833,11,33,44,21,9,5,17,27,28,52,0.5384615384615384,1
48,102,0.471,10,35,0.286,12,21,0.571,23,38,61,24,11,5,13,21,38,67,0.5671641791044776,1
37,82,0.451,9,31,0.29,21,26,0.808,8,25,33,28,10,10,13,20,28,51,0.5490196078431373,0
36,85,0.424,10,27,0.37,16,18,0.889,5,39,44,24,5,2,13,17,26,58,0.4482758620689655,0
37,86,0.43,11,31,0.355,17,23,0.739,10,39,49,17,10,4,13,16,26,55,0.4727272727272727,1
31,67,0.463,6,25,0.24,21,29,0.724,11,36,47,21,6,1,26,24,25,42,0.5952380952380952,0
35,78,0.449,14,37,0.378,19,21,0.905,5,23,28,23,12,5,11,21,21,41,0.5121951219512195,1
37,90,0.411,17,42,0.405,17,19,0.895,11,38,49,24,5,2,19,13,20,48,0.4166666666666667,0
45,92,0.489,14,38,0.368,11,13,0.846,7,36,43,39,11,6,12,17,31,54,0.5740740740740741,1
49,93,0.527,16,45,0.356,8,9,0.889,11,29,40,34,9,4,17,14,33,48,0.6875,1
39,78,0.5,11,32,0.344,15,17,0.882,4,27,31,22,12,3,21,10,28,46,0.6086956521739131,0
44,91,0.484,18,43,0.419,9,14,0.643,9,38,47,31,6,1,14,21,26,48,0.5416666666666666,1
39,92,0.424,11,46,0.239,17,22,0.773,11,36,47,21,9,2,8,12,28,46,0.6086956521739131,0
41,85,0.482,19,39,0.487,14,17,0.824,10,33,43,22,6,4,15,24,22,46,0.4782608695652174,1
39,97,0.402,12,46,0.261,14,22,0.636,17,30,47,21,7,5,10,21,27,51,0.5294117647058824,0
37,89,0.416,15,44,0.341,24,33,0.727,11,31,42,25,6,4,11,16,22,45,0.4888888888888889,0
50,96,0.521,17,40,0.425,16,17,0.941,12,42,54,33,7,7,14,21,33,56,0.5892857142857143,1
48,88,0.545,14,41,0.341,21,24,0.875,9,30,39,31,6,1,13,24,34,47,0.723404255319149,0
47,89,0.528,18,41,0.439,24,28,0.857,12,29,41,29,10,3,10,19,29,48,0.6041666666666666,1
50,104,0.481,14,38,0.368,7,13,0.538,13,32,45,28,14,5,9,22,36,66,0.5454545454545454,0
40,87,0.46,16,38,0.421,28,31,0.903,10,41,51,26,5,4,15,12,24,49,0.4897959183673469,1
42,90,0.467,9,27,0.333,17,22,0.773,12,33,45,21,6,8,9,18,33,63,0.5238095238095238,1
40,92,0.435,10,34,0.294,16,21,0.762,14,35,49,28,2,6,13,14,30,58,0.5172413793103449,0
43,83,0.518,14,34,0.412,14,18,0.778,9,36,45,31,2,3,18,18,29,49,0.5918367346938775,0
49,99,0.495,11,32,0.344,13,20,0.65,14,30,44,24,6,5,5,16,38,67,0.5671641791044776,1
46,85,0.541,17,31,0.548,14,20,0.7,5,37,42,32,7,5,11,24,29,54,0.5370370370370371,1
36,89,0.404,10,33,0.303,28,32,0.875,15,33,48,28,7,3,12,21,26,56,0.4642857142857143,0
32,76,0.421,9,38,0.237,21,32,0.656,9,26,35,22,3,3,12,20,23,38,0.6052631578947368,0
39,80,0.488,6,28,0.214,20,28,0.714,14,37,51,17,6,0,10,23,33,52,0.6346153846153846,1
41,95,0.432,9,35,0.257,13,19,0.684,17,33,50,27,6,3,20,23,32,60,0.5333333333333333,0
45,96,0.469,18,44,0.409,21,29,0.724,16,36,52,30,13,8,12,20,27,52,0.5192307692307693,1
42,88,0.477,10,26,0.385,5,5,1.0,12,36,48,20,6,5,18,13,32,62,0.5161290322580645,1
40,90,0.444,9,28,0.321,8,9,0.889,13,28,41,19,10,9,10,12,31,62,0.5,0
43,92,0.467,14,42,0.333,11,20,0.55,9,27,36,26,12,3,13,21,29,50,0.58,0
48,81,0.593,24,42,0.571,20,29,0.69,8,41,49,39,6,3,17,21,24,39,0.6153846153846154,1
33,81,0.407,5,28,0.179,11,16,0.688,8,38,46,20,10,5,17,20,28,53,0.5283018867924528,0
33,87,0.379,12,40,0.3,21,26,0.808,10,36,46,22,6,5,12,15,21,47,0.44680851063829785,1
43,92,0.467,14,41,0.341,15,18,0.833,8,36,44,22,7,4,7,18,29,51,0.5686274509803921,1
42,88,0.477,11,36,0.306,14,15,0.933,6,36,42,27,2,4,12,21,31,52,0.5961538461538461,0
49,86,0.57,5,21,0.238,26,29,0.897,9,29,38,28,13,4,12,20,44,65,0.676923076923077,1
41,82,0.5,13,39,0.333,26,28,0.929,7,26,33,26,3,5,17,19,28,43,0.6511627906976745,0
42,89,0.472,16,36,0.444,17,25,0.68,10,34,44,24,8,4,15,20,26,53,0.49056603773584906,1
38,85,0.447,17,39,0.436,18,26,0.692,9,36,45,22,10,8,18,18,21,46,0.45652173913043476,0
33,90,0.367,9,35,0.257,15,18,0.833,14,38,52,21,11,7,18,18,24,55,0.43636363636363634,0
36,90,0.4,12,44,0.273,14,20,0.7,15,40,55,23,11,7,16,16,24,46,0.5217391304347826,1
43,85,0.506,12,28,0.429,18,24,0.75,10,32,42,26,8,4,17,16,31,57,0.543859649122807,1
40,90,0.444,12,39,0.308,14,20,0.7,14,33,47,22,9,3,19,30,28,51,0.5490196078431373,0
37,82,0.451,19,41,0.463,22,29,0.759,14,36,50,29,3,3,11,21,18,41,0.43902439024390244,1
33,78,0.423,15,38,0.395,28,36,0.778,8,28,36,18,8,4,6,23,18,40,0.45,0
39,86,0.453,8,30,0.267,22,30,0.733,10,38,48,20,8,5,10,14,31,56,0.5535714285714286,1
38,90,0.422,11,27,0.407,15,20,0.75,10,37,47,15,6,1,11,20,27,63,0.42857142857142855,0
40,85,0.471,9,26,0.346,25,32,0.781,10,38,48,15,10,2,21,24,31,59,0.5254237288135594,1
40,91,0.44,10,39,0.256,21,26,0.808,9,32,41,18,9,6,15,27,30,52,0.5769230769230769,0
34,99,0.343,10,44,0.227,10,13,0.769,10,29,39,23,7,3,13,14,24,55,0.43636363636363634,0
48,98,0.49,10,32,0.313,12,19,0.632,18,43,61,31,8,9,19,18,38,66,0.5757575757575758,1
37,87,0.425,7,33,0.212,15,18,0.833,8,35,43,22,12,6,14,24,30,54,0.5555555555555556,0
35,83,0.422,8,34,0.235,23,29,0.793,8,38,46,20,7,5,17,18,27,49,0.5510204081632653,1
38,80,0.475,17,45,0.378,12,13,0.923,8,30,38,22,5,10,13,16,21,35,0.6,0
40,90,0.444,18,36,0.5,10,15,0.667,11,31,42,23,8,1,11,17,22,54,0.4074074074074074,1
31,86,0.36,6,28,0.214,21,25,0.84,8,41,49,20,5,7,13,16,25,58,0.43103448275862066,0
44,107,0.411,10,31,0.323,8,10,0.8,21,42,63,22,5,7,8,20,34,76,0.4473684210526316,1
44,96,0.458,16,45,0.356,17,21,0.81,13,32,45,21,6,3,11,20,28,51,0.5490196078431373,1
42,92,0.457,6,27,0.222,19,20,0.95,14,35,49,23,8,5,11,16,36,65,0.5538461538461539,0
45,88,0.511,7,24,0.292,25,26,0.962,10,31,41,28,8,5,15,15,38,64,0.59375,0
48,91,0.527,15,33,0.455,19,21,0.905,10,31,41,34,11,3,15,21,33,58,0.5689655172413793,1
40,92,0.435,11,29,0.379,20,24,0.833,12,35,47,21,6,3,12,19,29,63,0.4603174603174603,0
47,85,0.553,12,34,0.353,15,24,0.625,5,36,41,32,5,7,8,20,35,51,0.6862745098039216,1
49,90,0.544,17,38,0.447,15,28,0.536,11,44,55,34,6,4,16,24,32,52,0.6153846153846154,1
37,87,0.425,12,43,0.279,20,29,0.69,7,33,40,17,6,3,13,20,25,44,0.5681818181818182,0
43,96,0.448,13,36,0.361,19,27,0.704,13,41,54,29,3,0,15,18,30,60,0.5,0
50,101,0.495,17,41,0.415,17,19,0.895,8,39,47,37,14,4,8,26,33,60,0.55,1
50,90,0.556,17,41,0.415,18,25,0.72,8,37,45,39,12,8,15,18,33,49,0.673469387755102,1
36,89,0.404,15,44,0.341,18,23,0.783,13,32,45,26,10,4,20,23,21,45,0.4666666666666667,0
38,92,0.413,9,30,0.3,15,20,0.75,11,28,39,22,6,6,12,21,29,62,0.46774193548387094,0
45,87,0.517,8,23,0.348,21,27,0.778,12,37,49,28,7,4,13,18,37,64,0.578125,1
39,80,0.488,17,39,0.436,19,29,0.655,8,35,43,22,7,3,9,15,22,41,0.5365853658536586,1
37,92,0.402,16,35,0.457,11,19,0.579,16,35,51,22,8,5,12,19,21,57,0.3684210526315789,0
39,81,0.481,17,38,0.447,13,18,0.722,7,33,40,23,3,4,21,21,22,43,0.5116279069767442,0
45,100,0.45,12,41,0.293,20,25,0.8,19,29,48,26,11,7,9,17,33,59,0.559322033898305,1
29,79,0.367,11,31,0.355,6,15,0.4,11,29,40,13,8,4,14,15,18,48,0.375,0
36,76,0.474,12,29,0.414,15,17,0.882,9,36,45,26,8,8,12,15,24,47,0.5106382978723404,1
35,90,0.389,12,37,0.324,24,26,0.923,14,39,53,21,6,4,15,20,23,53,0.4339622641509434,0
44,99,0.444,16,48,0.333,10,17,0.588,13,36,49,29,10,3,11,25,28,51,0.5490196078431373,1
29,86,0.337,14,46,0.304,20,23,0.87,8,36,44,25,6,9,13,20,15,40,0.375,0
38,87,0.437,10,33,0.303,11,16,0.688,7,42,49,23,7,6,13,21,28,54,0.5185185185185185,1
40,84,0.476,15,35,0.429,18,19,0.947,9,30,39,20,6,3,15,25,25,49,0.5102040816326531,0
44,80,0.55,14,29,0.483,23,32,0.719,5,33,38,30,9,7,10,21,30,51,0.5882352941176471,1
44,100,0.44,12,38,0.316,23,31,0.742,16,40,56,26,9,11,10,21,32,62,0.5161290322580645,1
39,96,0.406,10,32,0.313,20,24,0.833,14,35,49,16,7,6,13,23,29,64,0.453125,0
44,88,0.5,22,44,0.5,13,15,0.867,11,38,49,33,9,1,16,18,22,44,0.5,1
30,79,0.38,14,34,0.412,26,29,0.897,6,29,35,24,10,1,16,14,16,45,0.35555555555555557,0
46,107,0.43,13,32,0.406,14,18,0.778,12,32,44,33,12,8,15,19,33,75,0.44,0
47,98,0.48,8,28,0.286,19,22,0.864,13,42,55,26,8,8,22,18,39,70,0.5571428571428572,1
39,90,0.433,11,33,0.333,10,13,0.769,8,31,39,23,8,3,7,15,28,57,0.49122807017543857,0
44,88,0.5,16,36,0.444,9,9,1.0,7,41,48,28,4,2,10,14,28,52,0.5384615384615384,1
32,75,0.427,7,24,0.292,11,18,0.611,8,34,42,21,9,3,19,10,25,51,0.49019607843137253,0
39,97,0.402,10,42,0.238,8,10,0.8,22,32,54,24,16,5,15,20,29,55,0.5272727272727272,1
55,108,0.509,15,42,0.357,16,21,0.762,18,38,56,37,10,10,11,22,40,66,0.6060606060606061,1
46,97,0.474,14,43,0.326,17,28,0.607,10,35,45,31,5,6,13,17,32,54,0.5925925925925926,0
35,78,0.449,7,26,0.269,16,19,0.842,6,33,39,19,6,2,13,14,28,52,0.5384615384615384,0
44,92,0.478,12,33,0.364,6,7,0.857,13,34,47,24,5,4,13,18,32,59,0.5423728813559322,1
47,86,0.547,11,30,0.367,22,32,0.688,10,37,47,33,10,10,14,22,36,56,0.6428571428571429,1
45,97,0.464,14,33,0.424,15,19,0.789,14,27,41,26,6,7,12,25,31,64,0.484375,0
37,89,0.416,13,36,0.361,12,16,0.75,18,35,53,28,7,2,15,14,24,53,0.4528301886792453,1
38,88,0.432,9,38,0.237,10,12,0.833,11,30,41,29,9,7,9,13,29,50,0.58,0
36,88,0.409,11,29,0.379,19,24,0.792,12,42,54,23,1,6,13,21,25,59,0.423728813559322,1
38,95,0.4,9,28,0.321,15,16,0.938,9,33,42,18,9,6,8,21,29,67,0.43283582089552236,0
33,85,0.388,7,31,0.226,15,21,0.714,8,38,46,20,8,5,12,17,26,54,0.48148148148148145,0
37,88,0.42,17,40,0.425,12,15,0.8,10,38,48,26,6,5,17,23,20,48,0.4166666666666667,1
34,75,0.453,12,33,0.364,21,25,0.84,7,28,35,20,5,5,13,18,22,42,0.5238095238095238,0
36,85,0.424,14,34,0.412,19,20,0.95,15,31,46,18,8,3,13,20,22,51,0.43137254901960786,1
36,94,0.383,11,37,0.297,15,17,0.882,10,37,47,22,10,6,20,21,25,57,0.43859649122807015,0
35,88,0.398,8,28,0.286,23,28,0.821,12,41,53,17,10,6,20,19,27,60,0.45,1
37,84,0.44,13,43,0.302,12,16,0.75,7,41,48,25,7,2,20,17,24,41,0.5853658536585366,0
38,96,0.396,13,44,0.295,14,16,0.875,13,35,48,23,12,3,14,16,25,52,0.4807692307692308,1
44,86,0.512,11,33,0.333,17,22,0.773,10,30,40,23,9,4,16,16,33,53,0.6226415094339622,0
48,93,0.516,19,37,0.514,11,12,0.917,9,30,39,30,9,7,12,20,29,56,0.5178571428571429,1
43,94,0.457,10,35,0.286,15,18,0.833,14,33,47,23,14,7,15,21,33,59,0.559322033898305,1
30,77,0.39,13,42,0.31,18,27,0.667,7,32,39,18,8,7,21,11,17,35,0.4857142857142857,0
39,95,0.411,8,29,0.276,10,15,0.667,13,30,43,19,7,7,10,18,31,66,0.4696969696969697,0
40,82,0.488,13,32,0.406,18,24,0.75,9,40,49,23,7,9,15,22,27,50,0.54,1
42,91,0.462,12,32,0.375,12,15,0.8,12,30,42,23,9,6,15,22,30,59,0.5084745762711864,0
40,86,0.465,15,38,0.395,19,26,0.731,11,36,47,23,8,9,15,17,25,48,0.5208333333333334,1
43,87,0.494,10,34,0.294,13,15,0.867,14,34,48,29,6,8,17,18,33,53,0.6226415094339622,1
39,91,0.429,14,30,0.467,16,22,0.727,15,28,43,20,10,3,12,16,25,61,0.4098360655737705,0
30,89,0.337,6,35,0.171,21,27,0.778,15,26,41,17,9,7,18,20,24,54,0.4444444444444444,0
50,92,0.543,18,34,0.529,15,19,0.789,14,47,61,33,13,4,18,23,32,58,0.5517241379310345,1
32,80,0.4,4,33,0.121,17,20,0.85,13,43,56,24,4,2,20,19,28,47,0.5957446808510638,0
34,84,0.405,10,34,0.294,9,12,0.75,3,28,31,23,12,4,9,22,24,50,0.48,1
35,82,0.427,13,36,0.361,25,29,0.862,4,41,45,25,8,5,17,19,22,46,0.4782608695652174,0
44,100,0.44,14,34,0.412,14,18,0.778,11,38,49,30,11,8,11,18,30,66,0.45454545454545453,1
42,86,0.488,18,39,0.462,23,31,0.742,9,23,32,27,11,4,13,24,24,47,0.5106382978723404,0
42,76,0.553,16,33,0.485,28,37,0.757,9,29,38,33,6,1,21,26,26,43,0.6046511627906976,1
35,74,0.473,11,32,0.344,18,22,0.818,10,29,39,25,10,2,20,23,24,42,0.5714285714285714,1
36,89,0.404,8,37,0.216,15,25,0.6,22,25,47,15,11,3,16,20,28,52,0.5384615384615384,0
47,98,0.48,11,39,0.282,13,15,0.867,9,32,41,23,5,1,5,20,36,59,0.6101694915254238,0
47,87,0.54,11,33,0.333,17,23,0.739,7,35,42,29,3,7,8,15,36,54,0.6666666666666666,1
43,90,0.478,16,45,0.356,13,14,0.929,10,44,54,28,7,4,15,20,27,45,0.6,1
31,82,0.378,13,45,0.289,16,23,0.696,6,31,37,20,8,3,14,15,18,37,0.4864864864864865,0
49,87,0.563,17,32,0.531,23,28,0.821,7,34,41,35,11,4,10,21,32,55,0.5818181818181818,1
38,81,0.469,11,30,0.367,25,31,0.806,10,25,35,22,5,6,17,20,27,51,0.5294117647058824,0
40,78,0.513,18,38,0.474,21,25,0.84,7,30,37,23,6,5,13,22,22,40,0.55,1
40,86,0.465,7,36,0.194,13,20,0.65,11,26,37,27,6,5,12,24,33,50,0.66,0
32,78,0.41,8,37,0.216,13,19,0.684,5,34,39,16,6,2,13,18,24,41,0.5853658536585366,0
42,90,0.467,12,27,0.444,12,15,0.8,11,43,54,24,5,4,9,21,30,63,0.47619047619047616,1
46,89,0.517,10,34,0.294,7,8,0.875,7,35,42,29,9,3,12,21,36,55,0.6545454545454545,1
34,73,0.466,12,30,0.4,18,28,0.643,3,30,33,18,3,3,17,13,22,43,0.5116279069767442,0
42,98,0.429,16,47,0.34,16,24,0.667,15,30,45,25,6,3,9,19,26,51,0.5098039215686274,0
49,89,0.551,11,30,0.367,16,19,0.842,8,37,45,28,8,7,13,20,38,59,0.6440677966101694,1
45,82,0.549,16,36,0.444,22,32,0.688,4,44,48,23,5,7,14,24,29,46,0.6304347826086957,1
43,99,0.434,17,46,0.37,21,27,0.778,9,34,43,27,10,5,9,24,26,53,0.49056603773584906,0
43,81,0.531,11,30,0.367,14,17,0.824,7,43,50,28,6,3,15,17,32,51,0.6274509803921569,1
34,85,0.4,16,47,0.34,7,11,0.636,4,28,32,11,7,2,7,16,18,38,0.47368421052631576,0
41,99,0.414,11,35,0.314,13,16,0.813,18,31,49,31,6,6,9,16,30,64,0.46875,0
43,82,0.524,10,31,0.323,16,21,0.762,6,36,42,26,6,4,10,14,33,51,0.6470588235294118,1
47,91,0.516,20,45,0.444,16,18,0.889,9,29,38,32,8,7,11,19,27,46,0.5869565217391305,1
41,98,0.418,7,32,0.219,20,22,0.909,21,29,50,16,7,11,12,19,34,66,0.5151515151515151,0
39,86,0.453,13,40,0.325,17,28,0.607,11,23,34,28,11,5,15,18,26,46,0.5652173913043478,0
52,83,0.627,21,42,0.5,15,20,0.75,6,34,40,35,7,3,16,25,31,41,0.7560975609756098,1
41,96,0.427,15,48,0.313,11,14,0.786,12,34,46,23,4,8,18,26,26,48,0.5416666666666666,0
42,92,0.457,8,32,0.25,24,35,0.686,16,40,56,22,10,7,14,15,34,60,0.5666666666666667,1
33,95,0.347,16,48,0.333,17,24,0.708,12,37,49,20,9,2,15,15,17,47,0.3617021276595745,0
44,86,0.512,18,41,0.439,12,18,0.667,5,49,54,29,10,7,17,16,26,45,0.5777777777777777,1
31,81,0.383,10,34,0.294,17,20,0.85,5,41,46,19,2,7,15,16,21,47,0.44680851063829785,0
43,97,0.443,14,39,0.359,13,16,0.813,13,44,57,23,8,4,6,18,29,58,0.5,1
53,94,0.564,19,42,0.452,13,17,0.765,9,38,47,39,12,5,7,17,34,52,0.6538461538461539,1
37,87,0.425,10,38,0.263,12,18,0.667,10,26,36,26,4,5,14,19,27,49,0.5510204081632653,0
45,87,0.517,15,45,0.333,11,15,0.733,4,39,43,32,9,4,20,18,30,42,0.7142857142857143,1
40,97,0.412,12,42,0.286,17,21,0.81,11,33,44,28,9,5,17,20,28,55,0.509090909090909,0
28,87,0.322,11,38,0.289,20,26,0.769,16,30,46,18,5,4,11,24,17,49,0.3469387755102041,0
38,81,0.469,8,27,0.296,19,23,0.826,9,34,43,22,7,6,8,25,30,54,0.5555555555555556,1
40,88,0.455,11,28,0.393,21,23,0.913,12,39,51,24,8,6,15,18,29,60,0.48333333333333334,1
34,88,0.386,13,43,0.302,13,18,0.722,9,33,42,20,9,7,12,20,21,45,0.4666666666666667,0
47,91,0.516,8,32,0.25,10,16,0.625,8,44,52,30,8,1,15,19,39,59,0.6610169491525424,1
34,89,0.382,7,31,0.226,10,13,0.769,10,31,41,19,8,6,15,16,27,58,0.46551724137931033,0
38,79,0.481,16,38,0.421,26,30,0.867,9,25,34,26,6,6,16,27,22,41,0.5365853658536586,0
41,77,0.532,14,30,0.467,28,30,0.933,9,28,37,30,6,5,16,27,27,47,0.574468085106383,1
37,78,0.474,11,31,0.355,14,18,0.778,7,37,44,20,4,4,20,21,26,47,0.5531914893617021,0
38,85,0.447,14,41,0.341,21,25,0.84,7,33,40,26,12,4,10,19,24,44,0.5454545454545454,1
44,101,0.436,13,43,0.302,13,16,0.813,13,37,50,25,7,4,17,19,31,58,0.5344827586206896,0
48,96,0.5,13,37,0.351,17,24,0.708,13,40,53,33,8,7,14,23,35,59,0.5932203389830508,1
46,95,0.484,8,20,0.4,14,24,0.583,12,34,46,24,7,3,9,13,38,75,0.5066666666666667,1
42,92,0.457,15,34,0.441,10,13,0.769,10,37,47,22,6,5,15,24,27,58,0.46551724137931033,0
42,83,0.506,13,31,0.419,20,26,0.769,11,33,44,24,2,0,11,20,29,52,0.5576923076923077,1
40,80,0.5,16,44,0.364,12,17,0.706,4,27,31,23,5,5,9,20,24,36,0.6666666666666666,0
44,87,0.506,12,29,0.414,12,15,0.8,7,25,32,31,3,3,6,19,32,58,0.5517241379310345,0
44,90,0.489,9,26,0.346,17,19,0.895,17,33,50,27,6,6,11,15,35,64,0.546875,1
40,87,0.46,9,31,0.29,16,24,0.667,12,23,35,27,9,3,12,18,31,56,0.5535714285714286,0
46,84,0.548,12,27,0.444,16,17,0.941,9,35,44,30,5,5,16,21,34,57,0.5964912280701754,1
37,77,0.481,7,26,0.269,11,16,0.688,5,32,37,16,7,3,17,26,30,51,0.5882352941176471,0
32,78,0.41,12,34,0.353,32,38,0.842,12,35,47,16,6,3,10,18,20,44,0.45454545454545453,1
36,82,0.439,10,30,0.333,14,19,0.737,8,33,41,21,4,3,11,15,26,52,0.5,0
47,91,0.516,23,40,0.575,16,17,0.941,9,42,51,35,9,2,6,17,24,51,0.47058823529411764,1
40,79,0.506,13,32,0.406,16,21,0.762,6,37,43,24,5,5,15,22,27,47,0.574468085106383,1
33,86,0.384,9,35,0.257,23,30,0.767,12,31,43,24,10,4,10,18,24,51,0.47058823529411764,0
40,91,0.44,12,35,0.343,11,20,0.55,16,34,50,25,7,8,15,25,28,56,0.5,1
26,77,0.338,12,39,0.308,32,35,0.914,9,32,41,19,8,8,13,23,14,38,0.3684210526315789,0
40,87,0.46,9,35,0.257,18,25,0.72,11,26,37,28,6,4,9,13,31,52,0.5961538461538461,1
36,83,0.434,10,27,0.37,20,22,0.909,14,37,51,17,4,5,16,21,26,56,0.4642857142857143,0
38,100,0.38,12,38,0.316,6,8,0.75,21,33,54,24,8,4,15,21,26,62,0.41935483870967744,0
34,83,0.41,11,37,0.297,22,27,0.815,15,39,54,19,6,5,15,12,23,46,0.5,1
39,85,0.459,13,39,0.333,24,35,0.686,8,31,39,19,13,2,13,25,26,46,0.5652173913043478,1
39,90,0.433,12,37,0.324,20,23,0.87,10,33,43,20,4,3,20,26,27,53,0.5094339622641509,0
44,84,0.524,15,39,0.385,22,29,0.759,9,42,51,26,8,5,9,16,29,45,0.6444444444444445,1
42,95,0.442,11,43,0.256,7,8,0.875,6,33,39,32,5,2,9,22,31,52,0.5961538461538461,0
51,87,0.586,11,27,0.407,22,30,0.733,11,40,51,30,4,7,15,26,40,60,0.6666666666666666,1
38,82,0.463,9,25,0.36,23,34,0.676,5,27,32,25,6,2,11,20,29,57,0.5087719298245614,0
32,82,0.39,13,42,0.31,22,29,0.759,7,40,47,20,6,3,15,17,19,40,0.475,0
45,91,0.495,16,43,0.372,13,20,0.65,6,41,47,30,8,9,16,21,29,48,0.6041666666666666,1
41,76,0.539,16,40,0.4,20,24,0.833,4,43,47,22,6,3,23,20,25,36,0.6944444444444444,1
41,91,0.451,12,38,0.316,18,24,0.75,7,30,37,26,16,2,12,24,29,53,0.5471698113207547,0
39,88,0.443,16,38,0.421,20,24,0.833,9,33,42,21,8,4,13,28,23,50,0.46,0
38,86,0.442,15,36,0.417,30,32,0.938,10,36,46,25,7,8,13,18,23,50,0.46,1
36,87,0.414,9,30,0.3,11,18,0.611,8,33,41,23,10,4,12,15,27,57,0.47368421052631576,0
38,80,0.475,10,32,0.313,18,20,0.9,5,42,47,22,6,4,14,18,28,48,0.5833333333333334,1
41,83,0.494,12,30,0.4,13,18,0.722,8,27,35,27,11,4,14,22,29,53,0.5471698113207547,0
42,81,0.519,11,32,0.344,19,21,0.905,8,32,40,26,7,3,16,14,31,49,0.6326530612244898,1
36,83,0.434,11,35,0.314,19,24,0.792,5,37,42,20,10,2,13,23,25,48,0.5208333333333334,0
35,88,0.398,12,37,0.324,22,28,0.786,11,36,47,28,10,7,11,19,23,51,0.45098039215686275,1
50,97,0.515,13,33,0.394,20,23,0.87,15,26,41,30,8,4,12,23,37,64,0.578125,0
45,82,0.549,18,36,0.5,31,36,0.861,8,29,37,32,7,7,13,18,27,46,0.5869565217391305,1
31,83,0.373,12,46,0.261,21,24,0.875,8,36,44,21,6,6,16,21,19,37,0.5135135135135135,0
38,86,0.442,11,37,0.297,14,23,0.609,10,35,45,15,7,5,13,19,27,49,0.5510204081632653,1
40,92,0.435,13,31,0.419,13,15,0.867,9,34,43,24,10,7,18,15,27,61,0.4426229508196721,0
47,92,0.511,10,25,0.4,15,20,0.75,10,38,48,29,14,7,18,13,37,67,0.5522388059701493,1
37,90,0.411,13,36,0.361,12,17,0.706,15,30,45,24,9,5,12,21,24,54,0.4444444444444444,0
38,83,0.458,9,24,0.375,19,22,0.864,13,36,49,20,11,8,12,18,29,59,0.4915254237288136,1
36,86,0.419,14,39,0.359,11,17,0.647,6,33,39,23,6,2,7,14,22,47,0.46808510638297873,1
32,80,0.4,12,34,0.353,11,21,0.524,14,39,53,22,7,4,15,19,20,46,0.43478260869565216,0
37,90,0.411,7,34,0.206,17,18,0.944,11,44,55,20,9,8,17,17,30,56,0.5357142857142857,1
34,90,0.378,8,32,0.25,12,20,0.6,10,40,50,21,9,7,16,15,26,58,0.4482758620689655,0
49,95,0.516,9,32,0.281,14,20,0.7,12,33,45,29,9,5,5,18,40,63,0.6349206349206349,1
41,92,0.446,9,30,0.3,16,22,0.727,13,34,47,21,3,2,12,16,32,62,0.5161290322580645,0
35,86,0.407,7,26,0.269,21,25,0.84,10,32,42,19,9,3,12,26,28,60,0.4666666666666667,0
42,87,0.483,9,30,0.3,24,32,0.75,9,40,49,25,7,6,12,18,33,57,0.5789473684210527,1
30,85,0.353,9,34,0.265,17,24,0.708,11,39,50,18,4,5,16,23,21,51,0.4117647058823529,0
34,83,0.41,14,42,0.333,20,27,0.741,13,41,54,26,12,3,13,25,20,41,0.4878048780487805,1
35,81,0.432,13,41,0.317,29,38,0.763,8,30,38,21,10,6,13,25,22,40,0.55,1
37,80,0.463,12,38,0.316,24,33,0.727,11,33,44,21,6,7,18,30,25,42,0.5952380952380952,0
42,97,0.433,17,46,0.37,21,29,0.724,16,29,45,21,10,3,13,24,25,51,0.49019607843137253,0
45,86,0.523,15,38,0.395,29,33,0.879,8,31,39,34,7,9,12,23,30,48,0.625,1
42,86,0.488,16,39,0.41,11,15,0.733,11,36,47,27,6,6,17,17,26,47,0.5531914893617021,1
39,90,0.433,14,46,0.304,10,13,0.769,8,30,38,27,8,3,14,20,25,44,0.5681818181818182,0
40,77,0.519,9,27,0.333,15,22,0.682,9,29,38,27,7,4,15,15,31,50,0.62,0
47,86,0.547,10,22,0.455,13,18,0.722,7,30,37,25,7,4,10,18,37,64,0.578125,1
35,91,0.385,8,32,0.25,20,25,0.8,16,28,44,17,11,1,12,21,27,59,0.4576271186440678,0
37,76,0.487,9,33,0.273,19,20,0.95,10,35,45,23,5,0,18,20,28,43,0.6511627906976745,1
52,97,0.536,15,39,0.385,9,12,0.75,12,35,47,35,6,3,14,24,37,58,0.6379310344827587,0
48,98,0.49,13,38,0.342,21,25,0.84,13,31,44,32,9,3,12,15,35,60,0.5833333333333334,1
44,90,0.489,11,30,0.367,12,15,0.8,14,34,48,28,6,8,13,22,33,60,0.55,1
40,90,0.444,11,34,0.324,13,18,0.722,12,28,40,23,4,7,11,18,29,56,0.5178571428571429,0
33,81,0.407,14,46,0.304,12,16,0.75,10,33,43,19,7,6,18,22,19,35,0.5428571428571428,0
37,80,0.463,12,35,0.343,18,25,0.72,9,34,43,24,12,6,16,15,25,45,0.5555555555555556,1
44,106,0.415,9,40,0.225,17,25,0.68,16,31,47,26,10,8,10,20,35,66,0.5303030303030303,0
46,97,0.474,13,37,0.351,21,22,0.955,13,43,56,29,7,6,15,21,33,60,0.55,1
40,90,0.444,18,35,0.514,12,16,0.75,9,34,43,26,4,4,11,19,22,55,0.4,0
45,83,0.542,10,28,0.357,23,27,0.852,6,38,44,21,7,8,10,15,35,55,0.6363636363636364,1
46,91,0.505,15,36,0.417,26,30,0.867,13,28,41,27,3,6,9,26,31,55,0.5636363636363636,1
44,84,0.524,12,27,0.444,31,44,0.705,8,27,35,22,4,8,7,17,32,57,0.5614035087719298,0
38,98,0.388,8,31,0.258,12,15,0.8,14,32,46,20,5,2,15,14,30,67,0.44776119402985076,0
47,96,0.49,15,40,0.375,9,14,0.643,11,39,50,32,9,13,9,17,32,56,0.5714285714285714,1
41,96,0.427,22,45,0.489,12,17,0.706,12,32,44,24,4,3,9,18,19,51,0.37254901960784315,1
42,89,0.472,10,38,0.263,17,20,0.85,11,38,49,26,7,5,9,16,32,51,0.6274509803921569,0
47,89,0.528,8,25,0.32,17,20,0.85,7,29,36,23,5,4,15,25,39,64,0.609375,1
41,86,0.477,10,29,0.345,26,32,0.813,13,27,40,23,6,8,13,19,31,57,0.543859649122807,0
39,86,0.453,8,36,0.222,23,25,0.92,5,35,40,25,13,1,7,21,31,50,0.62,1
37,85,0.435,11,37,0.297,16,20,0.8,10,40,50,19,1,3,19,22,26,48,0.5416666666666666,0
41,95,0.432,15,35,0.429,24,34,0.706,13,35,48,23,12,3,18,23,26,60,0.43333333333333335,1
42,94,0.447,9,42,0.214,24,29,0.828,15,38,53,28,11,6,21,28,33,52,0.6346153846153846,0
38,76,0.5,11,28,0.393,15,22,0.682,3,32,35,27,10,2,12,26,27,48,0.5625,1
29,77,0.377,9,38,0.237,24,36,0.667,14,34,48,21,6,5,15,21,20,39,0.5128205128205128,0
41,85,0.482,15,40,0.375,11,12,0.917,11,22,33,30,8,1,15,22,26,45,0.5777777777777777,0
38,68,0.559,14,33,0.424,20,24,0.833,6,30,36,26,3,1,18,17,24,35,0.6857142857142857,1
36,76,0.474,16,33,0.485,21,30,0.7,7,35,42,20,6,4,13,21,20,43,0.46511627906976744,1
37,82,0.451,11,37,0.297,20,23,0.87,8,34,42,25,7,7,12,24,26,45,0.5777777777777777,0
37,98,0.378,12,44,0.273,12,15,0.8,15,37,52,20,6,2,12,21,25,54,0.46296296296296297,0
45,99,0.455,17,49,0.347,14,20,0.7,16,46,62,34,8,5,12,18,28,50,0.56,1
43,82,0.524,11,25,0.44,25,40,0.625,13,35,48,19,11,10,16,24,32,57,0.5614035087719298,1
43,91,0.473,13,32,0.406,19,23,0.826,10,27,37,34,6,6,13,25,30,59,0.5084745762711864,0
38,89,0.427,10,35,0.286,17,20,0.85,8,31,39,25,10,3,12,15,28,54,0.5185185185185185,0
39,81,0.481,10,30,0.333,17,22,0.773,7,34,41,25,4,9,19,18,29,51,0.5686274509803921,1
31,85,0.365,7,38,0.184,21,24,0.875,6,43,49,21,4,4,10,21,24,47,0.5106382978723404,0
34,88,0.386,6,31,0.194,20,28,0.714,11,42,53,20,3,3,8,17,28,57,0.49122807017543857,1
42,85,0.494,13,30,0.433,19,23,0.826,8,37,45,23,12,4,19,24,29,55,0.5272727272727272,1
36,81,0.444,11,40,0.275,22,29,0.759,3,32,35,23,6,9,18,21,25,41,0.6097560975609756,0
40,87,0.46,11,32,0.344,11,15,0.733,10,39,49,21,5,0,12,21,29,55,0.5272727272727272,1
38,91,0.418,10,28,0.357,15,21,0.714,13,31,44,23,7,3,7,17,28,63,0.4444444444444444,0
48,100,0.48,9,25,0.36,12,12,1.0,12,41,53,24,3,5,8,17,39,75,0.52,1
37,95,0.389,8,29,0.276,20,24,0.833,16,33,49,24,3,7,6,13,29,66,0.4393939393939394,0
38,87,0.437,13,32,0.406,12,16,0.75,9,31,40,22,6,4,11,24,25,55,0.45454545454545453,0
36,79,0.456,10,31,0.323,29,34,0.853,7,37,44,22,3,7,11,21,26,48,0.5416666666666666,1
42,90,0.467,11,30,0.367,14,17,0.824,11,29,40,20,10,4,8,15,31,60,0.5166666666666667,1
43,85,0.506,11,33,0.333,8,10,0.8,11,34,45,29,3,3,18,16,32,52,0.6153846153846154,0
33,85,0.388,12,41,0.293,9,16,0.563,11,30,41,16,14,3,15,28,21,44,0.4772727272727273,0
35,76,0.461,6,27,0.222,18,35,0.514,15,39,54,22,5,6,23,20,29,49,0.5918367346938775,1
51,97,0.526,15,37,0.405,10,16,0.625,13,35,48,29,4,2,14,20,36,60,0.6,0
45,91,0.495,21,42,0.5,22,25,0.88,9,34,43,19,12,0,7,14,24,49,0.4897959183673469,1
37,84,0.44,10,29,0.345,19,27,0.704,12,32,44,19,5,5,18,18,27,55,0.4909090909090909,0
47,96,0.49,7,25,0.28,12,14,0.857,14,37,51,34,11,8,11,19,40,71,0.5633802816901409,1
40,88,0.455,15,39,0.385,18,24,0.75,7,38,45,25,12,6,10,22,25,49,0.5102040816326531,1
34,87,0.391,4,36,0.111,19,27,0.704,11,43,54,23,6,6,16,24,30,51,0.5882352941176471,0
37,99,0.374,4,24,0.167,13,19,0.684,21,29,50,20,10,3,15,25,33,75,0.44,0
36,74,0.486,9,30,0.3,23,31,0.742,9,33,42,22,10,12,18,23,27,44,0.6136363636363636,1
42,75,0.56,11,29,0.379,16,19,0.842,4,30,34,28,4,5,22,29,31,46,0.6739130434782609,0
44,85,0.518,12,35,0.343,17,23,0.739,8,26,34,29,8,1,13,22,32,50,0.64,1
31,81,0.383,11,35,0.314,19,23,0.826,17,34,51,17,7,2,12,13,20,46,0.43478260869565216,0
36,83,0.434,13,42,0.31,9,10,0.9,10,30,40,19,8,5,10,19,23,41,0.5609756097560976,1
36,79,0.456,11,40,0.275,24,30,0.8,7,31,38,20,7,1,18,20,25,39,0.6410256410256411,0
40,81,0.494,15,33,0.455,18,20,0.9,6,33,39,31,9,3,16,31,25,48,0.5208333333333334,1
48,95,0.505,15,38,0.395,14,15,0.933,16,32,48,27,4,1,19,29,33,57,0.5789473684210527,0
48,92,0.522,14,32,0.438,26,31,0.839,10,27,37,24,11,7,9,17,34,60,0.5666666666666667,1
34,79,0.43,14,41,0.341,20,30,0.667,6,34,40,20,7,6,12,19,20,38,0.5263157894736842,0
39,91,0.429,16,36,0.444,16,19,0.842,15,37,52,26,6,4,13,22,23,55,0.41818181818181815,1
33,76,0.434,5,21,0.238,24,32,0.75,11,33,44,10,3,4,22,22,28,55,0.509090909090909,0
42,80,0.525,12,26,0.462,18,23,0.783,3,32,35,31,7,8,14,25,30,54,0.5555555555555556,1
44,92,0.478,7,16,0.438,20,23,0.87,13,34,47,22,5,3,10,19,37,76,0.4868421052631579,1
42,89,0.472,10,30,0.333,15,22,0.682,12,31,43,30,4,5,9,15,32,59,0.5423728813559322,0
45,85,0.529,18,32,0.563,6,13,0.462,10,37,47,31,8,7,22,17,27,53,0.5094339622641509,1
39,98,0.398,18,54,0.333,9,14,0.643,15,28,43,28,15,8,16,18,21,44,0.4772727272727273,0
40,90,0.444,19,39,0.487,17,21,0.81,11,46,57,26,5,3,13,16,21,51,0.4117647058823529,1
33,93,0.355,8,34,0.235,13,16,0.813,9,35,44,20,8,6,7,14,25,59,0.423728813559322,0
35,84,0.417,12,38,0.316,11,21,0.524,11,34,45,21,11,1,12,19,23,46,0.5,0
35,81,0.432,13,36,0.361,12,20,0.6,12,39,51,29,7,1,20,18,22,45,0.4888888888888889,1
38,87,0.437,19,46,0.413,18,25,0.72,10,31,41,26,5,7,17,28,19,41,0.4634146341463415,0
41,88,0.466,6,30,0.2,29,31,0.935,12,33,45,23,7,4,12,22,35,58,0.603448275862069,1
41,89,0.461,15,39,0.385,14,19,0.737,10,41,51,31,7,9,19,23,26,50,0.52,1
38,92,0.413,16,45,0.356,18,24,0.75,10,34,44,26,9,5,11,15,22,47,0.46808510638297873,0
40,81,0.494,14,31,0.452,15,22,0.682,7,31,38,16,11,3,14,15,26,50,0.52,0
47,99,0.475,13,36,0.361,8,15,0.533,18,33,51,28,10,5,14,17,34,63,0.5396825396825397,1
29,95,0.305,6,33,0.182,11,15,0.733,15,30,45,15,7,8,12,14,23,62,0.3709677419354839,0
51,103,0.495,20,45,0.444,6,7,0.857,17,50,67,32,6,6,11,12,31,58,0.5344827586206896,1
42,89,0.472,12,38,0.316,10,10,1.0,5,28,33,23,12,9,10,19,30,51,0.5882352941176471,1
37,88,0.42,7,27,0.259,15,22,0.682,18,36,54,20,5,2,19,12,30,61,0.4918032786885246,0
36,84,0.429,11,32,0.344,27,31,0.871,16,40,56,25,7,1,25,17,25,52,0.4807692307692308,1
41,97,0.423,12,36,0.333,11,14,0.786,9,27,36,25,14,5,9,25,29,61,0.47540983606557374,0
32,91,0.352,10,40,0.25,18,18,1.0,10,29,39,17,9,4,11,17,22,51,0.43137254901960786,0
49,92,0.533,17,43,0.395,15,18,0.833,12,46,58,31,8,2,14,17,32,49,0.6530612244897959,1
58,101,0.574,12,32,0.375,6,6,1.0,11,38,49,38,8,5,13,22,46,69,0.6666666666666666,1
39,95,0.411,9,34,0.265,17,25,0.68,18,27,45,21,8,3,17,12,30,61,0.4918032786885246,0
40,83,0.482,9,22,0.409,18,26,0.692,11,28,39,26,5,7,8,25,31,61,0.5081967213114754,0
39,84,0.464,10,31,0.323,29,31,0.935,14,30,44,26,4,8,11,22,29,53,0.5471698113207547,1
36,82,0.439,14,43,0.326,23,31,0.742,11,38,49,21,8,10,17,19,22,39,0.5641025641025641,1
37,94,0.394,16,41,0.39,17,20,0.85,15,35,50,26,4,2,14,24,21,53,0.39622641509433965,0
40,82,0.488,10,31,0.323,23,32,0.719,9,28,37,25,7,2,12,20,30,51,0.5882352941176471,0
43,82,0.524,16,34,0.471,23,29,0.793,7,35,42,27,6,7,17,22,27,48,0.5625,1
39,94,0.415,11,29,0.379,27,31,0.871,12,36,48,28,9,5,12,29,28,65,0.4307692307692308,1
37,80,0.463,9,27,0.333,32,40,0.8,10,42,52,25,4,7,19,24,28,53,0.5283018867924528,0
39,93,0.419,12,40,0.3,14,19,0.737,10,32,42,23,6,3,12,20,27,53,0.5094339622641509,0
48,90,0.533,12,36,0.333,13,17,0.765,6,42,48,29,9,2,9,18,36,54,0.6666666666666666,1
42,89,0.472,15,36,0.417,25,27,0.926,12,36,48,27,8,2,13,21,27,53,0.5094339622641509,1
43,88,0.489,12,29,0.414,20,26,0.769,6,32,38,26,6,3,12,25,31,59,0.5254237288135594,0
38,79,0.481,12,31,0.387,17,28,0.607,8,26,34,24,8,5,12,17,26,48,0.5416666666666666,0
46,84,0.548,7,26,0.269,12,16,0.75,10,35,45,32,2,1,15,22,39,58,0.6724137931034483,1
37,80,0.463,9,32,0.281,16,18,0.889,10,31,41,22,7,3,19,19,28,48,0.5833333333333334,0
41,87,0.471,19,42,0.452,14,17,0.824,12,29,41,27,11,3,13,19,22,45,0.4888888888888889,1
54,93,0.581,24,45,0.533,26,33,0.788,8,28,36,37,9,5,13,29,30,48,0.625,1
44,92,0.478,10,34,0.294,28,34,0.824,17,24,41,33,9,3,20,31,34,58,0.5862068965517241,0
35,83,0.422,15,44,0.341,11,17,0.647,15,29,44,24,8,4,18,23,20,39,0.5128205128205128,0
37,74,0.5,16,37,0.432,20,22,0.909,7,31,38,30,8,3,20,23,21,37,0.5675675675675675,1
36,81,0.444,15,29,0.517,24,27,0.889,8,41,49,20,7,1,15,22,21,52,0.40384615384615385,1
38,84,0.452,9,35,0.257,17,22,0.773,8,31,39,29,9,3,13,23,29,49,0.5918367346938775,0
48,88,0.545,16,36,0.444,20,26,0.769,6,39,45,35,6,6,9,21,32,52,0.6153846153846154,1
42,82,0.512,14,38,0.368,14,23,0.609,3,35,38,27,4,1,9,21,28,44,0.6363636363636364,0
46,90,0.511,7,23,0.304,19,26,0.731,12,32,44,24,9,9,13,18,39,67,0.582089552238806,1
43,94,0.457,9,37,0.243,15,19,0.789,13,26,39,30,9,7,13,19,34,57,0.5964912280701754,0
40,82,0.488,7,18,0.389,18,27,0.667,9,35,44,14,6,7,9,20,33,64,0.515625,1
34,79,0.43,12,30,0.4,17,23,0.739,8,31,39,20,6,4,16,28,22,49,0.4489795918367347,0
42,95,0.442,10,44,0.227,21,27,0.778,10,31,41,22,10,4,9,15,32,51,0.6274509803921569,0
44,82,0.537,21,36,0.583,15,21,0.714,10,37,47,31,8,3,19,23,23,46,0.5,1
36,88,0.409,6,29,0.207,9,9,1.0,9,33,42,19,7,9,19,16,30,59,0.5084745762711864,0
41,82,0.5,13,35,0.371,10,17,0.588,3,38,41,30,8,5,15,14,28,47,0.5957446808510638,1
30,86,0.349,7,36,0.194,25,27,0.926,16,36,52,15,5,8,18,25,23,50,0.46,0
41,89,0.461,12,31,0.387,14,20,0.7,9,34,43,19,10,11,12,21,29,58,0.5,1
38,91,0.418,15,40,0.375,23,32,0.719,12,32,44,19,7,3,7,23,23,51,0.45098039215686275,0
43,83,0.518,11,36,0.306,20,28,0.714,11,39,50,25,4,5,12,24,32,47,0.6808510638297872,1
46,81,0.568,17,39,0.436,16,20,0.8,4,30,34,20,10,4,15,24,29,42,0.6904761904761905,1
38,79,0.481,10,41,0.244,24,31,0.774,5,33,38,25,6,3,19,22,28,38,0.7368421052631579,0
37,85,0.435,17,46,0.37,18,21,0.857,11,26,37,20,10,3,18,16,20,39,0.5128205128205128,0
46,82,0.561,9,23,0.391,18,24,0.75,8,34,42,27,9,7,15,19,37,59,0.6271186440677966,1
41,92,0.446,9,35,0.257,23,32,0.719,9,28,37,22,7,3,13,21,32,57,0.5614035087719298,0
40,85,0.471,15,34,0.441,26,27,0.963,12,39,51,28,6,3,18,23,25,51,0.49019607843137253,1
39,84,0.464,14,40,0.35,16,28,0.571,11,34,45,21,6,4,14,23,25,44,0.5681818181818182,0
41,89,0.461,14,43,0.326,27,31,0.871,11,36,47,27,11,1,13,24,27,46,0.5869565217391305,1
41,82,0.5,12,33,0.364,22,25,0.88,9,34,43,29,9,4,21,22,29,49,0.5918367346938775,1
35,90,0.389,5,34,0.147,30,33,0.909,14,29,43,23,14,4,13,19,30,56,0.5357142857142857,0
41,95,0.432,13,39,0.333,18,29,0.621,19,41,60,25,7,6,21,20,28,56,0.5,1
43,95,0.453,14,43,0.326,10,17,0.588,10,33,43,22,12,6,14,27,29,52,0.5576923076923077,0
32,87,0.368,10,29,0.345,29,37,0.784,14,27,41,23,10,9,10,24,22,58,0.3793103448275862,0
41,83,0.494,12,25,0.48,25,26,0.962,8,39,47,28,5,7,17,22,29,58,0.5,1
44,90,0.489,14,39,0.359,22,27,0.815,8,30,38,20,7,6,7,26,30,51,0.5882352941176471,0
43,84,0.512,20,39,0.513,28,37,0.757,10,39,49,36,4,2,12,22,23,45,0.5111111111111111,1
46,88,0.523,8,30,0.267,22,26,0.846,4,33,37,22,5,2,6,16,38,58,0.6551724137931034,0
50,95,0.526,16,37,0.432,15,18,0.833,10,34,44,35,3,1,7,18,34,58,0.5862068965517241,1
40,91,0.44,9,33,0.273,16,23,0.696,10,37,47,25,1,7,11,21,31,58,0.5344827586206896,0
51,96,0.531,16,34,0.471,14,22,0.636,11,35,46,31,8,7,5,19,35,62,0.5645161290322581,1
39,98,0.398,11,28,0.393,17,21,0.81,18,34,52,21,7,10,11,15,28,70,0.4,0
40,98,0.408,14,45,0.311,16,18,0.889,16,39,55,24,8,8,12,23,26,53,0.49056603773584906,1
35,84,0.417,10,29,0.345,15,21,0.714,7,30,37,27,6,5,12,12,25,55,0.45454545454545453,0
46,100,0.46,13,31,0.419,10,12,0.833,21,39,60,24,8,10,9,21,33,69,0.4782608695652174,1
47,107,0.439,16,45,0.356,14,18,0.778,12,41,53,24,15,9,17,22,31,62,0.5,1
45,110,0.409,16,50,0.32,14,20,0.7,19,42,61,26,12,6,24,26,29,60,0.48333333333333334,0
43,81,0.531,14,41,0.341,7,11,0.636,6,37,43,31,6,7,15,19,29,40,0.725,1
36,82,0.439,8,32,0.25,17,23,0.739,9,31,40,22,8,0,15,14,28,50,0.56,0
36,82,0.439,12,35,0.343,17,20,0.85,10,33,43,24,9,2,13,21,24,47,0.5106382978723404,0
36,70,0.514,12,30,0.4,19,26,0.731,3,33,36,24,8,3,18,17,24,40,0.6,1
47,87,0.54,15,35,0.429,12,23,0.522,6,32,38,29,5,2,13,24,32,52,0.6153846153846154,0
49,84,0.583,10,31,0.323,21,32,0.656,8,37,45,31,7,0,12,21,39,53,0.7358490566037735,1
43,83,0.518,18,39,0.462,12,16,0.75,5,31,36,23,4,3,12,12,25,44,0.5681818181818182,0
50,90,0.556,13,32,0.406,17,18,0.944,8,36,44,36,10,3,7,16,37,58,0.6379310344827587,1
44,84,0.524,11,28,0.393,16,19,0.842,6,54,60,23,5,6,18,23,33,56,0.5892857142857143,1
32,98,0.327,8,34,0.235,18,27,0.667,11,33,44,24,8,2,9,15,24,64,0.375,0
38,82,0.463,13,34,0.382,16,25,0.64,12,29,41,25,6,6,13,20,25,48,0.5208333333333334,0
42,91,0.462,10,26,0.385,21,25,0.84,16,32,48,26,7,4,9,21,32,65,0.49230769230769234,1
53,88,0.602,23,43,0.535,7,10,0.7,6,35,41,39,8,3,10,15,30,45,0.6666666666666666,1
37,78,0.474,10,30,0.333,16,22,0.727,6,26,32,23,6,3,15,10,27,48,0.5625,0
38,81,0.469,15,40,0.375,15,21,0.714,9,29,38,23,8,4,20,24,23,41,0.5609756097560976,0
49,89,0.551,13,31,0.419,15,18,0.833,10,30,40,35,11,2,16,15,36,58,0.6206896551724138,1
39,81,0.481,16,38,0.421,14,18,0.778,7,33,40,22,9,4,18,19,23,43,0.5348837209302325,0
43,84,0.512,11,34,0.324,13,16,0.813,9,31,40,26,8,1,16,16,32,50,0.64,1
45,100,0.45,13,37,0.351,7,8,0.875,11,32,43,27,6,3,11,15,32,63,0.5079365079365079,0
48,97,0.495,11,32,0.344,8,12,0.667,11,35,46,31,6,5,8,12,37,65,0.5692307692307692,1
38,89,0.427,18,36,0.5,12,17,0.706,6,37,43,21,7,8,8,15,20,53,0.37735849056603776,1
37,81,0.457,12,32,0.375,14,16,0.875,5,41,46,28,6,5,15,20,25,49,0.5102040816326531,0
34,87,0.391,17,44,0.386,7,10,0.7,10,28,38,25,6,2,19,22,17,43,0.3953488372093023,0
44,84,0.524,16,42,0.381,18,27,0.667,9,35,44,24,9,6,10,15,28,42,0.6666666666666666,1
33,85,0.388,6,30,0.2,18,21,0.857,16,35,51,26,6,8,13,18,27,55,0.4909090909090909,0
36,84,0.429,9,31,0.29,12,14,0.857,7,30,37,26,6,9,10,19,27,53,0.5094339622641509,1
43,80,0.538,17,40,0.425,19,23,0.826,7,34,41,23,10,8,15,24,26,40,0.65,1
36,84,0.429,16,43,0.372,20,29,0.69,9,28,37,25,4,3,17,19,20,41,0.4878048780487805,0
45,96,0.469,15,44,0.341,11,13,0.846,10,31,41,25,7,5,10,15,30,52,0.5769230769230769,0
50,95,0.526,14,29,0.483,8,12,0.667,11,39,50,31,3,5,12,12,36,66,0.5454545454545454,1
37,86,0.43,11,38,0.289,11,22,0.5,9,27,36,24,6,5,16,23,26,48,0.5416666666666666,0
40,80,0.5,13,35,0.371,23,29,0.793,8,39,47,25,12,5,17,20,27,45,0.6,1
34,81,0.42,7,38,0.184,6,8,0.75,6,35,41,18,7,6,15,20,27,43,0.627906976744186,0
35,86,0.407,12,41,0.293,16,17,0.941,11,39,50,22,6,3,13,13,23,45,0.5111111111111111,1
47,102,0.461,6,30,0.2,19,28,0.679,15,33,48,18,14,6,14,15,41,72,0.5694444444444444,0
49,100,0.49,11,31,0.355,13,15,0.867,14,35,49,30,8,12,21,23,38,69,0.5507246376811594,1
46,93,0.495,14,39,0.359,9,11,0.818,3,33,36,33,7,4,9,18,32,54,0.5925925925925926,0
46,90,0.511,11,30,0.367,23,29,0.793,11,38,49,25,5,6,10,15,35,60,0.5833333333333334,1
39,89,0.438,8,28,0.286,25,28,0.893,16,30,46,24,8,5,17,17,31,61,0.5081967213114754,1
41,84,0.488,8,32,0.25,11,14,0.786,6,29,35,21,7,3,19,25,33,52,0.6346153846153846,0
36,82,0.439,12,35,0.343,14,20,0.7,7,33,40,22,4,5,12,16,24,47,0.5106382978723404,0
46,92,0.5,12,38,0.316,8,9,0.889,8,36,44,26,7,2,9,17,34,54,0.6296296296296297,1
38,89,0.427,14,44,0.318,25,28,0.893,10,36,46,27,7,4,12,17,24,45,0.5333333333333333,0
46,93,0.495,19,45,0.422,19,25,0.76,13,39,52,35,8,9,10,21,27,48,0.5625,1
40,81,0.494,16,40,0.4,15,21,0.714,6,27,33,25,7,1,12,27,24,41,0.5853658536585366,0
42,76,0.553,11,31,0.355,26,31,0.839,7,30,37,26,8,4,16,19,31,45,0.6888888888888889,1
43,96,0.448,20,46,0.435,18,18,1.0,15,31,46,30,10,3,16,17,23,50,0.46,1
46,83,0.554,16,33,0.485,12,17,0.706,5,29,34,33,7,7,14,17,30,50,0.6,0
38,78,0.487,8,30,0.267,22,25,0.88,10,28,38,26,8,1,17,25,30,48,0.625,0
39,81,0.481,12,26,0.462,20,29,0.69,15,28,43,20,9,3,15,24,27,55,0.4909090909090909,1
37,87,0.425,12,40,0.3,21,27,0.778,14,32,46,18,12,4,16,20,25,47,0.5319148936170213,0
42,82,0.512,14,36,0.389,15,17,0.882,6,36,42,31,9,5,19,21,28,46,0.6086956521739131,1
41,86,0.477,17,37,0.459,21,25,0.84,14,36,50,25,6,8,20,16,24,49,0.4897959183673469,1
46,98,0.469,14,43,0.326,8,10,0.8,13,26,39,28,12,8,14,21,32,55,0.5818181818181818,0
41,80,0.513,7,21,0.333,15,27,0.556,12,36,48,23,6,4,19,27,34,59,0.576271186440678,0
39,82,0.476,14,40,0.35,23,33,0.697,8,29,37,25,11,3,12,23,25,42,0.5952380952380952,1
42,95,0.442,11,35,0.314,24,26,0.923,9,43,52,29,5,3,12,21,31,60,0.5166666666666667,1
44,98,0.449,14,32,0.438,16,23,0.696,7,39,46,25,7,1,8,19,30,66,0.45454545454545453,0
35,98,0.357,14,42,0.333,10,19,0.526,18,37,55,23,11,3,13,28,21,56,0.375,0
33,78,0.423,11,30,0.367,22,33,0.667,12,41,53,25,8,7,17,18,22,48,0.4583333333333333,1
44,102,0.431,16,39,0.41,16,23,0.696,15,36,51,30,11,5,11,18,28,63,0.4444444444444444,1
38,88,0.432,12,36,0.333,20,26,0.769,13,35,48,23,5,10,15,19,26,52,0.5,0
41,90,0.456,9,22,0.409,15,19,0.789,15,37,52,25,1,5,10,14,32,68,0.47058823529411764,1
41,91,0.451,11,27,0.407,10,13,0.769,10,31,41,23,2,4,4,20,30,64,0.46875,0
41,84,0.488,8,25,0.32,11,14,0.786,10,30,40,22,7,12,13,16,33,59,0.559322033898305,0
41,93,0.441,14,42,0.333,16,18,0.889,15,33,48,23,8,7,14,15,27,51,0.5294117647058824,1
42,79,0.532,11,28,0.393,9,12,0.75,7,32,39,24,5,7,14,20,31,51,0.6078431372549019,0
42,86,0.488,7,29,0.241,17,22,0.773,8,29,37,21,8,4,8,12,35,57,0.6140350877192983,1
46,88,0.523,9,32,0.281,14,18,0.778,6,33,39,30,11,2,11,20,37,56,0.6607142857142857,0
44,84,0.524,20,40,0.5,16,22,0.727,6,35,41,25,6,1,15,21,24,44,0.5454545454545454,1
44,87,0.506,15,34,0.441,25,28,0.893,9,33,42,29,11,3,14,18,29,53,0.5471698113207547,1
40,91,0.44,15,46,0.326,22,28,0.786,13,32,45,27,3,6,16,24,25,45,0.5555555555555556,0
42,80,0.525,11,31,0.355,19,23,0.826,5,20,25,29,13,3,16,16,31,49,0.6326530612244898,0
47,84,0.56,20,42,0.476,12,16,0.75,9,31,40,27,11,3,16,19,27,42,0.6428571428571429,1
41,88,0.466,11,29,0.379,17,25,0.68,11,33,44,19,6,6,11,13,30,59,0.5084745762711864,0
46,89,0.517,13,30,0.433,6,11,0.545,7,36,43,29,5,6,10,22,33,59,0.559322033898305,1
42,83,0.506,12,30,0.4,16,18,0.889,7,35,42,27,13,3,14,27,30,53,0.5660377358490566,1
30,80,0.375,8,33,0.242,27,38,0.711,12,31,43,21,9,5,17,19,22,47,0.46808510638297873,0
43,90,0.478,12,29,0.414,22,24,0.917,10,41,51,30,8,7,17,19,31,61,0.5081967213114754,0
48,113,0.425,14,36,0.389,17,19,0.895,22,36,58,30,10,5,12,17,34,77,0.44155844155844154,1
36,90,0.4,14,35,0.4,16,20,0.8,15,36,51,26,7,0,12,17,22,55,0.4,1
38,92,0.413,14,43,0.326,11,12,0.917,15,37,52,27,9,2,14,22,24,49,0.4897959183673469,0
36,70,0.514,9,27,0.333,17,23,0.739,6,30,36,23,5,5,14,22,27,43,0.627906976744186,0
39,85,0.459,10,34,0.294,19,23,0.826,11,29,40,22,8,0,11,18,29,51,0.5686274509803921,1
42,75,0.56,8,25,0.32,21,23,0.913,5,33,38,27,8,5,15,18,34,50,0.68,1
35,78,0.449,19,41,0.463,16,17,0.941,7,24,31,22,9,4,15,20,16,37,0.43243243243243246,0
37,82,0.451,9,28,0.321,19,25,0.76,11,44,55,23,4,9,14,17,28,54,0.5185185185185185,1
34,104,0.327,10,26,0.385,15,20,0.75,20,36,56,18,5,4,11,24,24,78,0.3076923076923077,0
49,90,0.544,6,26,0.231,18,23,0.783,10,33,43,30,5,6,9,17,43,64,0.671875,1
47,95,0.495,12,27,0.444,9,9,1.0,10,27,37,25,3,3,13,19,35,68,0.5147058823529411,0
33,87,0.379,15,42,0.357,15,21,0.714,13,39,52,24,5,6,15,18,18,45,0.4,1
40,101,0.396,6,33,0.182,7,10,0.7,17,36,53,18,7,4,12,18,34,68,0.5,0
36,83,0.434,11,33,0.333,23,29,0.793,9,26,35,15,9,6,19,20,25,50,0.5,0
51,89,0.573,13,28,0.464,16,20,0.8,11,33,44,33,14,5,13,25,38,61,0.6229508196721312,1
43,93,0.462,9,29,0.31,19,21,0.905,13,27,40,27,12,4,9,16,34,64,0.53125,0
46,81,0.568,17,27,0.63,16,18,0.889,8,37,45,29,7,4,17,18,29,54,0.5370370370370371,1
41,99,0.414,12,34,0.353,8,11,0.727,16,26,42,25,10,2,10,12,29,65,0.4461538461538462,0
48,85,0.565,17,38,0.447,12,14,0.857,9,41,50,33,7,5,18,16,31,47,0.6595744680851063,1
38,91,0.418,11,32,0.344,17,18,0.944,11,38,49,27,14,6,12,17,27,59,0.4576271186440678,1
33,86,0.384,10,36,0.278,10,16,0.625,12,38,50,23,4,5,20,19,23,50,0.46,0
39,98,0.398,11,38,0.289,26,36,0.722,15,41,56,24,8,4,14,26,28,60,0.4666666666666667,0
48,102,0.471,9,34,0.265,17,28,0.607,14,43,57,29,8,7,13,23,39,68,0.5735294117647058,1
53,105,0.505,13,39,0.333,16,22,0.727,16,46,62,33,6,5,8,21,40,66,0.6060606060606061,1
39,90,0.433,17,48,0.354,20,29,0.69,7,31,38,27,2,2,9,20,22,42,0.5238095238095238,0
49,92,0.533,23,50,0.46,16,22,0.727,10,34,44,36,9,6,10,18,26,42,0.6190476190476191,1
41,85,0.482,14,45,0.311,12,21,0.571,9,29,38,25,6,6,16,18,27,40,0.675,0
42,87,0.483,9,30,0.3,10,16,0.625,7,34,41,23,8,1,14,16,33,57,0.5789473684210527,0
43,83,0.518,12,32,0.375,15,22,0.682,7,40,47,30,13,4,16,15,31,51,0.6078431372549019,1
40,99,0.404,8,31,0.258,7,14,0.5,20,44,64,26,6,7,10,16,32,68,0.47058823529411764,1
30,85,0.353,5,24,0.208,15,19,0.789,8,34,42,14,8,4,9,17,25,61,0.4098360655737705,0
45,84,0.536,12,24,0.5,17,21,0.81,4,34,38,29,5,5,11,17,33,60,0.55,1
39,81,0.481,7,26,0.269,23,26,0.885,6,32,38,21,3,4,8,19,32,55,0.5818181818181818,0
31,83,0.373,8,31,0.258,15,17,0.882,13,34,47,17,5,2,19,26,23,52,0.4423076923076923,0
34,84,0.405,11,32,0.344,19,28,0.679,16,34,50,25,9,5,11,22,23,52,0.4423076923076923,1
37,95,0.389,5,25,0.2,15,16,0.938,15,35,50,21,7,4,12,18,32,70,0.45714285714285713,0
38,88,0.432,16,36,0.444,11,13,0.846,12,36,48,25,8,5,16,25,22,52,0.4230769230769231,1
36,87,0.414,16,41,0.39,16,22,0.727,8,28,36,24,8,9,10,19,20,46,0.43478260869565216,0
49,94,0.521,10,32,0.313,16,21,0.762,11,44,55,37,7,2,11,20,39,62,0.6290322580645161,1
41,77,0.532,12,29,0.414,26,36,0.722,5,28,33,29,12,4,13,23,29,48,0.6041666666666666,1
40,84,0.476,16,45,0.356,11,16,0.688,5,28,33,28,5,7,18,23,24,39,0.6153846153846154,0
48,88,0.545,19,38,0.5,22,27,0.815,7,43,50,28,6,4,10,15,29,50,0.58,1
40,96,0.417,18,46,0.391,15,16,0.938,10,34,44,26,6,2,10,20,22,50,0.44,0
40,95,0.421,12,32,0.375,13,19,0.684,14,33,47,28,6,9,11,22,28,63,0.4444444444444444,0
42,91,0.462,17,36,0.472,17,21,0.81,11,40,51,27,6,7,10,19,25,55,0.45454545454545453,1
45,99,0.455,13,46,0.283,13,14,0.929,16,39,55,29,9,6,16,17,32,53,0.6037735849056604,1
29,81,0.358,5,26,0.192,20,21,0.952,8,32,40,17,8,5,19,16,24,55,0.43636363636363634,0
49,90,0.544,12,32,0.375,17,19,0.895,10,34,44,31,5,5,11,23,37,58,0.6379310344827587,1
43,90,0.478,10,26,0.385,28,31,0.903,11,29,40,18,7,2,9,18,33,64,0.515625,0
41,84,0.488,15,35,0.429,19,29,0.655,14,37,51,21,9,5,18,20,26,49,0.5306122448979592,1
39,95,0.411,9,40,0.225,14,16,0.875,9,29,38,28,11,4,13,19,30,55,0.5454545454545454,0
41,82,0.5,15,43,0.349,13,17,0.765,6,34,40,30,12,3,15,19,26,39,0.6666666666666666,1
37,90,0.411,11,36,0.306,13,17,0.765,18,32,50,21,8,2,18,14,26,54,0.48148148148148145,0
36,95,0.379,8,33,0.242,24,35,0.686,20,36,56,18,8,3,16,23,28,62,0.45161290322580644,0
39,93,0.419,12,48,0.25,23,27,0.852,14,35,49,19,6,6,12,26,27,45,0.6,1
43,76,0.566,18,32,0.563,17,21,0.81,5,32,37,29,9,1,19,23,25,44,0.5681818181818182,1
36,80,0.45,7,31,0.226,21,23,0.913,7,26,33,25,10,0,17,18,29,49,0.5918367346938775,0
37,93,0.398,10,31,0.323,28,33,0.848,18,25,43,22,10,4,13,16,27,62,0.43548387096774194,0
52,90,0.578,17,33,0.515,12,16,0.75,10,33,43,36,8,7,16,26,35,57,0.6140350877192983,1
50,91,0.549,14,40,0.35,12,16,0.75,11,41,52,32,6,8,14,14,36,51,0.7058823529411765,1
38,99,0.384,10,36,0.278,5,13,0.385,15,25,40,22,6,4,14,18,28,63,0.4444444444444444,0
33,87,0.379,5,30,0.167,15,22,0.682,13,32,45,20,5,2,15,24,28,57,0.49122807017543857,0
40,79,0.506,18,36,0.5,18,23,0.783,6,41,47,24,10,5,13,18,22,43,0.5116279069767442,1
45,101,0.446,15,43,0.349,10,12,0.833,14,27,41,25,9,3,9,25,30,58,0.5172413793103449,0
46,85,0.541,16,39,0.41,24,31,0.774,12,40,52,31,5,1,13,18,30,46,0.6521739130434783,1
52,96,0.542,15,36,0.417,12,20,0.6,11,31,42,31,10,4,12,24,37,60,0.6166666666666667,1
44,85,0.518,10,32,0.313,18,30,0.6,12,29,41,28,7,6,16,20,34,53,0.6415094339622641,0
40,89,0.449,11,31,0.355,18,24,0.75,11,29,40,25,8,7,17,17,29,58,0.5,0
53,103,0.515,9,26,0.346,20,25,0.8,21,34,55,26,12,6,13,18,44,77,0.5714285714285714,1
32,86,0.372,13,42,0.31,20,31,0.645,18,29,47,19,8,3,21,23,19,44,0.4318181818181818,0
42,80,0.525,8,32,0.25,18,20,0.9,8,35,43,27,10,10,19,29,34,48,0.7083333333333334,1
43,95,0.453,6,26,0.231,22,24,0.917,11,37,48,27,7,5,8,15,37,69,0.5362318840579711,1
41,89,0.461,10,32,0.313,17,18,0.944,6,38,44,24,7,4,15,22,31,57,0.543859649122807,0
44,90,0.489,19,38,0.5,6,8,0.75,10,40,50,34,8,7,15,18,25,52,0.4807692307692308,1
32,91,0.352,11,38,0.289,20,26,0.769,17,33,50,21,9,5,13,12,21,53,0.39622641509433965,0
50,104,0.481,22,44,0.5,12,17,0.706,16,33,49,34,10,4,14,24,28,60,0.4666666666666667,1
41,83,0.494,9,25,0.36,23,26,0.885,5,33,38,29,4,3,19,20,32,58,0.5517241379310345,0
46,82,0.561,16,33,0.485,13,19,0.684,5,35,40,27,4,5,14,17,30,49,0.6122448979591837,1
40,93,0.43,13,43,0.302,16,23,0.696,11,32,43,26,7,1,9,16,27,50,0.54,0
38,99,0.384,8,33,0.242,8,11,0.727,15,31,46,24,8,4,13,17,30,66,0.45454545454545453,0
39,82,0.476,9,21,0.429,18,24,0.75,10,41,51,18,8,2,15,12,30,61,0.4918032786885246,1
45,88,0.511,13,35,0.371,14,14,1.0,10,35,45,22,9,4,16,16,32,53,0.6037735849056604,1
36,87,0.414,14,47,0.298,12,14,0.857,14,31,45,28,11,4,18,17,22,40,0.55,0
41,74,0.554,17,37,0.459,6,13,0.462,3,35,38,29,7,7,21,15,24,37,0.6486486486486487,0
42,89,0.472,10,32,0.313,13,16,0.813,11,30,41,26,15,3,11,15,32,57,0.5614035087719298,1
44,98,0.449,16,46,0.348,15,18,0.833,6,28,34,28,4,6,10,21,28,52,0.5384615384615384,0
48,93,0.516,12,30,0.4,24,27,0.889,11,40,51,32,4,7,14,19,36,63,0.5714285714285714,1
28,78,0.359,16,43,0.372,13,17,0.765,3,32,35,17,8,3,13,19,12,35,0.34285714285714286,0
41,89,0.461,17,51,0.333,12,17,0.706,11,41,52,26,3,9,12,16,24,38,0.631578947368421,1
39,81,0.481,9,23,0.391,18,25,0.72,4,27,31,24,9,2,10,25,30,58,0.5172413793103449,0
38,78,0.487,13,39,0.333,23,27,0.852,8,33,41,19,4,3,14,23,25,39,0.6410256410256411,1
44,92,0.478,15,30,0.5,29,42,0.69,18,42,60,32,6,4,13,23,29,62,0.46774193548387094,1
41,94,0.436,7,35,0.2,18,21,0.857,10,30,40,27,4,7,10,29,34,59,0.576271186440678,0
39,90,0.433,14,36,0.389,24,33,0.727,16,35,51,24,3,3,15,18,25,54,0.46296296296296297,1
42,91,0.462,15,45,0.333,15,17,0.882,5,33,38,27,4,5,8,24,27,46,0.5869565217391305,0
53,97,0.546,15,39,0.385,18,22,0.818,14,23,37,25,12,3,12,28,38,58,0.6551724137931034,1
43,82,0.524,16,38,0.421,18,30,0.6,13,28,41,25,5,4,21,20,27,44,0.6136363636363636,0
39,81,0.481,10,32,0.313,24,28,0.857,11,32,43,25,12,4,14,19,29,49,0.5918367346938775,1
36,85,0.424,11,41,0.268,14,16,0.875,12,27,39,19,8,6,17,23,25,44,0.5681818181818182,0
40,88,0.455,10,38,0.263,17,25,0.68,11,28,39,18,6,4,14,22,30,50,0.6,0
51,90,0.567,9,30,0.3,20,29,0.69,9,34,43,35,10,2,8,22,42,60,0.7,1
39,84,0.464,10,29,0.345,24,28,0.857,12,30,42,19,6,3,10,21,29,55,0.5272727272727272,0
43,85,0.506,11,31,0.355,16,18,0.889,10,31,41,29,7,5,12,23,32,54,0.5925925925925926,1
50,90,0.556,18,32,0.563,18,21,0.857,5,36,41,37,11,4,14,21,32,58,0.5517241379310345,1
47,103,0.456,14,43,0.326,13,15,0.867,17,32,49,28,10,5,14,18,33,60,0.55,0
39,90,0.433,11,44,0.25,13,18,0.722,12,40,52,23,7,6,21,22,28,46,0.6086956521739131,0
38,96,0.396,10,37,0.27,22,30,0.733,18,36,54,24,13,8,12,20,28,59,0.4745762711864407,1
48,96,0.5,13,40,0.325,13,16,0.813,7,25,32,32,7,4,9,12,35,56,0.625,0
55,87,0.632,14,31,0.452,10,13,0.769,6,37,43,32,6,3,15,15,41,56,0.7321428571428571,1
54,97,0.557,18,42,0.429,15,23,0.652,15,36,51,36,13,2,18,22,36,55,0.6545454545454545,1
48,102,0.471,12,35,0.343,11,18,0.611,16,29,45,32,10,6,18,20,36,67,0.5373134328358209,0
43,81,0.531,9,24,0.375,25,30,0.833,6,26,32,20,12,7,13,16,34,57,0.5964912280701754,1
42,89,0.472,18,38,0.474,11,16,0.688,9,29,38,25,9,4,23,25,24,51,0.47058823529411764,0
35,90,0.389,6,35,0.171,11,12,0.917,11,41,52,21,6,8,16,21,29,55,0.5272727272727272,0
36,93,0.387,7,26,0.269,21,26,0.808,15,40,55,19,7,10,11,16,29,67,0.43283582089552236,1
37,84,0.44,13,35,0.371,12,16,0.75,9,31,40,23,12,5,18,15,24,49,0.4897959183673469,0
40,89,0.449,13,41,0.317,21,24,0.875,11,39,50,22,15,5,16,14,27,48,0.5625,1
34,88,0.386,11,36,0.306,22,30,0.733,7,36,43,22,8,10,8,15,23,52,0.4423076923076923,0
40,89,0.449,7,25,0.28,19,23,0.826,11,46,57,20,6,3,13,19,33,64,0.515625,1
47,96,0.49,11,33,0.333,20,33,0.606,16,41,57,31,11,8,17,26,36,63,0.5714285714285714,1
39,97,0.402,14,45,0.311,26,33,0.788,18,35,53,28,7,6,17,29,25,52,0.4807692307692308,0
43,82,0.524,7,22,0.318,6,11,0.545,6,36,42,23,7,4,14,20,36,60,0.6,1
35,85,0.412,15,39,0.385,12,19,0.632,13,31,44,16,4,0,14,17,20,46,0.43478260869565216,0
41,88,0.466,11,27,0.407,22,33,0.667,12,36,48,25,5,6,9,24,30,61,0.4918032786885246,0
40,90,0.444,12,38,0.316,25,34,0.735,10,40,50,24,4,3,9,24,28,52,0.5384615384615384,1
42,93,0.452,12,40,0.3,15,22,0.682,9,32,41,16,12,2,8,27,30,53,0.5660377358490566,0
41,82,0.5,10,29,0.345,23,29,0.793,10,42,52,20,6,1,15,21,31,53,0.5849056603773585,1
47,93,0.505,14,37,0.378,16,19,0.842,7,27,34,26,9,5,5,19,33,56,0.5892857142857143,1
43,87,0.494,11,32,0.344,17,20,0.85,10,36,46,22,2,4,15,19,32,55,0.5818181818181818,0
36,77,0.468,8,24,0.333,13,15,0.867,5,29,34,21,3,3,17,16,28,53,0.5283018867924528,0
38,79,0.481,10,22,0.455,17,21,0.81,8,32,40,24,13,5,13,21,28,57,0.49122807017543857,1
37,87,0.425,15,41,0.366,16,24,0.667,4,40,44,25,2,2,15,9,22,46,0.4782608695652174,0
55,105,0.524,15,34,0.441,7,10,0.7,7,45,52,40,8,2,7,19,40,71,0.5633802816901409,1
31,81,0.383,12,39,0.308,29,34,0.853,9,32,41,19,6,6,13,24,19,42,0.4523809523809524,0
40,84,0.476,15,40,0.375,17,20,0.85,9,42,51,29,3,2,17,26,25,44,0.5681818181818182,1
39,84,0.464,14,37,0.378,18,21,0.857,12,38,50,28,5,3,18,16,25,47,0.5319148936170213,1
43,88,0.489,12,34,0.353,11,17,0.647,8,27,35,22,11,1,7,19,31,54,0.5740740740740741,0
43,76,0.566,12,28,0.429,25,29,0.862,6,36,42,27,4,2,14,20,31,48,0.6458333333333334,1
41,88,0.466,13,38,0.342,15,21,0.714,10,22,32,26,11,3,10,19,28,50,0.56,0
34,93,0.366,12,38,0.316,15,15,1.0,11,37,48,18,6,3,13,22,22,55,0.4,0
36,85,0.424,11,38,0.289,22,27,0.815,12,42,54,21,5,6,12,15,25,47,0.5319148936170213,1
43,84,0.512,18,34,0.529,25,28,0.893,8,30,38,23,8,8,14,25,25,50,0.5,1
45,102,0.441,13,45,0.289,17,22,0.773,22,32,54,28,5,6,13,21,32,57,0.5614035087719298,0
31,90,0.344,9,35,0.257,14,18,0.778,11,32,43,12,8,4,18,17,22,55,0.4,0
43,84,0.512,9,26,0.346,14,15,0.933,6,43,49,25,7,5,18,22,34,58,0.5862068965517241,1
44,92,0.478,6,20,0.3,15,21,0.714,4,29,33,28,9,2,7,15,38,72,0.5277777777777778,0
46,88,0.523,10,24,0.417,18,21,0.857,10,43,53,25,3,3,16,19,36,64,0.5625,1
40,91,0.44,11,39,0.282,20,23,0.87,11,31,42,24,16,5,15,19,29,52,0.5576923076923077,0
42,88,0.477,16,40,0.4,21,23,0.913,12,40,52,25,7,2,23,18,26,48,0.5416666666666666,1
39,86,0.453,16,41,0.39,10,13,0.769,7,31,38,23,7,3,14,18,23,45,0.5111111111111111,0
48,85,0.565,15,34,0.441,8,15,0.533,6,37,43,25,6,3,12,18,33,51,0.6470588235294118,1
45,99,0.455,18,43,0.419,14,19,0.737,14,44,58,30,8,6,14,19,27,56,0.48214285714285715,1
38,89,0.427,13,41,0.317,18,24,0.75,6,37,43,18,8,3,13,18,25,48,0.5208333333333334,0
29,95,0.305,8,34,0.235,24,31,0.774,19,25,44,8,7,3,8,14,21,61,0.3442622950819672,0
45,77,0.584,16,35,0.457,14,16,0.875,4,43,47,36,4,7,14,24,29,42,0.6904761904761905,1
48,96,0.5,13,34,0.382,18,27,0.667,8,38,46,28,9,1,11,19,35,62,0.5645161290322581,1
45,108,0.417,15,50,0.3,18,22,0.818,19,37,56,28,8,12,14,25,30,58,0.5172413793103449,0
35,83,0.422,12,37,0.324,19,28,0.679,10,23,33,23,5,4,12,20,23,46,0.5,0
49,89,0.551,18,40,0.45,19,22,0.864,13,40,53,34,6,5,13,22,31,49,0.6326530612244898,1
32,85,0.376,8,23,0.348,22,27,0.815,13,31,44,19,7,3,12,19,24,62,0.3870967741935484,0
40,85,0.471,9,29,0.31,14,18,0.778,10,35,45,21,8,3,15,16,31,56,0.5535714285714286,1
45,88,0.511,16,41,0.39,10,12,0.833,14,25,39,30,8,3,13,23,29,47,0.6170212765957447,0
43,80,0.538,14,33,0.424,24,27,0.889,7,28,35,25,9,4,11,18,29,47,0.6170212765957447,1
34,76,0.447,18,41,0.439,21,33,0.636,12,26,38,27,5,7,9,26,16,35,0.45714285714285713,1
35,84,0.417,7,27,0.259,22,27,0.815,15,33,48,19,1,2,12,23,28,57,0.49122807017543857,0
47,93,0.505,17,41,0.415,8,19,0.421,10,31,41,32,8,2,12,23,30,52,0.5769230769230769,0
48,86,0.558,10,29,0.345,22,30,0.733,9,38,47,28,7,0,15,17,38,57,0.6666666666666666,1
42,102,0.412,8,33,0.242,28,37,0.757,16,46,62,31,9,7,14,30,34,69,0.4927536231884058,0
43,109,0.394,13,55,0.236,27,43,0.628,17,41,58,29,10,8,14,26,30,54,0.5555555555555556,1
47,94,0.5,10,34,0.294,17,27,0.63,18,31,49,29,10,3,13,24,37,60,0.6166666666666667,1
44,88,0.5,4,26,0.154,17,20,0.85,11,23,34,20,7,5,15,23,40,62,0.6451612903225806,0
46,82,0.561,25,45,0.556,18,22,0.818,7,44,51,28,2,10,11,25,21,37,0.5675675675675675,1
23,80,0.288,8,32,0.25,33,39,0.846,12,28,40,17,7,2,9,17,15,48,0.3125,0
40,97,0.412,10,35,0.286,6,9,0.667,13,33,46,26,11,9,14,12,30,62,0.4838709677419355,0
44,90,0.489,8,25,0.32,7,10,0.7,12,40,52,30,9,4,17,12,36,65,0.5538461538461539,1
43,93,0.462,16,30,0.533,10,13,0.769,18,29,47,28,9,1,17,17,27,63,0.42857142857142855,1
42,77,0.545,13,32,0.406,14,18,0.778,2,28,30,29,8,6,17,14,29,45,0.6444444444444445,0
43,84,0.512,12,30,0.4,20,22,0.909,7,29,36,24,9,3,13,14,31,54,0.5740740740740741,0
47,94,0.5,12,29,0.414,19,20,0.95,13,34,47,25,8,2,13,16,35,65,0.5384615384615384,1
43,91,0.473,14,36,0.389,17,21,0.81,12,36,48,27,5,1,19,18,29,55,0.5272727272727272,1
45,87,0.517,10,34,0.294,16,24,0.667,8,29,37,26,13,5,11,21,35,53,0.660377358490566,0
39,91,0.429,17,37,0.459,13,16,0.813,12,32,44,25,7,3,13,20,22,54,0.4074074074074074,0
45,83,0.542,4,20,0.2,19,29,0.655,7,33,40,30,9,6,11,14,41,63,0.6507936507936508,1
37,79,0.468,11,33,0.333,16,19,0.842,8,33,41,17,11,6,13,22,26,46,0.5652173913043478,0
41,86,0.477,10,36,0.278,14,22,0.636,12,32,44,24,9,7,12,18,31,50,0.62,1
43,85,0.506,13,32,0.406,24,32,0.75,13,30,43,23,6,5,12,27,30,53,0.5660377358490566,1
37,85,0.435,11,30,0.367,34,42,0.81,10,29,39,20,10,7,10,26,26,55,0.4727272727272727,0
40,88,0.455,8,25,0.32,15,19,0.789,9,39,48,21,7,6,13,21,32,63,0.5079365079365079,1
30,77,0.39,10,42,0.238,21,29,0.724,6,36,42,23,6,7,17,18,20,35,0.5714285714285714,0
43,98,0.439,11,34,0.324,14,23,0.609,16,35,51,21,5,1,9,16,32,64,0.5,1
37,85,0.435,16,43,0.372,16,18,0.889,10,34,44,22,7,9,10,17,21,42,0.5,0
43,98,0.439,10,34,0.294,18,22,0.818,14,43,57,29,3,7,14,15,33,64,0.515625,1
41,105,0.39,11,32,0.344,13,19,0.684,15,35,50,25,6,6,8,19,30,73,0.410958904109589,0
45,90,0.5,18,33,0.545,22,28,0.786,13,34,47,23,7,6,11,20,27,57,0.47368421052631576,1
42,98,0.429,13,41,0.317,12,13,0.923,12,33,45,23,3,5,13,19,29,57,0.5087719298245614,0
42,97,0.433,13,44,0.295,24,28,0.857,13,36,49,23,5,5,16,27,29,53,0.5471698113207547,0
44,86,0.512,7,24,0.292,29,36,0.806,7,35,42,27,10,7,11,20,37,62,0.5967741935483871,1
46,83,0.554,12,24,0.5,13,16,0.813,8,30,38,26,10,7,16,21,34,59,0.576271186440678,1
36,89,0.404,14,38,0.368,17,24,0.708,15,27,42,19,6,5,16,20,22,51,0.43137254901960786,0
41,102,0.402,14,48,0.292,15,23,0.652,15,41,56,31,4,5,15,23,27,54,0.5,1
38,95,0.4,10,42,0.238,21,30,0.7,17,41,58,27,6,4,18,28,28,53,0.5283018867924528,0
42,91,0.462,13,37,0.351,14,19,0.737,12,23,35,29,8,2,19,20,29,54,0.5370370370370371,0
51,92,0.554,18,35,0.514,22,26,0.846,12,38,50,34,12,5,18,16,33,57,0.5789473684210527,1
44,88,0.5,12,34,0.353,23,27,0.852,9,37,46,21,2,2,12,23,32,54,0.5925925925925926,1
42,95,0.442,14,44,0.318,22,28,0.786,12,32,44,20,5,1,7,22,28,51,0.5490196078431373,0
44,82,0.537,19,40,0.475,18,25,0.72,7,31,38,18,5,4,9,22,25,42,0.5952380952380952,1
46,92,0.5,12,28,0.429,14,21,0.667,17,31,48,22,7,0,13,18,34,64,0.53125,0
46,85,0.541,17,42,0.405,20,27,0.741,8,40,48,28,9,3,14,20,29,43,0.6744186046511628,1
39,94,0.415,7,29,0.241,21,28,0.75,8,30,38,25,8,4,11,16,32,65,0.49230769230769234,0
41,97,0.423,8,28,0.286,18,27,0.667,13,32,45,20,2,3,10,18,33,69,0.4782608695652174,0
41,84,0.488,8,27,0.296,22,27,0.815,6,37,43,16,5,8,9,20,33,57,0.5789473684210527,1
34,77,0.442,12,35,0.343,23,34,0.676,8,35,43,20,3,7,12,21,22,42,0.5238095238095238,0
35,86,0.407,11,34,0.324,25,28,0.893,13,36,49,23,8,8,11,24,24,52,0.46153846153846156,1
38,98,0.388,9,31,0.29,29,40,0.725,26,33,59,25,9,7,16,21,29,67,0.43283582089552236,0
43,93,0.462,16,42,0.381,17,25,0.68,12,30,42,26,6,11,12,27,27,51,0.5294117647058824,1
46,86,0.535,13,34,0.382,19,21,0.905,3,40,43,32,14,6,16,12,33,52,0.6346153846153846,1
44,93,0.473,6,31,0.194,10,11,0.909,7,35,42,22,10,4,16,19,38,62,0.6129032258064516,0
45,88,0.511,15,41,0.366,27,32,0.844,10,36,46,36,10,7,12,23,30,47,0.6382978723404256,1
31,79,0.392,9,35,0.257,24,29,0.828,6,25,31,16,5,4,18,29,22,44,0.5,0
48,86,0.558,15,35,0.429,17,20,0.85,3,36,39,30,12,4,17,24,33,51,0.6470588235294118,1
43,86,0.5,9,29,0.31,15,18,0.833,6,28,34,25,5,8,15,17,34,57,0.5964912280701754,0
37,84,0.44,6,23,0.261,13,23,0.565,10,26,36,18,6,4,17,12,31,61,0.5081967213114754,0
52,94,0.553,15,40,0.375,6,9,0.667,13,39,52,34,10,7,18,20,37,54,0.6851851851851852,1
50,101,0.495,11,31,0.355,18,24,0.75,11,43,54,23,8,3,11,19,39,70,0.5571428571428572,1
49,101,0.485,14,37,0.378,13,22,0.591,12,39,51,31,8,11,14,19,35,64,0.546875,0
41,83,0.494,10,26,0.385,13,19,0.684,7,40,47,25,8,8,17,19,31,57,0.543859649122807,1
39,93,0.419,8,31,0.258,16,21,0.762,13,34,47,18,8,7,12,17,31,62,0.5,0
42,82,0.512,19,39,0.487,30,36,0.833,6,36,42,30,10,0,12,23,23,43,0.5348837209302325,1
36,86,0.419,9,39,0.231,21,25,0.84,9,32,41,23,4,1,16,27,27,47,0.574468085106383,0
39,83,0.47,11,32,0.344,26,35,0.743,4,40,44,22,13,5,10,28,28,51,0.5490196078431373,1
30,75,0.4,14,40,0.35,26,36,0.722,5,40,45,19,4,1,18,30,16,35,0.45714285714285713,0
44,94,0.468,14,47,0.298,9,20,0.45,10,31,41,22,12,3,13,24,30,47,0.6382978723404256,0
42,83,0.506,13,36,0.361,22,29,0.759,10,44,54,20,7,4,19,22,29,47,0.6170212765957447,1
38,87,0.437,8,29,0.276,33,41,0.805,16,37,53,21,10,4,11,18,30,58,0.5172413793103449,1
36,82,0.439,12,40,0.3,18,24,0.75,7,30,37,23,6,8,14,27,24,42,0.5714285714285714,0
42,88,0.477,17,39,0.436,8,8,1.0,8,22,30,22,9,3,12,21,25,49,0.5102040816326531,0
40,74,0.541,16,38,0.421,18,22,0.818,9,35,44,22,9,4,18,14,24,36,0.6666666666666666,1
57,105,0.543,9,29,0.31,34,43,0.791,16,34,50,35,6,3,17,22,48,76,0.631578947368421,1
59,108,0.546,16,38,0.421,19,24,0.792,11,28,39,36,10,5,16,29,43,70,0.6142857142857143,0
38,95,0.4,10,32,0.313,14,19,0.737,11,31,42,25,5,2,13,26,28,63,0.4444444444444444,0
48,83,0.578,13,31,0.419,18,22,0.818,5,40,45,27,8,8,12,19,35,52,0.6730769230769231,1
44,100,0.44,7,23,0.304,21,26,0.808,19,42,61,23,5,10,14,24,37,77,0.4805194805194805,1
39,93,0.419,9,20,0.45,23,30,0.767,6,35,41,17,9,3,10,17,30,73,0.410958904109589,0
35,81,0.432,11,23,0.478,5,6,0.833,7,35,42,19,8,7,18,24,24,58,0.41379310344827586,0
32,83,0.386,8,25,0.32,20,24,0.833,13,36,49,22,9,5,14,10,24,58,0.41379310344827586,1
38,89,0.427,9,30,0.3,25,33,0.758,9,36,45,24,4,3,13,25,29,59,0.4915254237288136,0
38,82,0.463,16,43,0.372,23,29,0.793,4,41,45,29,5,2,15,25,22,39,0.5641025641025641,1
42,88,0.477,10,26,0.385,19,21,0.905,10,27,37,31,5,6,10,21,32,62,0.5161290322580645,1
39,87,0.448,7,27,0.259,19,22,0.864,10,31,41,18,4,4,14,22,32,60,0.5333333333333333,0
50,90,0.556,14,31,0.452,15,19,0.789,12,34,46,33,5,1,22,31,36,59,0.6101694915254238,0
47,83,0.566,12,28,0.429,27,38,0.711,4,28,32,25,8,3,12,20,35,55,0.6363636363636364,1
44,92,0.478,13,34,0.382,25,33,0.758,12,28,40,24,7,5,9,24,31,58,0.5344827586206896,1
41,78,0.526,16,38,0.421,25,38,0.658,4,39,43,24,4,0,15,26,25,40,0.625,0
50,110,0.455,14,40,0.35,13,18,0.722,22,32,54,30,10,3,15,29,36,70,0.5142857142857142,1
45,89,0.506,13,31,0.419,23,34,0.676,12,34,46,25,8,8,17,19,32,58,0.5517241379310345,0
39,78,0.5,13,34,0.382,16,20,0.8,6,39,45,16,5,7,18,18,26,44,0.5909090909090909,1
39,91,0.429,11,39,0.282,12,20,0.6,12,32,44,27,15,2,11,23,28,52,0.5384615384615384,0
34,77,0.442,11,34,0.324,20,28,0.714,10,49,59,18,4,12,18,22,23,43,0.5348837209302325,1
35,92,0.38,17,42,0.405,11,18,0.611,6,31,37,26,8,0,7,21,18,50,0.36,0
39,91,0.429,12,43,0.279,17,20,0.85,12,28,40,25,5,9,10,13,27,48,0.5625,0
47,90,0.522,17,33,0.515,17,20,0.85,10,39,49,25,7,5,14,23,30,57,0.5263157894736842,1
47,92,0.511,13,30,0.433,16,25,0.64,12,39,51,29,16,3,15,19,34,62,0.5483870967741935,1
35,84,0.417,7,34,0.206,18,20,0.9,7,31,38,15,8,7,23,18,28,50,0.56,0
38,78,0.487,10,33,0.303,39,44,0.886,5,38,43,28,13,5,10,26,28,45,0.6222222222222222,1
38,85,0.447,11,33,0.333,22,35,0.629,12,35,47,21,6,2,18,24,27,52,0.5192307692307693,0
44,94,0.468,17,40,0.425,13,20,0.65,14,27,41,23,7,6,10,16,27,54,0.5,1
44,86,0.512,13,28,0.464,13,16,0.813,10,26,36,24,7,5,9,19,31,58,0.5344827586206896,0
44,86,0.512,12,37,0.324,24,31,0.774,8,47,55,28,9,5,15,20,32,49,0.6530612244897959,1
34,91,0.374,6,36,0.167,18,26,0.692,11,31,42,22,12,3,15,25,28,55,0.509090909090909,0
51,99,0.515,18,38,0.474,13,22,0.591,16,31,47,35,17,5,13,20,33,61,0.5409836065573771,1
33,86,0.384,12,35,0.343,19,24,0.792,14,31,45,23,4,5,23,20,21,51,0.4117647058823529,0
47,86,0.547,18,42,0.429,15,19,0.789,8,23,31,30,12,6,13,31,29,44,0.6590909090909091,1
39,74,0.527,15,37,0.405,29,34,0.853,10,28,38,29,5,3,22,17,24,37,0.6486486486486487,0
41,99,0.414,9,32,0.281,14,19,0.737,12,26,38,30,13,3,9,18,32,67,0.47761194029850745,0
48,89,0.539,11,26,0.423,11,19,0.579,13,42,55,24,5,6,18,18,37,63,0.5873015873015873,1
41,84,0.488,7,29,0.241,10,15,0.667,5,33,38,23,9,4,16,24,34,55,0.6181818181818182,0
40,81,0.494,12,31,0.387,20,26,0.769,9,30,39,28,8,5,14,18,28,50,0.56,1
36,93,0.387,14,39,0.359,20,32,0.625,9,31,40,22,6,1,9,27,22,54,0.4074074074074074,0
40,91,0.44,18,45,0.4,32,37,0.865,17,45,62,25,4,5,13,28,22,46,0.4782608695652174,1
49,87,0.563,10,31,0.323,23,30,0.767,11,35,46,30,10,6,17,25,39,56,0.6964285714285714,1
40,86,0.465,11,35,0.314,19,27,0.704,7,31,38,28,12,5,17,26,29,51,0.5686274509803921,0
35,72,0.486,15,36,0.417,18,25,0.72,4,35,39,22,4,6,22,18,20,36,0.5555555555555556,0
45,96,0.469,12,37,0.324,17,22,0.773,10,29,39,29,10,2,11,19,33,59,0.559322033898305,1
36,83,0.434,7,31,0.226,19,24,0.792,5,32,37,15,8,4,10,20,29,52,0.5576923076923077,0
39,83,0.47,11,35,0.314,18,19,0.947,11,36,47,27,4,8,14,20,28,48,0.5833333333333334,1
42,96,0.438,13,31,0.419,16,17,0.941,17,38,55,24,7,8,16,19,29,65,0.4461538461538462,1
38,96,0.396,13,39,0.333,11,17,0.647,14,31,45,21,8,6,14,18,25,57,0.43859649122807015,0
41,82,0.5,10,35,0.286,17,27,0.63,10,35,45,24,8,7,14,19,31,47,0.6595744680851063,1
37,82,0.451,14,34,0.412,16,20,0.8,4,33,37,22,8,6,12,20,23,48,0.4791666666666667,0
41,90,0.456,13,45,0.289,19,22,0.864,8,32,40,26,11,3,17,25,28,45,0.6222222222222222,0
47,89,0.528,16,40,0.4,19,23,0.826,6,36,42,27,10,2,16,20,31,49,0.6326530612244898,1
42,84,0.5,10,25,0.4,14,19,0.737,7,30,37,21,3,5,12,21,32,59,0.5423728813559322,0
41,90,0.456,7,23,0.304,20,23,0.87,16,32,48,27,5,2,13,19,34,67,0.5074626865671642,1
43,90,0.478,8,27,0.296,19,23,0.826,14,29,43,23,9,3,12,21,35,63,0.5555555555555556,0
41,82,0.5,13,26,0.5,21,26,0.808,12,30,42,29,6,8,15,22,28,56,0.5,1
43,85,0.506,17,38,0.447,16,22,0.727,9,36,45,32,10,5,12,21,26,47,0.5531914893617021,1
37,79,0.468,10,31,0.323,14,21,0.667,4,33,37,21,6,1,14,18,27,48,0.5625,0
44,87,0.506,16,29,0.552,15,21,0.714,9,41,50,24,11,6,15,15,28,58,0.4827586206896552,1
40,90,0.444,12,46,0.261,15,17,0.882,10,37,47,25,11,2,16,19,28,44,0.6363636363636364,0
50,91,0.549,15,42,0.357,17,24,0.708,11,38,49,32,12,2,19,24,35,49,0.7142857142857143,1
43,86,0.5,21,51,0.412,20,30,0.667,5,29,34,27,12,3,17,25,22,35,0.6285714285714286,0
44,97,0.454,21,44,0.477,10,12,0.833,9,39,48,28,9,4,12,22,23,53,0.4339622641509434,0
41,91,0.451,14,36,0.389,24,27,0.889,11,41,52,22,7,3,12,16,27,55,0.4909090909090909,1
35,89,0.393,8,35,0.229,17,25,0.68,12,26,38,20,9,4,11,19,27,54,0.5,0
52,88,0.591,11,29,0.379,10,12,0.833,7,43,50,30,5,5,16,23,41,59,0.6949152542372882,1
41,94,0.436,12,37,0.324,28,35,0.8,14,40,54,23,12,7,18,19,29,57,0.5087719298245614,1
44,97,0.454,10,32,0.313,16,20,0.8,12,40,52,22,12,5,20,28,34,65,0.5230769230769231,0
39,91,0.429,8,28,0.286,22,32,0.688,10,30,40,20,9,3,10,25,31,63,0.49206349206349204,0
39,75,0.52,17,36,0.472,28,33,0.848,5,38,43,24,2,8,14,25,22,39,0.5641025641025641,1
30,78,0.385,11,31,0.355,19,25,0.76,5,30,35,22,10,2,19,23,19,47,0.40425531914893614,0
40,80,0.5,14,36,0.389,26,31,0.839,7,39,46,32,14,6,16,21,26,44,0.5909090909090909,1
52,88,0.591,14,26,0.538,6,7,0.857,5,27,32,30,5,2,14,19,38,62,0.6129032258064516,0
44,84,0.524,18,40,0.45,24,28,0.857,8,25,33,26,7,3,6,15,26,44,0.5909090909090909,1
42,99,0.424,13,40,0.325,10,13,0.769,17,27,44,24,10,4,7,16,29,59,0.4915254237288136,0
46,89,0.517,16,37,0.432,12,15,0.8,15,36,51,33,4,7,14,15,30,52,0.5769230769230769,1
40,77,0.519,10,30,0.333,23,28,0.821,5,30,35,27,8,6,15,22,30,47,0.6382978723404256,1
39,83,0.47,12,31,0.387,17,22,0.773,7,23,30,24,5,5,13,24,27,52,0.5192307692307693,0
44,81,0.543,15,30,0.5,10,13,0.769,10,27,37,26,7,5,15,19,29,51,0.5686274509803921,0
45,85,0.529,17,37,0.459,15,20,0.75,8,24,32,29,7,1,10,16,28,48,0.5833333333333334,1
41,84,0.488,12,35,0.343,17,22,0.773,9,27,36,26,8,4,14,17,29,49,0.5918367346938775,0
51,93,0.548,17,27,0.63,13,15,0.867,13,33,46,32,10,3,12,22,34,66,0.5151515151515151,1
39,85,0.459,10,32,0.313,27,32,0.844,9,40,49,26,6,2,14,13,29,53,0.5471698113207547,1
46,93,0.495,12,32,0.375,8,16,0.5,6,34,40,28,8,5,11,24,34,61,0.5573770491803278,0
38,84,0.452,11,37,0.297,21,28,0.75,11,31,42,25,4,5,10,29,27,47,0.574468085106383,1
36,83,0.434,7,26,0.269,27,36,0.75,14,27,41,12,5,4,10,22,29,57,0.5087719298245614,0
43,88,0.489,10,31,0.323,22,33,0.667,12,38,50,20,5,5,14,18,33,57,0.5789473684210527,1
47,94,0.5,10,26,0.385,8,11,0.727,5,35,40,25,5,2,12,23,37,68,0.5441176470588235,0
38,83,0.458,10,36,0.278,15,22,0.682,9,35,44,25,4,3,15,21,28,47,0.5957446808510638,0
39,86,0.453,13,33,0.394,25,31,0.806,10,31,41,27,10,4,10,21,26,53,0.49056603773584906,1
39,100,0.39,10,40,0.25,18,28,0.643,21,34,55,24,4,9,14,16,29,60,0.48333333333333334,0
42,94,0.447,15,30,0.5,12,18,0.667,19,33,52,28,5,9,13,22,27,64,0.421875,1
31,89,0.348,11,41,0.268,17,26,0.654,22,30,52,15,7,2,21,14,20,48,0.4166666666666667,0
50,97,0.515,11,36,0.306,13,17,0.765,15,37,52,29,11,5,11,23,39,61,0.639344262295082,1
49,91,0.538,22,47,0.468,18,23,0.783,7,34,41,35,17,7,18,17,27,44,0.6136363636363636,1
37,86,0.43,9,35,0.257,18,21,0.857,8,31,39,19,12,4,23,16,28,51,0.5490196078431373,0
44,82,0.537,10,28,0.357,21,24,0.875,10,31,41,30,5,4,12,22,34,54,0.6296296296296297,0
41,75,0.547,14,33,0.424,29,32,0.906,3,27,30,23,8,3,12,24,27,42,0.6428571428571429,1
40,86,0.465,13,29,0.448,21,30,0.7,12,37,49,23,7,5,14,22,27,57,0.47368421052631576,0
38,85,0.447,17,34,0.5,22,27,0.815,3,30,33,28,7,3,10,22,21,51,0.4117647058823529,1
36,95,0.379,11,37,0.297,20,21,0.952,12,43,55,24,5,4,11,18,25,58,0.43103448275862066,1
37,93,0.398,12,37,0.324,11,17,0.647,12,42,54,22,2,8,12,18,25,56,0.44642857142857145,0
38,91,0.418,13,36,0.361,28,34,0.824,13,26,39,18,6,5,4,16,25,55,0.45454545454545453,1
46,85,0.541,14,29,0.483,8,9,0.889,7,34,41,37,2,7,14,29,32,56,0.5714285714285714,0
45,98,0.459,11,37,0.297,16,20,0.8,13,38,51,28,7,6,10,18,34,61,0.5573770491803278,0
42,91,0.462,16,42,0.381,23,29,0.793,11,39,50,29,8,5,9,16,26,49,0.5306122448979592,1
46,94,0.489,9,25,0.36,12,18,0.667,10,35,45,24,5,1,16,28,37,69,0.5362318840579711,0
40,84,0.476,14,36,0.389,20,27,0.741,10,29,39,22,7,2,10,22,26,48,0.5416666666666666,1
46,92,0.5,15,34,0.441,9,19,0.474,10,31,41,22,11,4,16,20,31,58,0.5344827586206896,0
44,89,0.494,18,41,0.439,18,21,0.857,12,35,47,25,10,6,20,18,26,48,0.5416666666666666,1
37,86,0.43,11,35,0.314,11,16,0.688,1,40,41,25,7,5,12,20,26,51,0.5098039215686274,0
46,92,0.5,14,34,0.412,18,27,0.667,6,49,55,25,7,4,8,14,32,58,0.5517241379310345,1
28,82,0.341,7,41,0.171,19,23,0.826,13,28,41,13,9,4,12,17,21,41,0.5121951219512195,0
35,72,0.486,13,28,0.464,16,19,0.842,6,32,38,20,6,3,14,19,22,44,0.5,1
40,85,0.471,16,38,0.421,25,30,0.833,11,30,41,24,5,1,16,23,24,47,0.5106382978723404,0
48,85,0.565,15,37,0.405,24,29,0.828,9,33,42,36,10,7,11,21,33,48,0.6875,1
45,89,0.506,12,27,0.444,18,20,0.9,12,33,45,24,6,4,16,26,33,62,0.532258064516129,0
40,83,0.482,17,36,0.472,29,38,0.763,10,27,37,25,9,7,10,19,23,47,0.48936170212765956,1
37,94,0.394,6,24,0.25,16,26,0.615,14,31,45,17,13,3,7,20,31,70,0.44285714285714284,0
39,85,0.459,11,36,0.306,15,23,0.652,15,43,58,24,5,7,19,22,28,49,0.5714285714285714,1
48,101,0.475,14,33,0.424,20,29,0.69,14,35,49,30,9,4,14,30,34,68,0.5,0
47,87,0.54,10,33,0.303,34,43,0.791,10,37,47,32,7,8,15,26,37,54,0.6851851851851852,1
44,97,0.454,5,26,0.192,19,27,0.704,12,28,40,27,12,8,11,27,39,71,0.5492957746478874,0
43,82,0.524,13,34,0.382,24,36,0.667,8,37,45,23,4,5,17,22,30,48,0.625,1
42,89,0.472,13,29,0.448,19,30,0.633,15,42,57,19,4,5,10,18,29,60,0.48333333333333334,1
33,88,0.375,11,34,0.324,16,22,0.727,9,34,43,17,2,5,10,23,22,54,0.4074074074074074,0
50,93,0.538,14,31,0.452,8,11,0.727,6,21,27,33,8,4,11,20,36,62,0.5806451612903226,0
47,87,0.54,15,32,0.469,23,29,0.793,14,34,48,31,9,6,15,19,32,55,0.5818181818181818,1
40,89,0.449,23,52,0.442,13,17,0.765,11,37,48,27,4,4,11,21,17,37,0.4594594594594595,1
39,92,0.424,8,40,0.2,17,19,0.895,11,36,47,20,11,9,8,19,31,52,0.5961538461538461,0
44,85,0.518,10,31,0.323,25,29,0.862,7,35,42,28,3,5,10,22,34,54,0.6296296296296297,0
45,86,0.523,17,42,0.405,26,32,0.813,5,31,36,33,6,4,6,16,28,44,0.6363636363636364,1
36,83,0.434,12,31,0.387,19,24,0.792,12,33,45,22,5,6,14,20,24,52,0.46153846153846156,0
39,88,0.443,17,46,0.37,16,20,0.8,9,34,43,19,9,5,9,21,22,42,0.5238095238095238,1
45,88,0.511,17,40,0.425,17,23,0.739,9,32,41,29,5,0,14,30,28,48,0.5833333333333334,0
46,84,0.548,10,32,0.313,29,41,0.707,7,34,41,39,8,5,9,25,36,52,0.6923076923076923,1
42,93,0.452,11,38,0.289,15,22,0.682,13,35,48,28,3,6,14,25,31,55,0.5636363636363636,0
43,93,0.462,12,33,0.364,15,23,0.652,15,32,47,27,7,2,14,27,31,60,0.5166666666666667,1
39,88,0.443,13,43,0.302,15,22,0.682,9,24,33,22,8,7,11,24,26,45,0.5777777777777777,0
49,91,0.538,14,31,0.452,11,14,0.786,13,37,50,26,3,4,15,17,35,60,0.5833333333333334,1
23,83,0.277,7,28,0.25,28,38,0.737,8,34,42,11,10,5,18,30,16,55,0.2909090909090909,0
38,92,0.413,13,43,0.302,35,44,0.795,19,48,67,21,10,9,22,25,25,49,0.5102040816326531,1
39,87,0.448,8,24,0.333,20,26,0.769,14,34,48,22,5,4,13,24,31,63,0.49206349206349204,0
41,84,0.488,12,30,0.4,27,34,0.794,8,30,38,29,5,5,10,19,29,54,0.5370370370370371,1
47,92,0.511,18,42,0.429,19,23,0.826,9,38,47,19,7,6,9,31,29,50,0.58,1
39,80,0.488,11,32,0.344,26,36,0.722,4,36,40,23,4,2,12,16,28,48,0.5833333333333334,0
43,91,0.473,8,26,0.308,16,23,0.696,12,31,43,19,7,3,15,26,35,65,0.5384615384615384,0
46,84,0.548,9,26,0.346,16,30,0.533,12,35,47,28,6,7,18,18,37,58,0.6379310344827587,1
46,82,0.561,18,35,0.514,22,29,0.759,6,32,38,33,8,4,16,20,28,47,0.5957446808510638,1
45,92,0.489,13,41,0.317,18,22,0.818,10,31,41,26,12,3,15,24,32,51,0.6274509803921569,0
33,93,0.355,12,39,0.308,19,23,0.826,12,35,47,23,12,3,13,12,21,54,0.3888888888888889,0
44,92,0.478,13,34,0.382,11,13,0.846,10,41,51,33,8,6,16,20,31,58,0.5344827586206896,1
47,94,0.5,9,32,0.281,24,27,0.889,14,26,40,25,13,6,8,16,38,62,0.6129032258064516,1
49,91,0.538,16,32,0.5,10,15,0.667,11,27,38,35,6,7,18,20,33,59,0.559322033898305,0
41,88,0.466,11,34,0.324,18,27,0.667,12,33,45,24,9,3,15,18,30,54,0.5555555555555556,0
48,101,0.475,16,44,0.364,20,24,0.833,15,37,52,30,8,6,12,20,32,57,0.5614035087719298,1
53,100,0.53,20,40,0.5,16,20,0.8,16,37,53,35,10,4,13,18,33,60,0.55,1
42,84,0.5,16,39,0.41,15,21,0.714,6,30,36,26,6,5,16,20,26,45,0.5777777777777777,0
35,92,0.38,13,37,0.351,19,23,0.826,7,45,52,24,7,6,10,20,22,55,0.4,1
35,92,0.38,7,39,0.179,22,25,0.88,8,45,53,17,6,2,12,20,28,53,0.5283018867924528,0
46,93,0.495,12,37,0.324,11,14,0.786,16,31,47,30,10,8,11,20,34,56,0.6071428571428571,1
36,85,0.424,8,33,0.242,21,28,0.75,15,31,46,18,8,7,16,15,28,52,0.5384615384615384,0
36,84,0.429,9,34,0.265,26,33,0.788,14,41,55,20,3,3,13,25,27,50,0.54,1
27,86,0.314,6,44,0.136,17,25,0.68,12,25,37,11,3,4,8,24,21,42,0.5,0
40,76,0.526,3,15,0.2,31,35,0.886,2,31,33,19,13,0,11,15,37,61,0.6065573770491803,1
42,82,0.512,11,31,0.355,13,17,0.765,5,27,32,25,6,3,16,25,31,51,0.6078431372549019,0
47,101,0.465,18,47,0.383,18,26,0.692,12,36,48,25,10,7,16,21,29,54,0.5370370370370371,0
52,102,0.51,17,40,0.425,18,19,0.947,10,40,50,25,7,4,20,21,35,62,0.5645161290322581,1
41,87,0.471,10,27,0.37,17,20,0.85,9,32,41,26,10,3,13,13,31,60,0.5166666666666667,0
43,86,0.5,16,32,0.5,13,13,1.0,7,34,41,21,6,10,12,15,27,54,0.5,1
45,99,0.455,11,37,0.297,10,10,1.0,14,41,55,26,8,5,15,18,34,62,0.5483870967741935,1
35,88,0.398,10,33,0.303,10,13,0.769,6,32,38,27,8,5,15,9,25,55,0.45454545454545453,0
43,86,0.5,11,38,0.289,18,22,0.818,7,37,44,26,6,3,9,20,32,48,0.6666666666666666,0
47,94,0.5,12,35,0.343,18,23,0.783,11,39,50,24,7,2,9,19,35,59,0.5932203389830508,1
36,87,0.414,14,43,0.326,16,24,0.667,9,33,42,26,8,0,16,18,22,44,0.5,0
45,86,0.523,22,52,0.423,20,26,0.769,6,42,48,34,10,5,14,18,23,34,0.6764705882352942,1
36,76,0.474,14,37,0.378,22,26,0.846,7,38,45,25,4,1,19,20,22,39,0.5641025641025641,1
41,93,0.441,7,31,0.226,13,18,0.722,10,31,41,23,11,2,11,22,34,62,0.5483870967741935,0
40,82,0.488,9,35,0.257,17,19,0.895,10,41,51,26,11,3,20,20,31,47,0.6595744680851063,1
38,85,0.447,12,34,0.353,12,18,0.667,8,30,38,24,11,5,16,22,26,51,0.5098039215686274,0
41,85,0.482,11,30,0.367,26,28,0.929,13,34,47,12,7,1,10,23,30,55,0.5454545454545454,1
38,84,0.452,9,32,0.281,19,20,0.95,7,29,36,24,5,4,14,18,29,52,0.5576923076923077,0
29,89,0.326,9,36,0.25,18,22,0.818,9,27,36,19,4,2,10,23,20,53,0.37735849056603776,0
42,81,0.519,17,46,0.37,22,27,0.815,6,44,50,31,3,5,9,23,25,35,0.7142857142857143,1
42,88,0.477,14,42,0.333,15,20,0.75,8,28,36,26,9,4,8,25,28,46,0.6086956521739131,1
35,84,0.417,7,31,0.226,25,32,0.781,12,37,49,19,5,6,13,20,28,53,0.5283018867924528,0
51,91,0.56,18,40,0.45,9,17,0.529,10,35,45,29,13,15,12,22,33,51,0.6470588235294118,1
30,93,0.323,14,36,0.389,26,30,0.867,17,33,50,19,5,5,20,19,16,57,0.2807017543859649,0
40,82,0.488,12,32,0.375,14,17,0.824,6,30,36,22,7,3,12,20,28,50,0.56,0
43,90,0.478,9,31,0.29,17,19,0.895,15,32,47,28,5,3,10,19,34,59,0.576271186440678,1
35,83,0.422,10,34,0.294,23,24,0.958,11,31,42,21,4,4,14,22,25,49,0.5102040816326531,0
42,90,0.467,6,32,0.188,24,30,0.8,13,34,47,23,10,3,9,19,36,58,0.6206896551724138,1
40,88,0.455,11,36,0.306,22,28,0.786,12,35,47,20,6,8,14,21,29,52,0.5576923076923077,1
41,86,0.477,6,30,0.2,12,19,0.632,5,34,39,29,9,3,13,23,35,56,0.625,0
39,85,0.459,9,27,0.333,22,33,0.667,14,33,47,21,6,6,11,18,30,58,0.5172413793103449,0
48,91,0.527,14,31,0.452,12,17,0.706,7,30,37,25,5,3,9,25,34,60,0.5666666666666667,1
38,90,0.422,10,25,0.4,28,37,0.757,15,39,54,23,8,6,16,31,28,65,0.4307692307692308,0
46,104,0.442,9,26,0.346,17,29,0.586,19,35,54,23,8,16,10,27,37,78,0.47435897435897434,1
35,79,0.443,8,25,0.32,27,29,0.931,7,33,40,25,5,2,18,23,27,54,0.5,0
41,86,0.477,11,35,0.314,24,27,0.889,8,34,42,28,9,6,9,26,30,51,0.5882352941176471,1
52,87,0.598,22,47,0.468,16,20,0.8,6,32,38,41,11,1,14,23,30,40,0.75,1
43,86,0.5,15,39,0.385,19,25,0.76,13,27,40,31,9,2,17,21,28,47,0.5957446808510638,0
41,90,0.456,15,45,0.333,13,13,1.0,5,32,37,24,8,5,9,24,26,45,0.5777777777777777,0
40,86,0.465,16,40,0.4,22,25,0.88,10,39,49,31,4,3,12,11,24,46,0.5217391304347826,1
42,94,0.447,14,32,0.438,19,21,0.905,12,36,48,19,11,4,17,19,28,62,0.45161290322580644,1
44,88,0.5,11,36,0.306,13,17,0.765,5,35,40,27,7,8,16,23,33,52,0.6346153846153846,0
37,92,0.402,13,40,0.325,15,23,0.652,16,41,57,20,10,8,17,26,24,52,0.46153846153846156,0
34,85,0.4,6,29,0.207,30,43,0.698,14,40,54,15,8,6,13,20,28,56,0.5,1
36,86,0.419,5,24,0.208,14,17,0.824,5,35,40,19,7,4,14,19,31,62,0.5,0
39,88,0.443,9,21,0.429,14,15,0.933,8,38,46,20,12,5,14,18,30,67,0.44776119402985076,1
48,102,0.471,12,31,0.387,19,25,0.76,23,27,50,28,12,6,8,23,36,71,0.5070422535211268,1
43,78,0.551,11,27,0.407,18,24,0.75,9,30,39,32,4,5,19,23,32,51,0.6274509803921569,0
38,92,0.413,17,44,0.386,16,23,0.696,8,31,39,27,8,2,5,16,21,48,0.4375,0
45,93,0.484,18,45,0.4,14,15,0.933,12,43,55,33,3,7,12,19,27,48,0.5625,1
35,83,0.422,15,42,0.357,28,32,0.875,6,40,46,21,12,5,15,19,20,41,0.4878048780487805,1
35,88,0.398,15,45,0.333,19,25,0.76,11,42,53,23,7,1,18,24,20,43,0.46511627906976744,0
39,83,0.47,14,34,0.412,26,27,0.963,9,26,35,26,7,8,15,16,25,49,0.5102040816326531,0
48,93,0.516,11,30,0.367,20,22,0.909,12,31,43,21,10,3,11,21,37,63,0.5873015873015873,1
45,92,0.489,14,36,0.389,15,15,1.0,9,38,47,23,6,10,13,20,31,56,0.5535714285714286,1
42,102,0.412,11,34,0.324,13,16,0.813,15,37,52,28,6,3,12,15,31,68,0.45588235294117646,0
47,94,0.5,13,33,0.394,18,21,0.857,8,25,33,27,6,3,7,20,34,61,0.5573770491803278,0
48,86,0.558,16,41,0.39,22,31,0.71,10,34,44,21,4,5,10,20,32,45,0.7111111111111111,1
46,89,0.517,15,35,0.429,21,26,0.808,15,28,43,23,7,4,15,21,31,54,0.5740740740740741,0
46,84,0.548,17,38,0.447,22,24,0.917,9,27,36,27,9,3,12,21,29,46,0.6304347826086957,1
33,74,0.446,15,37,0.405,14,19,0.737,4,38,42,20,7,5,18,16,18,37,0.4864864864864865,1
33,88,0.375,9,37,0.243,17,19,0.895,11,34,45,16,8,3,11,12,24,51,0.47058823529411764,0
39,83,0.47,11,29,0.379,18,21,0.857,11,29,40,27,8,5,17,21,28,54,0.5185185185185185,0
44,89,0.494,6,29,0.207,16,22,0.727,12,27,39,30,11,3,14,19,38,60,0.6333333333333333,1
40,89,0.449,10,30,0.333,16,20,0.8,11,35,46,25,5,3,6,15,30,59,0.5084745762711864,1
36,80,0.45,12,29,0.414,18,20,0.9,8,36,44,23,3,4,10,18,24,51,0.47058823529411764,0
39,77,0.506,12,31,0.387,15,25,0.6,9,30,39,24,3,4,25,26,27,46,0.5869565217391305,0
48,93,0.516,10,32,0.313,24,34,0.706,14,31,45,30,17,3,11,20,38,61,0.6229508196721312,1
48,102,0.471,11,29,0.379,18,20,0.9,20,37,57,30,8,5,13,20,37,73,0.5068493150684932,1
41,97,0.423,13,41,0.317,23,28,0.821,14,30,44,25,7,8,11,21,28,56,0.5,0
35,92,0.38,14,37,0.378,32,37,0.865,10,35,45,21,7,3,8,17,21,55,0.38181818181818183,1
41,91,0.451,18,43,0.419,14,20,0.7,8,42,50,28,7,7,12,27,23,48,0.4791666666666667,0
36,81,0.444,16,40,0.4,23,31,0.742,7,30,37,24,4,2,19,14,20,41,0.4878048780487805,0
58,102,0.569,12,33,0.364,12,14,0.857,14,37,51,36,12,5,11,24,46,69,0.6666666666666666,1
44,88,0.5,10,24,0.417,15,21,0.714,11,45,56,25,4,9,21,25,34,64,0.53125,0
40,109,0.367,12,48,0.25,30,32,0.938,17,32,49,28,13,6,4,15,28,61,0.45901639344262296,1
43,98,0.439,12,36,0.333,13,17,0.765,12,31,43,29,5,8,11,24,31,62,0.5,0
41,86,0.477,15,30,0.5,23,32,0.719,12,37,49,28,7,4,12,19,26,56,0.4642857142857143,1
42,82,0.512,10,26,0.385,18,23,0.783,5,30,35,28,7,1,12,18,32,56,0.5714285714285714,0
45,84,0.536,18,45,0.4,18,22,0.818,6,38,44,26,7,4,13,21,27,39,0.6923076923076923,1
39,96,0.406,10,37,0.27,26,36,0.722,19,45,64,24,8,9,13,20,29,59,0.4915254237288136,1
34,87,0.391,13,42,0.31,22,29,0.759,9,34,43,20,7,7,13,27,21,45,0.4666666666666667,0
49,91,0.538,20,35,0.571,16,21,0.762,8,29,37,33,12,7,6,17,29,56,0.5178571428571429,1
42,90,0.467,16,44,0.364,16,19,0.842,13,36,49,31,4,3,18,19,26,46,0.5652173913043478,0
44,82,0.537,13,33,0.394,13,20,0.65,6,36,42,29,8,3,14,24,31,49,0.6326530612244898,1
36,84,0.429,12,33,0.364,26,32,0.813,11,37,48,25,8,6,13,17,24,51,0.47058823529411764,0
36,88,0.409,10,34,0.294,21,22,0.955,9,31,40,22,5,5,15,20,26,54,0.48148148148148145,0
39,82,0.476,10,25,0.4,24,26,0.923,7,38,45,25,10,3,16,21,29,57,0.5087719298245614,1
52,90,0.578,17,33,0.515,28,32,0.875,7,33,40,28,8,3,16,20,35,57,0.6140350877192983,1
52,97,0.536,13,35,0.371,22,26,0.846,9,27,36,33,5,11,15,24,39,62,0.6290322580645161,0
40,86,0.465,12,31,0.387,25,29,0.862,6,36,42,21,10,3,14,19,28,55,0.509090909090909,1
37,93,0.398,17,48,0.354,20,24,0.833,13,32,45,21,7,4,14,23,20,45,0.4444444444444444,0
54,105,0.514,15,40,0.375,12,20,0.6,18,33,51,38,11,11,10,16,39,65,0.6,1
41,98,0.418,6,30,0.2,14,19,0.737,16,33,49,23,4,3,19,21,35,68,0.5147058823529411,0
37,80,0.463,10,34,0.294,14,22,0.636,6,33,39,23,6,5,13,30,27,46,0.5869565217391305,0
29,72,0.403,12,33,0.364,35,39,0.897,7,37,44,20,1,1,13,21,17,39,0.4358974358974359,1
49,90,0.544,18,34,0.529,15,15,1.0,6,28,34,35,9,2,9,22,31,56,0.5535714285714286,1
43,86,0.5,12,34,0.353,17,24,0.708,13,32,45,29,7,4,17,19,31,52,0.5961538461538461,0
53,88,0.602,16,27,0.593,28,34,0.824,7,41,48,35,9,4,13,23,37,61,0.6065573770491803,1
36,95,0.379,15,41,0.366,21,27,0.778,11,26,37,25,2,4,12,25,21,54,0.3888888888888889,0
41,83,0.494,12,34,0.353,19,19,1.0,9,28,37,21,5,2,11,17,29,49,0.5918367346938775,1
45,91,0.495,9,26,0.346,12,15,0.8,19,26,45,28,2,2,11,21,36,65,0.5538461538461539,0
40,93,0.43,13,37,0.351,13,14,0.929,12,31,43,28,6,2,13,23,27,56,0.48214285714285715,0
43,87,0.494,11,35,0.314,19,23,0.826,11,32,43,30,8,8,9,18,32,52,0.6153846153846154,1
41,79,0.519,12,32,0.375,24,28,0.857,7,32,39,24,6,2,11,25,29,47,0.6170212765957447,1
39,80,0.488,9,28,0.321,27,32,0.844,8,31,39,25,9,4,9,17,30,52,0.5769230769230769,0
38,81,0.469,15,40,0.375,19,22,0.864,8,45,53,23,4,4,10,15,23,41,0.5609756097560976,1
32,86,0.372,11,48,0.229,13,16,0.813,7,31,38,19,8,4,8,21,21,38,0.5526315789473685,0
53,95,0.558,13,33,0.394,10,13,0.769,13,36,49,32,5,4,11,18,40,62,0.6451612903225806,1
42,85,0.494,16,39,0.41,12,19,0.632,9,24,33,26,9,3,12,13,26,46,0.5652173913043478,0
38,83,0.458,11,32,0.344,16,21,0.762,13,30,43,14,5,1,11,12,27,51,0.5294117647058824,1
38,78,0.487,11,30,0.367,13,15,0.867,10,31,41,27,7,2,14,15,27,48,0.5625,0
39,93,0.419,10,44,0.227,16,23,0.696,13,25,38,23,7,4,14,25,29,49,0.5918367346938775,0
40,90,0.444,17,42,0.405,27,31,0.871,15,36,51,22,7,6,17,23,23,48,0.4791666666666667,1
40,91,0.44,11,34,0.324,7,14,0.5,10,31,41,26,1,3,12,31,29,57,0.5087719298245614,0
40,80,0.5,16,38,0.421,32,39,0.821,9,38,47,31,9,8,11,14,24,42,0.5714285714285714,1
47,89,0.528,18,35,0.514,23,32,0.719,8,39,47,21,12,3,13,19,29,54,0.5370370370370371,1
46,94,0.489,16,43,0.372,18,21,0.857,7,32,39,27,8,5,15,21,30,51,0.5882352941176471,0
43,82,0.524,13,35,0.371,21,29,0.724,10,37,47,24,11,1,19,18,30,47,0.6382978723404256,0
43,98,0.439,19,41,0.463,17,20,0.85,15,33,48,31,10,2,12,18,24,57,0.42105263157894735,1
43,91,0.473,12,34,0.353,12,17,0.706,5,32,37,28,10,2,12,22,31,57,0.543859649122807,0
42,83,0.506,19,39,0.487,22,29,0.759,10,37,47,20,8,6,17,18,23,44,0.5227272727272727,1
46,90,0.511,15,37,0.405,20,21,0.952,8,33,41,30,7,3,10,25,31,53,0.5849056603773585,1
41,87,0.471,5,23,0.217,22,31,0.71,13,35,48,26,7,8,11,18,36,64,0.5625,0
47,94,0.5,20,43,0.465,20,31,0.645,10,35,45,34,11,3,9,21,27,51,0.5294117647058824,1
47,97,0.485,11,30,0.367,15,21,0.714,10,35,45,24,3,4,14,21,36,67,0.5373134328358209,0
40,86,0.465,8,22,0.364,17,23,0.739,15,33,48,18,6,10,17,18,32,64,0.5,0
45,91,0.495,13,28,0.464,17,21,0.81,7,33,40,28,12,6,10,20,32,63,0.5079365079365079,1
48,96,0.5,13,35,0.371,14,24,0.583,17,20,37,29,14,4,14,26,35,61,0.5737704918032787,0
45,77,0.584,10,25,0.4,28,33,0.848,13,32,45,24,7,4,21,22,35,52,0.6730769230769231,1
46,92,0.5,10,33,0.303,14,18,0.778,13,38,51,35,6,3,19,24,36,59,0.6101694915254238,0
44,98,0.449,14,37,0.378,17,26,0.654,15,31,46,31,11,4,11,17,30,61,0.4918032786885246,1
47,101,0.465,14,43,0.326,13,19,0.684,16,30,46,29,7,4,13,26,33,58,0.5689655172413793,1
39,79,0.494,12,27,0.444,28,32,0.875,5,37,42,24,9,8,16,19,27,52,0.5192307692307693,0
40,84,0.476,10,34,0.294,18,23,0.783,11,36,47,19,4,5,12,10,30,50,0.6,0
46,95,0.484,18,51,0.353,10,12,0.833,11,35,46,25,5,0,6,19,28,44,0.6363636363636364,1
34,79,0.43,13,34,0.382,16,21,0.762,3,35,38,19,2,6,13,27,21,45,0.4666666666666667,0
31,90,0.344,10,33,0.303,28,36,0.778,19,41,60,18,9,3,13,20,21,57,0.3684210526315789,1
37,80,0.463,12,32,0.375,15,21,0.714,11,29,40,21,4,3,12,17,25,48,0.5208333333333334,0
37,75,0.493,16,38,0.421,21,23,0.913,5,33,38,23,9,4,12,21,21,37,0.5675675675675675,1
35,85,0.412,7,27,0.259,25,31,0.806,13,24,37,20,6,0,11,18,28,58,0.4827586206896552,0
47,84,0.56,11,25,0.44,24,26,0.923,10,39,49,23,5,4,13,20,36,59,0.6101694915254238,1
46,82,0.561,22,40,0.55,12,17,0.706,6,37,43,33,11,1,13,23,24,42,0.5714285714285714,1
33,79,0.418,13,36,0.361,18,24,0.75,8,29,37,23,5,6,16,14,20,43,0.46511627906976744,0
48,96,0.5,14,34,0.412,14,18,0.778,13,45,58,24,13,4,10,21,34,62,0.5483870967741935,1
32,89,0.36,11,44,0.25,16,20,0.8,8,32,40,22,5,4,16,12,21,45,0.4666666666666667,0
47,96,0.49,19,43,0.442,15,21,0.714,13,30,43,33,6,4,14,19,28,53,0.5283018867924528,1
49,97,0.505,12,37,0.324,13,20,0.65,16,30,46,25,8,2,12,19,37,60,0.6166666666666667,0
31,86,0.36,11,35,0.314,19,21,0.905,8,35,43,23,10,8,12,13,20,51,0.39215686274509803,0
47,97,0.485,16,44,0.364,11,14,0.786,15,44,59,30,9,5,12,18,31,53,0.5849056603773585,1
39,89,0.438,14,38,0.368,16,20,0.8,12,32,44,18,4,4,15,26,25,51,0.49019607843137253,0
44,88,0.5,20,42,0.476,21,27,0.778,10,36,46,33,8,8,9,18,24,46,0.5217391304347826,1
41,85,0.482,13,30,0.433,14,19,0.737,10,28,38,23,10,6,16,22,28,55,0.509090909090909,0
45,88,0.511,10,26,0.385,13,23,0.565,12,32,44,28,7,4,16,16,35,62,0.5645161290322581,1
43,97,0.443,19,52,0.365,14,17,0.824,14,37,51,27,6,4,14,18,24,45,0.5333333333333333,0
47,92,0.511,22,47,0.468,22,26,0.846,8,36,44,30,12,2,11,19,25,45,0.5555555555555556,1
48,91,0.527,13,35,0.371,10,11,0.909,9,32,41,25,3,1,15,23,35,56,0.625,0
44,85,0.518,13,31,0.419,26,31,0.839,7,29,36,30,10,1,8,13,31,54,0.5740740740740741,1
43,96,0.448,7,21,0.333,24,27,0.889,18,36,54,22,12,1,16,23,36,75,0.48,1
41,87,0.471,10,32,0.313,20,23,0.87,7,33,40,22,7,4,16,22,31,55,0.5636363636363636,0
47,82,0.573,19,40,0.475,11,11,1.0,5,33,38,29,4,6,9,18,28,42,0.6666666666666666,1
35,87,0.402,14,39,0.359,20,25,0.8,13,28,41,22,4,3,11,15,21,48,0.4375,0
38,98,0.388,15,40,0.375,19,25,0.76,17,27,44,25,7,2,11,18,23,58,0.39655172413793105,1
41,90,0.456,11,33,0.333,15,21,0.714,20,37,57,26,5,1,15,20,30,57,0.5263157894736842,0
46,96,0.479,16,34,0.471,14,17,0.824,7,44,51,26,14,6,14,24,30,62,0.4838709677419355,1
37,86,0.43,10,31,0.323,14,24,0.583,5,40,45,26,6,3,17,16,27,55,0.4909090909090909,0
38,81,0.469,9,33,0.273,13,18,0.722,10,22,32,23,10,3,18,19,29,48,0.6041666666666666,0
48,84,0.571,15,35,0.429,18,21,0.857,11,30,41,38,10,2,16,19,33,49,0.673469387755102,1
34,74,0.459,17,46,0.37,23,29,0.793,9,40,49,16,9,11,12,17,17,28,0.6071428571428571,1
31,83,0.373,16,40,0.4,15,21,0.714,10,27,37,20,7,2,11,19,15,43,0.3488372093023256,0
30,92,0.326,13,48,0.271,12,18,0.667,14,33,47,19,13,7,16,24,17,44,0.38636363636363635,0
32,83,0.386,7,31,0.226,19,24,0.792,15,45,60,22,11,4,21,17,25,52,0.4807692307692308,1
35,93,0.376,7,26,0.269,16,23,0.696,20,36,56,16,5,4,9,16,28,67,0.417910447761194,1
30,73,0.411,7,27,0.259,21,28,0.75,5,35,40,21,7,5,10,23,23,46,0.5,0
46,92,0.5,12,28,0.429,23,27,0.852,10,40,50,25,12,5,18,30,34,64,0.53125,1
39,91,0.429,16,34,0.471,30,36,0.833,9,33,42,27,12,2,15,21,23,57,0.40350877192982454,0
37,83,0.446,14,39,0.359,18,22,0.818,11,26,37,18,8,7,14,16,23,44,0.5227272727272727,0
45,83,0.542,11,30,0.367,13,15,0.867,7,34,41,31,5,4,14,19,34,53,0.6415094339622641,1
40,91,0.44,6,32,0.188,13,15,0.867,14,35,49,26,5,6,14,20,34,59,0.576271186440678,0
44,90,0.489,11,28,0.393,14,24,0.583,14,28,42,28,6,7,6,14,33,62,0.532258064516129,1
40,90,0.444,9,24,0.375,14,16,0.875,15,32,47,23,9,4,15,16,31,66,0.4696969696969697,0
40,79,0.506,13,37,0.351,13,15,0.867,5,30,35,34,5,10,17,19,27,42,0.6428571428571429,1
53,94,0.564,12,32,0.375,13,16,0.813,9,32,41,34,7,3,8,19,41,62,0.6612903225806451,1
45,86,0.523,14,39,0.359,16,19,0.842,8,30,38,29,3,2,12,19,31,47,0.6595744680851063,0
36,91,0.396,13,36,0.361,23,29,0.793,15,35,50,21,9,3,9,18,23,55,0.41818181818181815,0
40,83,0.482,14,46,0.304,16,21,0.762,7,40,47,27,5,3,12,21,26,37,0.7027027027027027,1
37,88,0.42,8,28,0.286,37,49,0.755,17,30,47,22,15,7,9,26,29,60,0.48333333333333334,1
36,85,0.424,9,35,0.257,34,41,0.829,12,36,48,22,8,5,20,34,27,50,0.54,0
35,85,0.412,6,29,0.207,21,24,0.875,10,37,47,24,7,6,11,15,29,56,0.5178571428571429,0
42,85,0.494,20,39,0.513,11,13,0.846,6,38,44,30,5,8,13,22,22,46,0.4782608695652174,1
44,86,0.512,15,40,0.375,29,34,0.853,6,36,42,22,8,7,9,18,29,46,0.6304347826086957,1
48,93,0.516,17,37,0.459,10,14,0.714,10,32,42,23,5,4,11,26,31,56,0.5535714285714286,0
38,80,0.475,10,33,0.303,20,20,1.0,4,30,34,23,6,4,12,16,28,47,0.5957446808510638,0
43,86,0.5,15,37,0.405,12,16,0.75,11,34,45,26,6,4,12,20,28,49,0.5714285714285714,1
42,86,0.488,10,32,0.313,21,26,0.808,6,29,35,27,3,7,6,19,32,54,0.5925925925925926,0
45,83,0.542,16,32,0.5,21,23,0.913,6,34,40,31,4,5,11,19,29,51,0.5686274509803921,1
39,92,0.424,13,33,0.394,7,13,0.538,5,28,33,21,9,4,7,12,26,59,0.4406779661016949,0
50,82,0.61,12,28,0.429,14,20,0.7,5,48,53,26,4,6,15,12,38,54,0.7037037037037037,1
40,81,0.494,15,36,0.417,22,27,0.815,10,33,43,26,7,5,14,18,25,45,0.5555555555555556,1
42,86,0.488,13,34,0.382,14,26,0.538,14,27,41,20,12,4,14,23,29,52,0.5576923076923077,0
34,85,0.4,11,32,0.344,11,16,0.688,12,36,48,21,6,3,18,23,23,53,0.4339622641509434,0
34,79,0.43,10,36,0.278,16,20,0.8,6,33,39,25,9,6,14,14,24,43,0.5581395348837209,1
35,88,0.398,8,36,0.222,19,21,0.905,16,24,40,13,8,1,14,14,27,52,0.5192307692307693,0
50,84,0.595,19,36,0.528,6,7,0.857,8,31,39,37,8,10,13,20,31,48,0.6458333333333334,1
43,83,0.518,20,45,0.444,15,17,0.882,6,34,40,30,5,3,9,17,23,38,0.6052631578947368,1
42,89,0.472,13,46,0.283,9,17,0.529,14,31,45,26,5,4,11,18,29,43,0.6744186046511628,0
33,82,0.402,4,28,0.143,21,28,0.75,12,33,45,17,8,5,16,21,29,54,0.5370370370370371,0
42,86,0.488,8,33,0.242,18,22,0.818,8,34,42,24,9,1,13,24,34,53,0.6415094339622641,1
37,92,0.402,14,44,0.318,13,15,0.867,9,31,40,21,8,3,14,17,23,48,0.4791666666666667,0
44,88,0.5,12,33,0.364,22,25,0.88,9,45,54,30,10,4,16,19,32,55,0.5818181818181818,1
43,82,0.524,12,37,0.324,12,17,0.706,4,32,36,26,7,3,17,10,31,45,0.6888888888888889,1
42,91,0.462,14,36,0.389,11,11,1.0,10,32,42,34,11,3,15,17,28,55,0.509090909090909,0
47,91,0.516,10,27,0.37,22,28,0.786,8,35,43,26,7,5,7,13,37,64,0.578125,1
50,97,0.515,11,30,0.367,10,16,0.625,11,34,45,25,6,3,12,19,39,67,0.582089552238806,0
43,87,0.494,9,25,0.36,25,27,0.926,10,29,39,18,6,10,14,20,34,62,0.5483870967741935,0
47,101,0.465,19,38,0.5,19,22,0.864,16,30,46,28,8,7,13,22,28,63,0.4444444444444444,1
40,77,0.519,15,36,0.417,23,27,0.852,7,38,45,23,5,2,13,24,25,41,0.6097560975609756,1
37,85,0.435,14,36,0.389,16,21,0.762,8,26,34,26,8,1,10,19,23,49,0.46938775510204084,0
45,86,0.523,12,33,0.364,23,29,0.793,11,32,43,30,6,9,13,20,33,53,0.6226415094339622,1
42,95,0.442,13,43,0.302,19,22,0.864,15,30,45,27,5,5,12,21,29,52,0.5576923076923077,0
36,93,0.387,17,51,0.333,13,16,0.813,9,36,45,24,3,3,11,22,19,42,0.4523809523809524,0
38,79,0.481,17,41,0.415,25,30,0.833,5,39,44,21,6,6,12,16,21,38,0.5526315789473685,1
46,94,0.489,19,44,0.432,22,24,0.917,14,39,53,34,8,11,14,13,27,50,0.54,1
36,94,0.383,7,26,0.269,17,18,0.944,12,31,43,18,5,5,18,21,29,68,0.4264705882352941,0
52,86,0.605,13,27,0.481,23,29,0.793,5,24,29,32,7,3,9,23,39,59,0.6610169491525424,1
48,81,0.593,15,32,0.469,19,27,0.704,10,27,37,27,5,2,17,22,33,49,0.673469387755102,0
39,92,0.424,9,33,0.273,16,23,0.696,9,22,31,20,7,8,11,19,30,59,0.5084745762711864,0
50,93,0.538,21,42,0.5,12,17,0.706,16,39,55,34,8,9,17,22,29,51,0.5686274509803921,1
43,92,0.467,11,38,0.289,5,9,0.556,12,29,41,25,9,1,11,17,32,54,0.5925925925925926,0
42,81,0.519,16,35,0.457,14,16,0.875,4,37,41,23,5,2,16,17,26,46,0.5652173913043478,1
40,78,0.513,14,34,0.412,15,19,0.789,4,29,33,25,5,4,15,24,26,44,0.5909090909090909,0
41,83,0.494,12,29,0.414,32,34,0.941,10,33,43,23,10,2,11,17,29,54,0.5370370370370371,1
37,79,0.468,12,30,0.4,18,22,0.818,9,27,36,24,4,3,13,14,25,49,0.5102040816326531,0
42,89,0.472,16,37,0.432,17,19,0.895,13,27,40,26,9,5,9,22,26,52,0.5,1
43,90,0.478,14,41,0.341,10,13,0.769,14,33,47,27,4,1,16,22,29,49,0.5918367346938775,0
46,89,0.517,14,37,0.378,15,19,0.789,12,32,44,27,11,4,12,18,32,52,0.6153846153846154,1
38,84,0.452,17,47,0.362,8,11,0.727,9,29,38,25,7,2,12,16,21,37,0.5675675675675675,0
41,88,0.466,13,34,0.382,12,17,0.706,16,29,45,26,7,3,10,17,28,54,0.5185185185185185,1
36,83,0.434,9,30,0.3,19,21,0.905,5,40,45,23,6,7,17,15,27,53,0.5094339622641509,1
39,95,0.411,6,32,0.188,13,14,0.929,10,38,48,19,9,8,15,20,33,63,0.5238095238095238,0
43,92,0.467,15,35,0.429,21,24,0.875,12,40,52,23,12,8,13,18,28,57,0.49122807017543857,1
34,85,0.4,8,25,0.32,21,25,0.84,9,30,39,19,7,7,16,18,26,60,0.43333333333333335,0
36,82,0.439,17,50,0.34,22,28,0.786,17,25,42,23,8,2,11,24,19,32,0.59375,1
35,70,0.5,12,33,0.364,21,25,0.84,8,27,35,18,6,3,15,25,23,37,0.6216216216216216,0
35,90,0.389,10,43,0.233,15,19,0.789,10,35,45,21,4,5,11,19,25,47,0.5319148936170213,0
43,84,0.512,11,32,0.344,19,24,0.792,6,39,45,26,4,2,9,21,32,52,0.6153846153846154,1
43,83,0.518,19,45,0.422,20,23,0.87,9,28,37,27,12,3,16,22,24,38,0.631578947368421,1
43,85,0.506,3,20,0.15,17,23,0.739,13,25,38,28,6,3,17,21,40,65,0.6153846153846154,0
36,75,0.48,5,21,0.238,21,25,0.84,6,31,37,23,6,1,15,21,31,54,0.5740740740740741,1
34,82,0.415,7,31,0.226,19,27,0.704,15,31,46,17,7,3,13,23,27,51,0.5294117647058824,0
39,84,0.464,14,36,0.389,15,16,0.938,5,31,36,29,8,5,17,19,25,48,0.5208333333333334,0
41,85,0.482,8,31,0.258,23,24,0.958,10,37,47,33,11,5,15,19,33,54,0.6111111111111112,1
37,93,0.398,7,32,0.219,21,26,0.808,14,32,46,19,4,7,14,21,30,61,0.4918032786885246,0
49,102,0.48,13,37,0.351,16,23,0.696,16,38,54,30,10,9,8,19,36,65,0.5538461538461539,1
39,83,0.47,11,33,0.333,21,26,0.808,11,29,40,26,15,5,17,22,28,50,0.56,1
33,75,0.44,10,34,0.294,19,26,0.731,6,33,39,20,7,5,24,23,23,41,0.5609756097560976,0
39,92,0.424,7,26,0.269,22,25,0.88,16,33,49,22,4,6,10,17,32,66,0.48484848484848486,1
40,90,0.444,10,32,0.313,13,19,0.684,12,30,42,23,4,11,8,19,30,58,0.5172413793103449,0
42,98,0.429,11,36,0.306,19,24,0.792,18,41,59,24,4,4,14,12,31,62,0.5,1
45,106,0.425,13,36,0.361,7,7,1.0,15,42,57,27,9,3,13,20,32,70,0.45714285714285713,0
44,84,0.524,15,35,0.429,12,18,0.667,8,30,38,34,12,8,21,14,29,49,0.5918367346938775,1
37,93,0.398,12,40,0.3,12,17,0.706,21,30,51,21,14,4,23,19,25,53,0.4716981132075472,0
33,79,0.418,11,36,0.306,14,20,0.7,9,26,35,23,5,3,14,14,22,43,0.5116279069767442,0
51,84,0.607,15,32,0.469,14,19,0.737,9,33,42,34,9,3,6,16,36,52,0.6923076923076923,1
45,84,0.536,14,32,0.438,8,12,0.667,4,26,30,26,7,3,14,21,31,52,0.5961538461538461,0
49,87,0.563,17,39,0.436,19,21,0.905,10,35,45,27,7,5,13,20,32,48,0.6666666666666666,1
42,98,0.429,17,32,0.531,18,23,0.783,17,36,53,26,6,2,12,22,25,66,0.3787878787878788,1
43,97,0.443,7,34,0.206,17,26,0.654,14,36,50,30,9,11,11,20,36,63,0.5714285714285714,0
41,89,0.461,12,34,0.353,6,10,0.6,7,29,36,23,5,1,6,20,29,55,0.5272727272727272,0
40,77,0.519,17,34,0.5,17,24,0.708,10,35,45,21,3,2,10,13,23,43,0.5348837209302325,1
34,85,0.4,13,41,0.317,23,29,0.793,13,38,51,19,8,8,14,16,21,44,0.4772727272727273,1
39,85,0.459,8,29,0.276,16,18,0.889,9,28,37,23,8,5,10,21,31,56,0.5535714285714286,0
42,80,0.525,14,35,0.4,10,16,0.625,7,32,39,26,5,2,15,20,28,45,0.6222222222222222,0
44,91,0.484,9,27,0.333,19,24,0.792,12,29,41,25,10,1,7,13,35,64,0.546875,1
37,89,0.416,10,36,0.278,20,26,0.769,12,33,45,22,6,4,12,19,27,53,0.5094339622641509,0
45,87,0.517,13,27,0.481,11,17,0.647,5,35,40,24,5,5,13,21,32,60,0.5333333333333333,1
38,89,0.427,8,33,0.242,31,39,0.795,13,33,46,20,8,2,10,24,30,56,0.5357142857142857,0
44,84,0.524,16,28,0.571,19,22,0.864,5,37,42,33,5,8,12,24,28,56,0.5,1
40,86,0.465,12,33,0.364,21,28,0.75,17,34,51,29,7,3,16,17,28,53,0.5283018867924528,1
44,93,0.473,13,42,0.31,8,12,0.667,8,32,40,33,11,3,15,21,31,51,0.6078431372549019,0
42,87,0.483,10,37,0.27,7,13,0.538,8,37,45,31,6,1,17,24,32,50,0.64,0
37,83,0.446,13,41,0.317,20,23,0.87,6,35,41,26,11,4,15,13,24,42,0.5714285714285714,1
47,100,0.47,7,29,0.241,22,28,0.786,17,39,56,28,11,5,13,20,40,71,0.5633802816901409,1
38,92,0.413,20,49,0.408,24,28,0.857,10,34,44,26,5,9,12,24,18,43,0.4186046511627907,0
47,86,0.547,17,35,0.486,21,26,0.808,13,27,40,32,11,4,15,19,30,51,0.5882352941176471,1
45,87,0.517,17,36,0.472,16,18,0.889,8,20,28,32,7,6,14,22,28,51,0.5490196078431373,0
33,81,0.407,9,29,0.31,20,26,0.769,7,33,40,18,6,7,17,27,24,52,0.46153846153846156,0
43,92,0.467,12,30,0.4,25,35,0.714,13,39,52,26,11,3,14,21,31,62,0.5,1
37,81,0.457,12,35,0.343,14,18,0.778,5,27,32,21,6,2,14,12,25,46,0.5434782608695652,0
49,90,0.544,19,40,0.475,6,6,1.0,10,38,48,30,7,1,16,20,30,50,0.6,1
34,79,0.43,6,23,0.261,30,33,0.909,6,41,47,16,6,3,14,24,28,56,0.5,0
38,89,0.427,12,35,0.343,21,35,0.6,13,33,46,19,4,4,6,22,26,54,0.48148148148148145,1
48,90,0.533,20,45,0.444,18,25,0.72,11,38,49,32,7,3,21,15,28,45,0.6222222222222222,1
51,112,0.455,20,50,0.4,9,13,0.692,19,28,47,28,17,5,11,23,31,62,0.5,0
39,95,0.411,12,40,0.3,22,28,0.786,16,41,57,23,5,7,17,15,27,55,0.4909090909090909,0
46,106,0.434,10,39,0.256,13,18,0.722,16,36,52,16,10,11,10,28,36,67,0.5373134328358209,1
48,99,0.485,16,38,0.421,11,13,0.846,16,23,39,28,11,4,14,25,32,61,0.5245901639344263,0
42,76,0.553,15,28,0.536,31,34,0.912,8,33,41,24,9,6,19,19,27,48,0.5625,1
40,89,0.449,12,44,0.273,18,22,0.818,14,34,48,20,7,2,9,22,28,45,0.6222222222222222,0
45,87,0.517,20,46,0.435,18,23,0.783,11,35,46,27,5,1,8,14,25,41,0.6097560975609756,1
43,78,0.551,12,31,0.387,17,29,0.586,10,28,38,23,5,5,16,24,31,47,0.6595744680851063,0
41,83,0.494,15,36,0.417,24,28,0.857,10,23,33,21,8,4,11,23,26,47,0.5531914893617021,1
44,88,0.5,14,38,0.368,16,23,0.696,9,39,48,26,5,4,11,17,30,50,0.6,1
43,89,0.483,16,41,0.39,14,18,0.778,5,35,40,28,7,3,9,19,27,48,0.5625,0
43,85,0.506,6,18,0.333,15,18,0.833,6,30,36,26,9,1,9,14,37,67,0.5522388059701493,1
38,79,0.481,6,26,0.231,12,17,0.706,7,30,37,25,6,7,14,17,32,53,0.6037735849056604,0
38,79,0.481,13,34,0.382,17,25,0.68,4,38,42,27,9,6,18,23,25,45,0.5555555555555556,1
35,85,0.412,11,37,0.297,17,23,0.739,8,36,44,27,9,1,18,22,24,48,0.5,0
46,88,0.523,16,42,0.381,12,15,0.8,9,29,38,28,6,6,12,17,30,46,0.6521739130434783,1
42,83,0.506,11,25,0.44,17,22,0.773,9,30,39,24,7,3,15,15,31,58,0.5344827586206896,0
38,92,0.413,7,28,0.25,24,30,0.8,12,34,46,20,9,1,14,19,31,64,0.484375,1
35,83,0.422,13,38,0.342,20,25,0.8,10,38,48,26,7,4,21,24,22,45,0.4888888888888889,0
44,95,0.463,7,26,0.269,26,36,0.722,13,31,44,21,7,10,9,21,37,69,0.5362318840579711,1
43,94,0.457,13,42,0.31,19,25,0.76,12,39,51,23,7,4,18,34,30,52,0.5769230769230769,0
50,80,0.625,12,28,0.429,13,14,0.929,8,35,43,33,6,4,20,20,38,52,0.7307692307692307,1
44,97,0.454,12,40,0.3,18,23,0.783,18,19,37,29,11,4,8,21,32,57,0.5614035087719298,0
49,90,0.544,12,35,0.343,15,17,0.882,8,32,40,39,7,3,12,21,37,55,0.6727272727272727,1
40,85,0.471,16,44,0.364,18,26,0.692,11,32,43,23,5,5,14,19,24,41,0.5853658536585366,0
49,91,0.538,18,39,0.462,20,22,0.909,6,37,43,28,10,4,13,19,31,52,0.5961538461538461,1
41,87,0.471,17,41,0.415,19,27,0.704,10,32,42,31,5,2,18,17,24,46,0.5217391304347826,0
40,78,0.513,6,24,0.25,31,39,0.795,12,28,40,26,16,6,14,16,34,54,0.6296296296296297,1
39,85,0.459,14,42,0.333,15,18,0.833,13,28,41,30,7,4,22,27,25,43,0.5813953488372093,0
44,91,0.484,16,39,0.41,8,11,0.727,12,28,40,26,8,5,14,15,28,52,0.5384615384615384,1
42,83,0.506,14,35,0.4,13,16,0.813,7,30,37,26,8,1,15,13,28,48,0.5833333333333334,0
37,92,0.402,11,37,0.297,17,23,0.739,17,31,48,26,11,9,22,19,26,55,0.4727272727272727,0
48,96,0.5,18,36,0.5,11,15,0.733,11,36,47,32,9,4,19,23,30,60,0.5,1
40,96,0.417,11,34,0.324,19,22,0.864,11,31,42,21,8,5,12,23,29,62,0.46774193548387094,0
47,92,0.511,13,36,0.361,20,26,0.769,12,39,51,35,5,8,12,15,34,56,0.6071428571428571,1
39,90,0.433,7,30,0.233,22,28,0.786,15,32,47,19,6,5,14,20,32,60,0.5333333333333333,0
45,91,0.495,17,39,0.436,24,28,0.857,12,36,48,27,7,4,9,22,28,52,0.5384615384615384,1
40,89,0.449,12,41,0.293,28,34,0.824,11,46,57,17,12,3,23,14,28,48,0.5833333333333334,1
45,97,0.464,18,37,0.486,11,16,0.688,5,36,41,31,12,7,16,25,27,60,0.45,0
45,90,0.5,16,36,0.444,24,26,0.923,4,36,40,26,7,5,12,24,29,54,0.5370370370370371,0
50,102,0.49,10,29,0.345,25,32,0.781,13,37,50,24,6,3,8,17,40,73,0.547945205479452,1
31,69,0.449,7,26,0.269,25,28,0.893,4,35,39,22,8,9,15,17,24,43,0.5581395348837209,0
41,82,0.5,10,35,0.286,10,15,0.667,5,33,38,26,11,4,10,21,31,47,0.6595744680851063,1
41,83,0.494,7,25,0.28,20,28,0.714,9,31,40,18,5,3,11,21,34,58,0.5862068965517241,0
46,90,0.511,15,44,0.341,15,24,0.625,9,32,41,25,7,2,8,20,31,46,0.6739130434782609,1
42,81,0.519,17,36,0.472,22,23,0.957,8,22,30,25,9,3,16,30,25,45,0.5555555555555556,0
45,83,0.542,12,33,0.364,26,28,0.929,11,29,40,29,7,4,16,19,33,50,0.66,1
43,86,0.5,19,40,0.475,31,36,0.861,10,28,38,26,14,4,12,23,24,46,0.5217391304347826,1
46,86,0.535,12,35,0.343,26,29,0.897,10,34,44,36,7,2,18,23,34,51,0.6666666666666666,0
42,81,0.519,12,28,0.429,26,34,0.765,8,39,47,29,6,11,13,19,30,53,0.5660377358490566,1
41,97,0.423,17,45,0.378,18,26,0.692,15,30,45,26,9,7,11,25,24,52,0.46153846153846156,0
41,79,0.519,7,26,0.269,25,29,0.862,4,33,37,23,8,4,15,21,34,53,0.6415094339622641,1
39,82,0.476,11,27,0.407,22,31,0.71,7,33,40,24,10,1,17,24,28,55,0.509090909090909,0
47,86,0.547,10,27,0.37,10,17,0.588,2,37,39,27,8,4,20,25,37,59,0.6271186440677966,0
46,102,0.451,7,24,0.292,23,28,0.821,16,32,48,30,7,2,11,18,39,78,0.5,1
56,92,0.609,23,43,0.535,18,24,0.75,8,28,36,34,9,7,10,17,33,49,0.673469387755102,1
50,94,0.532,8,25,0.32,11,18,0.611,13,25,38,30,6,5,15,19,42,69,0.6086956521739131,0
40,94,0.426,15,48,0.313,15,18,0.833,8,36,44,29,9,8,8,20,25,46,0.5434782608695652,1
36,84,0.429,11,34,0.324,18,29,0.621,12,42,54,24,1,8,17,15,25,50,0.5,0
36,86,0.419,13,42,0.31,17,20,0.85,10,31,41,21,13,3,10,14,23,44,0.5227272727272727,1
34,79,0.43,11,35,0.314,10,11,0.909,9,36,45,24,6,4,22,14,23,44,0.5227272727272727,0
41,92,0.446,15,35,0.429,14,20,0.7,12,30,42,27,12,2,12,20,26,57,0.45614035087719296,0
46,81,0.568,16,37,0.432,22,28,0.786,8,36,44,34,9,6,15,16,30,44,0.6818181818181818,1
34,78,0.436,11,38,0.289,24,26,0.923,5,31,36,14,3,3,13,16,23,40,0.575,0
49,90,0.544,17,33,0.515,20,22,0.909,8,37,45,33,7,4,9,19,32,57,0.5614035087719298,1
42,99,0.424,17,37,0.459,14,19,0.737,10,42,52,17,5,3,13,29,25,62,0.4032258064516129,0
36,86,0.419,13,41,0.317,37,49,0.755,10,44,54,18,10,4,7,18,23,45,0.5111111111111111,1
44,82,0.537,17,34,0.5,22,27,0.815,5,36,41,28,4,1,9,21,27,48,0.5625,1
37,86,0.43,9,34,0.265,26,29,0.897,11,28,39,21,5,4,6,19,28,52,0.5384615384615384,0
38,89,0.427,15,46,0.326,16,22,0.727,12,35,47,19,8,2,13,17,23,43,0.5348837209302325,0
40,84,0.476,20,48,0.417,11,12,0.917,6,35,41,30,5,6,11,22,20,36,0.5555555555555556,1
44,81,0.543,15,34,0.441,16,21,0.762,7,36,43,26,6,3,12,24,29,47,0.6170212765957447,1
31,77,0.403,13,30,0.433,26,34,0.765,6,29,35,19,6,4,11,19,18,47,0.3829787234042553,0
42,87,0.483,11,30,0.367,19,24,0.792,7,25,32,34,14,1,17,18,31,57,0.543859649122807,0
53,87,0.609,21,43,0.488,17,21,0.81,10,37,47,38,10,5,19,18,32,44,0.7272727272727273,1
38,82,0.463,8,21,0.381,18,20,0.9,7,25,32,21,4,2,12,14,30,61,0.4918032786885246,0
56,91,0.615,23,44,0.523,9,13,0.692,7,32,39,39,6,5,8,20,33,47,0.7021276595744681,1
33,80,0.413,11,31,0.355,35,42,0.833,12,38,50,23,7,8,14,19,22,49,0.4489795918367347,1
35,78,0.449,15,33,0.455,23,31,0.742,7,34,41,24,10,3,12,28,20,45,0.4444444444444444,0
51,86,0.593,17,41,0.415,20,25,0.8,7,25,32,32,13,6,19,27,34,45,0.7555555555555555,1
48,85,0.565,16,40,0.4,20,29,0.69,11,25,36,28,8,4,24,24,32,45,0.7111111111111111,0
43,99,0.434,21,41,0.512,14,18,0.778,10,28,38,31,11,4,12,19,22,58,0.3793103448275862,1
45,94,0.479,12,38,0.316,15,19,0.789,17,41,58,33,6,11,19,21,33,56,0.5892857142857143,0
35,87,0.402,9,24,0.375,21,27,0.778,19,35,54,22,4,5,16,13,26,63,0.4126984126984127,0
45,95,0.474,21,44,0.477,8,10,0.8,12,29,41,33,10,5,10,21,24,51,0.47058823529411764,1
47,82,0.573,12,31,0.387,23,29,0.793,6,32,38,33,10,5,12,18,35,51,0.6862745098039216,1
49,92,0.533,6,20,0.3,14,21,0.667,6,34,40,31,4,5,13,25,43,72,0.5972222222222222,0
39,76,0.513,16,38,0.421,24,27,0.889,2,36,38,28,7,3,14,20,23,38,0.6052631578947368,1
42,95,0.442,15,40,0.375,13,18,0.722,10,26,36,25,9,1,9,22,27,55,0.4909090909090909,0
37,89,0.416,7,38,0.184,15,17,0.882,6,27,33,22,14,4,11,17,30,51,0.5882352941176471,0
43,87,0.494,17,41,0.415,14,18,0.778,12,42,54,33,7,4,18,18,26,46,0.5652173913043478,1
45,93,0.484,15,44,0.341,13,16,0.813,13,43,56,29,9,7,10,22,30,49,0.6122448979591837,1
30,85,0.353,12,44,0.273,16,27,0.593,8,32,40,18,5,2,11,12,18,41,0.43902439024390244,0
41,79,0.519,16,34,0.471,11,15,0.733,7,40,47,29,8,8,17,28,25,45,0.5555555555555556,1
31,81,0.383,7,33,0.212,21,24,0.875,6,29,35,19,5,1,13,15,24,48,0.5,0
33,84,0.393,16,45,0.356,10,15,0.667,7,32,39,22,7,4,14,22,17,39,0.4358974358974359,0
38,84,0.452,14,42,0.333,23,30,0.767,10,41,51,25,9,1,13,18,24,42,0.5714285714285714,1
41,79,0.519,18,38,0.474,14,22,0.636,8,30,38,30,9,4,17,21,23,41,0.5609756097560976,1
35,83,0.422,12,39,0.308,27,34,0.794,10,28,38,19,12,1,17,20,23,44,0.5227272727272727,0
40,99,0.404,11,43,0.256,14,25,0.56,18,30,48,18,8,6,11,20,29,56,0.5178571428571429,0
39,86,0.453,15,37,0.405,25,27,0.926,12,40,52,22,6,9,17,23,24,49,0.4897959183673469,1
46,87,0.529,12,35,0.343,23,25,0.92,8,39,47,32,8,8,14,19,34,52,0.6538461538461539,1
42,98,0.429,9,33,0.273,13,13,1.0,13,29,42,22,8,2,15,21,33,65,0.5076923076923077,0
44,89,0.494,12,26,0.462,16,24,0.667,5,43,48,31,6,3,11,14,32,63,0.5079365079365079,1
41,98,0.418,7,33,0.212,8,12,0.667,10,41,51,22,4,2,11,19,34,65,0.5230769230769231,0
47,87,0.54,23,40,0.575,14,18,0.778,5,31,36,34,8,3,16,14,24,47,0.5106382978723404,1
45,95,0.474,12,40,0.3,20,21,0.952,16,32,48,29,8,10,16,18,33,55,0.6,0
45,85,0.529,12,38,0.316,13,18,0.722,7,24,31,34,8,3,15,18,33,47,0.7021276595744681,0
48,84,0.571,23,42,0.548,25,29,0.862,8,33,41,29,10,1,15,19,25,42,0.5952380952380952,1
56,101,0.554,13,30,0.433,7,14,0.5,9,43,52,38,4,4,10,25,43,71,0.6056338028169014,1
41,91,0.451,14,41,0.341,18,25,0.72,6,32,38,27,6,3,10,16,27,50,0.54,0
35,83,0.422,11,32,0.344,13,16,0.813,10,30,40,24,10,6,17,19,24,51,0.47058823529411764,0
39,81,0.481,9,29,0.31,11,22,0.5,13,34,47,15,12,12,17,10,30,52,0.5769230769230769,1
42,86,0.488,16,36,0.444,15,22,0.682,9,38,47,25,6,4,12,11,26,50,0.52,0
47,93,0.505,16,35,0.457,10,15,0.667,8,35,43,31,9,8,7,19,31,58,0.5344827586206896,1
39,86,0.453,9,29,0.31,23,30,0.767,7,39,46,22,7,3,16,14,30,57,0.5263157894736842,0
50,102,0.49,14,39,0.359,7,9,0.778,11,42,53,38,10,4,14,22,36,63,0.5714285714285714,1
45,88,0.511,12,25,0.48,21,26,0.808,14,30,44,26,13,2,13,20,33,63,0.5238095238095238,1
39,76,0.513,11,30,0.367,20,22,0.909,3,31,34,28,4,3,15,20,28,46,0.6086956521739131,0
43,94,0.457,14,37,0.378,8,12,0.667,10,33,43,31,5,4,7,22,29,57,0.5087719298245614,0
44,101,0.436,9,35,0.257,21,31,0.677,20,40,60,20,6,5,8,14,35,66,0.5303030303030303,1
39,101,0.386,13,31,0.419,24,29,0.828,10,41,51,26,13,7,13,29,26,70,0.37142857142857144,0
40,96,0.417,12,38,0.316,29,43,0.674,13,48,61,23,8,8,17,21,28,58,0.4827586206896552,1
42,86,0.488,10,35,0.286,9,11,0.818,6,38,44,26,4,4,14,17,32,51,0.6274509803921569,0
43,92,0.467,16,39,0.41,16,19,0.842,7,32,39,26,11,1,6,13,27,53,0.5094339622641509,1
43,88,0.489,17,37,0.459,14,22,0.636,8,34,42,29,11,6,13,18,26,51,0.5098039215686274,1
35,80,0.438,7,23,0.304,17,23,0.739,7,33,40,19,7,4,17,22,28,57,0.49122807017543857,0
45,80,0.563,15,33,0.455,26,34,0.765,8,33,41,28,8,1,10,24,30,47,0.6382978723404256,1
35,82,0.427,11,30,0.367,32,35,0.914,11,31,42,26,7,5,11,21,24,52,0.46153846153846156,0
42,108,0.389,17,48,0.354,8,12,0.667,18,36,54,29,11,2,12,26,25,60,0.4166666666666667,0
33,75,0.44,12,34,0.353,35,44,0.795,9,46,55,20,7,9,17,17,21,41,0.5121951219512195,1
41,93,0.441,14,41,0.341,14,18,0.778,13,36,49,28,7,6,14,26,27,52,0.5192307692307693,1
32,83,0.386,13,38,0.342,21,36,0.583,10,32,42,22,4,7,11,19,19,45,0.4222222222222222,0
37,90,0.411,16,37,0.432,11,17,0.647,11,21,32,27,9,1,10,22,21,53,0.39622641509433965,0
49,84,0.583,15,36,0.417,24,32,0.75,16,39,55,29,7,10,13,13,34,48,0.7083333333333334,1
38,95,0.4,15,48,0.313,10,13,0.769,8,35,43,27,6,4,16,22,23,47,0.48936170212765956,0
48,92,0.522,12,34,0.353,20,27,0.741,10,46,56,29,9,10,12,17,36,58,0.6206896551724138,1
42,89,0.472,11,28,0.393,14,19,0.737,10,24,34,30,8,3,13,21,31,61,0.5081967213114754,0
44,80,0.55,12,30,0.4,22,25,0.88,8,35,43,27,7,2,19,22,32,50,0.64,1
37,83,0.446,9,32,0.281,29,38,0.763,8,34,42,14,8,4,19,13,28,51,0.5490196078431373,0
51,97,0.526,16,32,0.5,10,10,1.0,9,36,45,39,10,5,15,26,35,65,0.5384615384615384,1
43,87,0.494,21,50,0.42,14,19,0.737,8,36,44,30,8,4,16,15,22,37,0.5945945945945946,0
49,97,0.505,14,38,0.368,15,21,0.714,14,34,48,27,13,5,11,19,35,59,0.5932203389830508,1
43,89,0.483,10,28,0.357,25,34,0.735,8,37,45,31,5,5,12,22,33,61,0.5409836065573771,0
41,96,0.427,20,53,0.377,25,31,0.806,13,34,47,25,8,2,11,29,21,43,0.4883720930232558,1
36,69,0.522,11,31,0.355,11,13,0.846,3,24,27,28,10,4,22,27,25,38,0.6578947368421053,0
44,93,0.473,13,37,0.351,26,31,0.839,23,26,49,31,15,1,12,14,31,56,0.5535714285714286,1
37,75,0.493,19,36,0.528,21,25,0.84,6,31,37,26,7,3,17,18,18,39,0.46153846153846156,0
45,91,0.495,15,33,0.455,14,18,0.778,12,29,41,22,7,4,11,17,30,58,0.5172413793103449,1
40,82,0.488,8,27,0.296,19,24,0.792,10,21,31,19,4,4,9,20,32,55,0.5818181818181818,0
43,92,0.467,12,32,0.375,20,21,0.952,13,32,45,30,5,8,11,20,31,60,0.5166666666666667,1
52,86,0.605,19,40,0.475,10,10,1.0,8,30,38,34,7,4,11,21,33,46,0.717391304347826,1
44,82,0.537,13,24,0.542,16,20,0.8,6,25,31,25,7,1,12,12,31,58,0.5344827586206896,0
31,83,0.373,7,32,0.219,9,12,0.75,5,24,29,20,9,2,17,23,24,51,0.47058823529411764,0
42,79,0.532,20,45,0.444,24,31,0.774,9,42,51,25,9,5,15,19,22,34,0.6470588235294118,1
50,101,0.495,11,37,0.297,20,23,0.87,10,41,51,29,7,1,8,20,39,64,0.609375,1
35,90,0.389,10,48,0.208,21,23,0.913,9,34,43,27,6,5,14,22,25,42,0.5952380952380952,0
40,88,0.455,6,29,0.207,15,19,0.789,9,35,44,21,5,3,14,26,34,59,0.576271186440678,0
41,82,0.5,9,31,0.29,29,39,0.744,7,38,45,23,8,4,10,17,32,51,0.6274509803921569,1
42,88,0.477,8,34,0.235,17,19,0.895,13,30,43,17,9,0,15,23,34,54,0.6296296296296297,0
40,72,0.556,11,26,0.423,22,28,0.786,4,29,33,20,9,1,17,17,29,46,0.6304347826086957,1
43,81,0.531,10,29,0.345,19,24,0.792,7,34,41,24,6,3,19,19,33,52,0.6346153846153846,0
44,96,0.458,7,29,0.241,22,23,0.957,13,28,41,20,13,4,10,18,37,67,0.5522388059701493,1
46,92,0.5,6,19,0.316,13,15,0.867,11,35,46,27,7,3,13,25,40,73,0.547945205479452,1
35,88,0.398,11,38,0.289,24,33,0.727,15,29,44,20,8,4,11,18,24,50,0.48,0
41,88,0.466,16,39,0.41,16,20,0.8,10,32,42,27,13,3,10,19,25,49,0.5102040816326531,1
35,69,0.507,9,28,0.321,13,17,0.765,2,35,37,21,5,5,22,19,26,41,0.6341463414634146,0
38,86,0.442,7,28,0.25,15,24,0.625,7,35,42,24,12,2,13,16,31,58,0.5344827586206896,0
42,86,0.488,21,43,0.488,12,15,0.8,10,38,48,29,7,3,17,22,21,43,0.4883720930232558,1
41,91,0.451,6,30,0.2,26,35,0.743,9,20,29,23,10,3,16,22,35,61,0.5737704918032787,0
53,90,0.589,18,35,0.514,17,23,0.739,13,35,48,41,6,9,19,24,35,55,0.6363636363636364,1
41,78,0.526,10,23,0.435,28,36,0.778,7,24,31,28,8,6,17,22,31,55,0.5636363636363636,0
50,90,0.556,12,34,0.353,21,27,0.778,14,28,42,37,14,3,15,24,38,56,0.6785714285714286,1
33,81,0.407,8,32,0.25,26,33,0.788,13,38,51,23,8,1,12,22,25,49,0.5102040816326531,1
32,80,0.4,10,31,0.323,20,27,0.741,4,37,41,19,5,3,12,24,22,49,0.4489795918367347,0
47,104,0.452,19,46,0.413,13,19,0.684,11,19,30,32,16,1,7,23,28,58,0.4827586206896552,0
52,81,0.642,8,22,0.364,22,25,0.88,8,42,50,30,5,6,21,16,44,59,0.7457627118644068,1
42,94,0.447,8,23,0.348,16,26,0.615,17,26,43,25,12,3,11,16,34,71,0.4788732394366197,0
48,89,0.539,18,33,0.545,10,14,0.714,11,37,48,34,6,9,20,20,30,56,0.5357142857142857,1
39,88,0.443,12,30,0.4,25,32,0.781,8,33,41,27,7,2,12,14,27,58,0.46551724137931033,0
51,94,0.543,19,38,0.5,12,17,0.706,10,38,48,39,5,5,12,26,32,56,0.5714285714285714,1
43,89,0.483,11,31,0.355,23,23,1.0,7,28,35,26,15,3,8,17,32,58,0.5517241379310345,0
46,85,0.541,20,36,0.556,18,23,0.783,10,33,43,34,5,3,16,16,26,49,0.5306122448979592,1
44,94,0.468,16,43,0.372,42,47,0.894,13,37,50,26,4,6,13,24,28,51,0.5490196078431373,1
49,100,0.49,15,47,0.319,28,36,0.778,11,34,45,33,10,7,14,34,34,53,0.6415094339622641,0
45,87,0.517,21,38,0.553,19,24,0.792,13,37,50,29,4,4,13,19,24,49,0.4897959183673469,1
41,89,0.461,17,46,0.37,15,20,0.75,6,28,34,24,4,4,8,19,24,43,0.5581395348837209,0
37,98,0.378,9,34,0.265,5,9,0.556,12,28,40,17,6,2,10,16,28,64,0.4375,0
54,97,0.557,18,35,0.514,12,14,0.857,12,45,57,34,4,8,9,11,36,62,0.5806451612903226,1
54,99,0.545,18,48,0.375,13,13,1.0,14,42,56,34,5,2,15,20,36,51,0.7058823529411765,1
39,102,0.382,15,47,0.319,17,27,0.63,19,26,45,27,11,6,10,16,24,55,0.43636363636363634,0
44,83,0.53,10,21,0.476,26,33,0.788,16,32,48,22,9,3,23,22,34,62,0.5483870967741935,1
46,91,0.505,11,31,0.355,17,22,0.773,9,23,32,30,7,9,13,23,35,60,0.5833333333333334,0
49,81,0.605,19,33,0.576,11,13,0.846,7,34,41,33,5,2,17,15,30,48,0.625,1
42,99,0.424,14,40,0.35,9,12,0.75,18,24,42,24,10,0,12,17,28,59,0.4745762711864407,0
36,92,0.391,12,42,0.286,10,11,0.909,9,34,43,27,10,2,14,17,24,50,0.48,0
40,87,0.46,15,43,0.349,10,12,0.833,10,38,48,32,6,5,17,17,25,44,0.5681818181818182,1
40,94,0.426,19,50,0.38,12,16,0.75,10,37,47,20,5,4,10,13,21,44,0.4772727272727273,0
45,91,0.495,23,58,0.397,12,14,0.857,6,42,48,33,4,3,10,16,22,33,0.6666666666666666,1
38,83,0.458,11,34,0.324,19,29,0.655,15,27,42,26,4,4,20,16,27,49,0.5510204081632653,0
46,88,0.523,5,25,0.2,21,23,0.913,10,32,42,25,13,6,11,23,41,63,0.6507936507936508,1
40,76,0.526,14,26,0.538,22,30,0.733,2,38,40,26,9,7,15,18,26,50,0.52,1
42,103,0.408,14,47,0.298,11,15,0.733,18,32,50,27,9,7,11,25,28,56,0.5,0
37,82,0.451,9,36,0.25,28,38,0.737,15,45,60,23,8,6,17,16,28,46,0.6086956521739131,1
31,83,0.373,9,34,0.265,9,12,0.75,5,27,32,21,11,8,16,27,22,49,0.4489795918367347,0
41,92,0.446,9,26,0.346,17,20,0.85,10,30,40,26,9,2,15,21,32,66,0.48484848484848486,0
45,84,0.536,9,28,0.321,16,24,0.667,10,33,43,33,9,9,14,20,36,56,0.6428571428571429,1
34,78,0.436,16,35,0.457,20,27,0.741,7,32,39,19,5,5,17,28,18,43,0.4186046511627907,0
36,83,0.434,14,35,0.4,23,37,0.622,12,37,49,19,10,2,11,26,22,48,0.4583333333333333,1
34,90,0.378,13,41,0.317,22,29,0.759,11,30,41,22,4,4,14,24,21,49,0.42857142857142855,0
49,94,0.521,16,32,0.5,18,25,0.72,12,42,54,31,5,6,10,25,33,62,0.532258064516129,1
37,91,0.407,13,34,0.382,16,22,0.727,8,26,34,19,4,3,6,20,24,57,0.42105263157894735,0
44,81,0.543,8,20,0.4,17,23,0.739,8,45,53,25,4,7,13,22,36,61,0.5901639344262295,1
39,80,0.488,9,31,0.29,20,22,0.909,10,32,42,15,5,3,13,19,30,49,0.6122448979591837,1
37,81,0.457,13,36,0.361,14,17,0.824,8,28,36,23,8,4,11,20,24,45,0.5333333333333333,0
43,88,0.489,6,22,0.273,13,25,0.52,17,37,54,20,2,3,8,26,37,66,0.5606060606060606,1
35,85,0.412,9,36,0.25,22,34,0.647,12,33,45,20,7,3,7,21,26,49,0.5306122448979592,0
36,83,0.434,7,22,0.318,20,23,0.87,13,40,53,15,3,5,15,25,29,61,0.47540983606557374,1
29,76,0.382,9,32,0.281,26,34,0.765,7,27,34,17,8,4,7,22,20,44,0.45454545454545453,0
43,93,0.462,11,35,0.314,10,13,0.769,9,26,35,26,8,3,11,22,32,58,0.5517241379310345,0
43,82,0.524,16,35,0.457,21,29,0.724,10,31,41,33,5,8,13,22,27,47,0.574468085106383,1
45,90,0.5,16,41,0.39,24,27,0.889,11,35,46,32,5,7,19,32,29,49,0.5918367346938775,1
39,86,0.453,7,27,0.259,32,43,0.744,8,27,35,25,7,8,12,24,32,59,0.5423728813559322,0
40,82,0.488,12,30,0.4,19,23,0.826,7,28,35,27,1,8,8,26,28,52,0.5384615384615384,0
43,84,0.512,16,32,0.5,29,34,0.853,10,29,39,29,6,4,4,18,27,52,0.5192307692307693,1
42,78,0.538,11,24,0.458,19,24,0.792,5,24,29,20,12,6,16,26,31,54,0.5740740740740741,0
42,89,0.472,12,33,0.364,19,24,0.792,14,29,43,24,12,5,15,24,30,56,0.5357142857142857,1
29,75,0.387,10,36,0.278,23,27,0.852,8,30,38,16,8,2,18,19,19,39,0.48717948717948717,0
43,82,0.524,18,38,0.474,11,18,0.611,4,36,40,35,12,3,15,22,25,44,0.5681818181818182,1
31,96,0.323,7,37,0.189,17,19,0.895,16,37,53,17,10,3,11,22,24,59,0.4067796610169492,0
34,84,0.405,10,38,0.263,15,23,0.652,11,47,58,19,4,6,21,21,24,46,0.5217391304347826,1
36,95,0.379,9,23,0.391,18,26,0.692,25,30,55,20,4,2,14,18,27,72,0.375,0
42,78,0.538,10,28,0.357,16,21,0.762,5,30,35,25,6,9,10,23,32,50,0.64,1
38,82,0.463,11,29,0.379,17,20,0.85,11,39,50,19,2,4,10,19,27,53,0.5094339622641509,0
39,83,0.47,22,47,0.468,10,13,0.769,2,29,31,22,5,2,3,19,17,36,0.4722222222222222,1
37,87,0.425,13,36,0.361,19,21,0.905,17,30,47,20,4,4,18,25,24,51,0.47058823529411764,0
46,84,0.548,17,40,0.425,17,24,0.708,6,29,35,27,10,8,9,20,29,44,0.6590909090909091,1
38,89,0.427,11,32,0.344,10,12,0.833,13,22,35,16,7,4,11,24,27,57,0.47368421052631576,0
36,69,0.522,14,30,0.467,26,30,0.867,7,34,41,20,5,12,16,18,22,39,0.5641025641025641,1
30,76,0.395,11,38,0.289,25,28,0.893,4,36,40,16,5,9,20,28,19,38,0.5,0
44,92,0.478,11,34,0.324,25,32,0.781,14,34,48,29,9,1,12,22,33,58,0.5689655172413793,1
41,87,0.471,12,40,0.3,11,14,0.786,7,33,40,21,6,2,19,26,29,47,0.6170212765957447,0
38,79,0.481,14,36,0.389,25,29,0.862,4,30,34,21,9,6,15,24,24,43,0.5581395348837209,1
46,84,0.548,17,30,0.567,16,20,0.8,11,32,43,32,7,6,17,20,29,54,0.5370370370370371,1
43,86,0.5,13,35,0.371,15,18,0.833,8,25,33,26,9,3,13,18,30,51,0.5882352941176471,0
35,76,0.461,10,21,0.476,27,34,0.794,9,27,36,16,8,8,14,28,25,55,0.45454545454545453,0
39,75,0.52,11,31,0.355,25,31,0.806,7,29,36,27,7,4,14,27,28,44,0.6363636363636364,1
44,89,0.494,12,25,0.48,14,15,0.933,6,37,43,25,7,5,13,20,32,64,0.5,1
38,82,0.463,14,36,0.389,20,31,0.645,9,35,44,27,4,6,15,17,24,46,0.5217391304347826,0
38,74,0.514,13,31,0.419,15,20,0.75,9,37,46,18,5,3,24,21,25,43,0.5813953488372093,1
38,86,0.442,13,35,0.371,12,18,0.667,9,23,32,23,9,4,11,21,25,51,0.49019607843137253,0
41,74,0.554,18,40,0.45,18,28,0.643,4,26,30,29,7,6,16,25,23,34,0.6764705882352942,1
40,80,0.5,11,26,0.423,22,27,0.815,11,33,44,25,9,3,18,26,29,54,0.5370370370370371,0
35,83,0.422,14,37,0.378,20,31,0.645,13,35,48,22,7,9,18,20,21,46,0.45652173913043476,1
33,85,0.388,12,35,0.343,17,23,0.739,9,32,41,21,11,11,17,28,21,50,0.42,0
41,83,0.494,18,42,0.429,26,31,0.839,6,26,32,24,10,1,9,32,23,41,0.5609756097560976,1
39,69,0.565,9,28,0.321,31,33,0.939,1,31,32,20,2,4,14,28,30,41,0.7317073170731707,0
41,93,0.441,14,45,0.311,14,17,0.824,11,34,45,30,6,3,15,23,27,48,0.5625,0
41,80,0.513,12,32,0.375,17,21,0.81,5,31,36,23,5,3,11,20,29,48,0.6041666666666666,1
43,91,0.473,15,41,0.366,10,14,0.714,9,46,55,27,8,6,10,15,28,50,0.56,1
33,84,0.393,9,34,0.265,6,10,0.6,5,38,43,22,5,2,13,15,24,50,0.48,0
44,87,0.506,4,26,0.154,22,27,0.815,9,26,35,26,8,3,6,21,40,61,0.6557377049180327,1
38,79,0.481,11,32,0.344,24,31,0.774,11,34,45,17,4,5,15,28,27,47,0.574468085106383,0
42,84,0.5,12,39,0.308,13,14,0.929,13,21,34,26,13,3,14,19,30,45,0.6666666666666666,1
39,77,0.506,12,29,0.414,13,16,0.813,12,21,33,25,7,5,21,22,27,48,0.5625,0
42,86,0.488,15,32,0.469,19,25,0.76,6,33,39,31,9,4,19,33,27,54,0.5,0
35,74,0.473,18,36,0.5,31,40,0.775,6,28,34,23,7,8,16,23,17,38,0.4473684210526316,1
34,80,0.425,13,31,0.419,21,25,0.84,6,35,41,24,4,5,16,26,21,49,0.42857142857142855,0
37,88,0.42,8,34,0.235,28,35,0.8,13,33,46,19,9,6,11,20,29,54,0.5370370370370371,1
33,77,0.429,15,44,0.341,18,23,0.783,7,36,43,15,4,2,12,29,18,33,0.5454545454545454,0
32,79,0.405,10,35,0.286,26,42,0.619,13,33,46,17,4,3,8,21,22,44,0.5,1
40,92,0.435,13,42,0.31,17,21,0.81,15,33,48,22,8,1,7,23,27,50,0.54,1
30,75,0.4,15,42,0.357,11,20,0.55,11,30,41,18,2,3,15,21,15,33,0.45454545454545453,0
45,86,0.523,17,33,0.515,12,18,0.667,5,46,51,21,6,4,15,23,28,53,0.5283018867924528,1
35,90,0.389,9,36,0.25,16,17,0.941,8,36,44,27,5,3,12,18,26,54,0.48148148148148145,0
43,86,0.5,12,34,0.353,23,32,0.719,9,27,36,26,15,3,17,27,31,52,0.5961538461538461,0
41,73,0.562,15,31,0.484,29,36,0.806,5,28,33,28,9,2,20,31,26,42,0.6190476190476191,1
43,85,0.506,7,27,0.259,10,15,0.667,12,27,39,33,6,3,13,28,36,58,0.6206896551724138,0
40,85,0.471,6,24,0.25,32,42,0.762,19,29,48,20,8,3,9,16,34,61,0.5573770491803278,1
42,89,0.472,14,35,0.4,18,22,0.818,10,35,45,26,3,4,13,28,28,54,0.5185185185185185,1
41,81,0.506,13,35,0.371,17,29,0.586,8,30,38,28,5,7,10,23,28,46,0.6086956521739131,0
29,77,0.377,3,30,0.1,16,21,0.762,7,33,40,12,8,2,13,24,26,47,0.5531914893617021,0
37,85,0.435,12,43,0.279,16,21,0.762,11,38,49,16,6,1,11,18,25,42,0.5952380952380952,1
42,82,0.512,8,31,0.258,11,13,0.846,3,37,40,24,8,6,9,20,34,51,0.6666666666666666,1
31,81,0.383,10,37,0.27,16,20,0.8,8,29,37,21,7,1,16,17,21,44,0.4772727272727273,0
37,83,0.446,14,33,0.424,21,24,0.875,6,36,42,23,9,7,23,29,23,50,0.46,0
39,94,0.415,7,28,0.25,26,39,0.667,18,35,53,24,10,7,16,19,32,66,0.48484848484848486,1
31,74,0.419,8,25,0.32,24,28,0.857,12,30,42,15,8,2,19,22,23,49,0.46938775510204084,0
37,82,0.451,7,31,0.226,16,21,0.762,7,26,33,19,12,2,14,25,30,51,0.5882352941176471,1
32,80,0.4,5,25,0.2,28,35,0.8,13,34,47,14,6,5,15,20,27,55,0.4909090909090909,0
43,86,0.5,10,27,0.37,16,20,0.8,6,34,40,28,10,4,10,25,33,59,0.559322033898305,1
36,81,0.444,6,29,0.207,20,29,0.69,14,36,50,26,5,5,15,21,30,52,0.5769230769230769,0
37,82,0.451,13,31,0.419,15,21,0.714,6,31,37,28,10,6,10,22,24,51,0.47058823529411764,1
39,92,0.424,15,52,0.288,7,11,0.636,6,31,37,24,12,3,16,18,24,40,0.6,0
43,87,0.494,14,36,0.389,16,20,0.8,7,44,51,23,10,2,16,13,29,51,0.5686274509803921,1
45,75,0.6,8,20,0.4,17,18,0.944,5,27,32,23,8,2,14,21,37,55,0.6727272727272727,1
42,83,0.506,8,24,0.333,17,19,0.895,12,24,36,25,9,0,17,25,34,59,0.576271186440678,0
47,81,0.58,16,40,0.4,22,23,0.957,10,37,47,32,4,4,11,22,31,41,0.7560975609756098,1
35,89,0.393,7,35,0.2,20,25,0.8,15,22,37,15,6,1,10,22,28,54,0.5185185185185185,0
36,80,0.45,17,43,0.395,9,11,0.818,3,34,37,22,6,4,10,19,19,37,0.5135135135135135,1
36,84,0.429,9,35,0.257,15,20,0.75,11,37,48,20,5,4,11,15,27,49,0.5510204081632653,0
40,86,0.465,15,32,0.469,19,24,0.792,16,39,55,24,7,8,19,21,25,54,0.46296296296296297,1
38,84,0.452,12,31,0.387,18,26,0.692,6,31,37,22,12,5,11,21,26,53,0.49056603773584906,0
37,90,0.411,12,34,0.353,15,21,0.714,10,44,54,22,11,5,14,21,25,56,0.44642857142857145,1
28,84,0.333,18,50,0.36,15,20,0.75,10,38,48,21,8,7,18,25,10,34,0.29411764705882354,0
45,93,0.484,14,38,0.368,13,20,0.65,16,36,52,31,10,6,18,25,31,55,0.5636363636363636,1
41,95,0.432,16,40,0.4,18,24,0.75,16,30,46,26,11,6,16,19,25,55,0.45454545454545453,0
34,79,0.43,6,34,0.176,18,20,0.9,9,28,37,18,4,6,15,17,28,45,0.6222222222222222,0
40,92,0.435,9,36,0.25,17,18,0.944,15,32,47,21,5,2,13,18,31,56,0.5535714285714286,1
40,85,0.471,16,39,0.41,18,25,0.72,7,29,36,16,6,2,9,22,24,46,0.5217391304347826,0
46,91,0.505,11,28,0.393,18,18,1.0,13,38,51,27,3,6,10,21,35,63,0.5555555555555556,1
34,73,0.466,3,18,0.167,15,23,0.652,5,32,37,16,4,5,17,19,31,55,0.5636363636363636,0
38,80,0.475,20,43,0.465,13,15,0.867,7,33,40,28,10,5,16,23,18,37,0.4864864864864865,1
40,95,0.421,7,38,0.184,14,18,0.778,14,38,52,27,6,2,18,20,33,57,0.5789473684210527,0
36,91,0.396,14,45,0.311,20,21,0.952,13,36,49,17,13,6,15,23,22,46,0.4782608695652174,1
38,84,0.452,8,30,0.267,19,22,0.864,5,29,34,17,10,4,10,25,30,54,0.5555555555555556,0
40,78,0.513,14,29,0.483,25,31,0.806,8,36,44,25,5,3,14,22,26,49,0.5306122448979592,1
36,79,0.456,17,41,0.415,20,24,0.833,7,18,25,19,7,1,17,26,19,38,0.5,0
49,76,0.645,13,25,0.52,18,21,0.857,4,30,34,28,6,6,17,28,36,51,0.7058823529411765,1
34,76,0.447,13,28,0.464,13,15,0.867,9,36,45,23,5,1,17,14,21,48,0.4375,0
40,90,0.444,13,39,0.333,10,13,0.769,8,28,36,25,12,4,8,19,27,51,0.5294117647058824,1
27,77,0.351,7,30,0.233,18,24,0.75,11,25,36,14,11,1,13,22,20,47,0.425531914893617,0
32,67,0.478,16,33,0.485,19,22,0.864,8,35,43,22,7,3,19,24,16,34,0.47058823529411764,1
40,92,0.435,16,43,0.372,16,21,0.762,7,23,30,21,7,4,12,20,24,49,0.4897959183673469,0
53,85,0.624,17,32,0.531,19,21,0.905,4,34,38,34,5,4,16,24,36,53,0.6792452830188679,1
32,87,0.368,9,33,0.273,28,34,0.824,11,36,47,23,5,13,12,21,23,54,0.42592592592592593,0
40,99,0.404,9,34,0.265,14,17,0.824,13,40,53,20,8,4,12,27,31,65,0.47692307692307695,1
39,84,0.464,9,25,0.36,14,18,0.778,12,32,44,27,4,4,17,25,30,59,0.5084745762711864,0
38,85,0.447,20,44,0.455,15,19,0.789,10,27,37,22,5,1,11,21,18,41,0.43902439024390244,1
38,82,0.463,7,35,0.2,25,28,0.893,5,28,33,24,9,5,13,26,31,47,0.6595744680851063,0
37,68,0.544,16,33,0.485,26,34,0.765,4,28,32,25,5,2,17,24,21,35,0.6,1
40,96,0.417,9,35,0.257,9,15,0.6,10,38,48,25,10,10,12,19,31,61,0.5081967213114754,0
36,90,0.4,9,37,0.243,20,22,0.909,10,44,54,25,6,7,16,15,27,53,0.5094339622641509,1
42,84,0.5,14,37,0.378,18,20,0.9,4,34,38,25,2,4,11,25,28,47,0.5957446808510638,1
39,94,0.415,9,27,0.333,21,27,0.778,13,35,48,18,6,3,8,17,30,67,0.44776119402985076,0
31,85,0.365,9,32,0.281,14,15,0.933,10,26,36,14,8,2,16,19,22,53,0.41509433962264153,0
45,84,0.536,13,33,0.394,17,23,0.739,8,38,46,26,8,4,11,13,32,51,0.6274509803921569,1
27,71,0.38,8,32,0.25,18,27,0.667,6,32,38,9,7,0,18,21,19,39,0.48717948717948717,0
43,87,0.494,12,32,0.375,12,16,0.75,12,38,50,28,10,2,12,23,31,55,0.5636363636363636,1
40,92,0.435,13,29,0.448,17,21,0.81,17,32,49,22,5,5,13,14,27,63,0.42857142857142855,1
42,82,0.512,10,31,0.323,13,15,0.867,5,31,36,25,6,7,10,19,32,51,0.6274509803921569,0
36,80,0.45,14,39,0.359,9,13,0.692,4,33,37,22,3,5,22,23,22,41,0.5365853658536586,0
47,99,0.475,18,41,0.439,22,30,0.733,18,37,55,37,12,4,10,17,29,58,0.5,1
31,78,0.397,6,18,0.333,18,21,0.857,13,32,45,18,3,2,22,27,25,60,0.4166666666666667,0
35,77,0.455,16,39,0.41,27,36,0.75,7,32,39,18,16,4,7,23,19,38,0.5,1
42,87,0.483,7,28,0.25,8,11,0.727,13,36,49,19,7,6,16,12,35,59,0.5932203389830508,1
36,87,0.414,12,37,0.324,6,7,0.857,6,29,35,21,8,6,13,16,24,50,0.48,0
34,96,0.354,15,36,0.417,13,20,0.65,10,34,44,21,8,6,7,12,19,60,0.31666666666666665,0
41,104,0.394,20,53,0.377,8,11,0.727,25,45,70,24,3,10,19,17,21,51,0.4117647058823529,1
38,87,0.437,17,43,0.395,15,23,0.652,8,34,42,22,5,7,8,17,21,44,0.4772727272727273,1
36,88,0.409,7,29,0.241,16,18,0.889,7,42,49,15,5,3,11,25,29,59,0.4915254237288136,0
33,90,0.367,4,33,0.121,11,16,0.688,11,45,56,20,5,5,13,18,29,57,0.5087719298245614,0
37,88,0.42,22,55,0.4,13,18,0.722,8,40,48,29,5,7,14,19,15,33,0.45454545454545453,1
46,81,0.568,19,39,0.487,12,12,1.0,6,37,43,14,9,6,12,17,27,42,0.6428571428571429,1
33,87,0.379,12,34,0.353,12,18,0.667,15,24,39,22,8,4,12,18,21,53,0.39622641509433965,0
36,79,0.456,11,34,0.324,24,32,0.75,8,30,38,22,8,8,16,23,25,45,0.5555555555555556,0
39,80,0.488,10,30,0.333,30,34,0.882,9,30,39,18,10,12,13,24,29,50,0.58,1
31,86,0.36,11,48,0.229,14,21,0.667,9,26,35,14,7,1,13,17,20,38,0.5263157894736842,0
46,82,0.561,10,29,0.345,10,16,0.625,7,44,51,24,8,7,15,22,36,53,0.6792452830188679,1
43,84,0.512,20,40,0.5,21,23,0.913,8,33,41,28,8,5,10,21,23,44,0.5227272727272727,1
38,86,0.442,10,34,0.294,16,22,0.727,12,30,42,21,4,3,15,18,28,52,0.5384615384615384,0
37,78,0.474,21,45,0.467,22,29,0.759,4,26,30,22,7,5,12,20,16,33,0.48484848484848486,0
46,82,0.561,14,28,0.5,20,25,0.8,8,35,43,33,4,2,16,26,32,54,0.5925925925925926,1
43,92,0.467,11,33,0.333,12,14,0.857,8,26,34,22,19,4,9,24,32,59,0.5423728813559322,1
34,70,0.486,12,32,0.375,23,30,0.767,9,35,44,21,2,7,24,21,22,38,0.5789473684210527,0
38,81,0.469,11,32,0.344,22,25,0.88,14,33,47,28,5,1,13,23,27,49,0.5510204081632653,1
30,75,0.4,13,45,0.289,27,34,0.794,7,26,33,18,4,2,9,18,17,30,0.5666666666666667,0
30,90,0.333,14,36,0.389,8,14,0.571,10,29,39,22,4,2,9,26,16,54,0.2962962962962963,0
31,78,0.397,8,34,0.235,32,38,0.842,14,46,60,21,4,11,11,15,23,44,0.5227272727272727,1
41,84,0.488,10,28,0.357,17,26,0.654,6,36,42,26,5,4,8,18,31,56,0.5535714285714286,0
41,82,0.5,20,43,0.465,17,22,0.773,4,41,45,30,4,6,8,19,21,39,0.5384615384615384,1
33,71,0.465,10,33,0.303,17,23,0.739,6,40,46,24,5,7,15,19,23,38,0.6052631578947368,1
30,94,0.319,7,45,0.156,13,14,0.929,19,30,49,14,7,2,12,19,23,49,0.46938775510204084,0
37,82,0.451,17,42,0.405,19,25,0.76,6,28,34,22,6,4,8,18,20,40,0.5,0
45,88,0.511,14,36,0.389,16,16,1.0,14,37,51,36,6,3,11,20,31,52,0.5961538461538461,1
36,78,0.462,15,35,0.429,24,25,0.96,11,26,37,25,10,2,19,27,21,43,0.4883720930232558,1
32,72,0.444,11,33,0.333,28,31,0.903,6,28,34,22,10,4,18,28,21,39,0.5384615384615384,0
35,85,0.412,11,32,0.344,19,24,0.792,10,41,51,22,4,6,13,26,24,53,0.4528301886792453,1
37,88,0.42,6,30,0.2,16,24,0.667,7,37,44,16,4,5,10,18,31,58,0.5344827586206896,0
43,85,0.506,21,41,0.512,13,16,0.813,7,32,39,33,7,6,13,13,22,44,0.5,1
39,88,0.443,19,45,0.422,11,15,0.733,12,27,39,24,8,6,14,16,20,43,0.46511627906976744,0
30,80,0.375,15,37,0.405,13,17,0.765,6,37,43,24,5,7,19,18,15,43,0.3488372093023256,0
39,86,0.453,15,37,0.405,14,20,0.7,6,36,42,25,15,2,12,17,24,49,0.4897959183673469,1
36,78,0.462,15,40,0.375,13,15,0.867,6,25,31,22,7,5,17,23,21,38,0.5526315789473685,0
43,89,0.483,13,35,0.371,17,24,0.708,15,32,47,28,7,7,12,17,30,54,0.5555555555555556,1
40,91,0.44,15,43,0.349,12,15,0.8,16,39,55,20,10,5,16,21,25,48,0.5208333333333334,1
34,85,0.4,15,38,0.395,14,19,0.737,11,31,42,22,8,6,16,17,19,47,0.40425531914893614,0
31,75,0.413,11,32,0.344,21,31,0.677,8,39,47,18,2,2,18,16,20,43,0.46511627906976744,0
41,88,0.466,9,40,0.225,13,15,0.867,4,35,39,23,9,2,7,28,32,48,0.6666666666666666,1
38,92,0.413,19,46,0.413,8,8,1.0,15,29,44,27,13,7,17,20,19,46,0.41304347826086957,1
34,80,0.425,11,28,0.393,11,12,0.917,11,30,41,27,8,8,23,16,23,52,0.4423076923076923,0
40,80,0.5,13,34,0.382,24,28,0.857,4,27,31,16,8,3,14,25,27,46,0.5869565217391305,0
46,82,0.561,12,35,0.343,22,28,0.786,6,30,36,24,8,3,11,24,34,47,0.723404255319149,1
40,94,0.426,10,40,0.25,19,25,0.76,9,39,48,23,12,4,22,18,30,54,0.5555555555555556,0
45,99,0.455,16,45,0.356,17,23,0.739,11,37,48,31,11,4,18,23,29,54,0.5370370370370371,1
42,98,0.429,9,35,0.257,14,15,0.933,15,39,54,25,4,3,16,20,33,63,0.5238095238095238,0
45,90,0.5,7,25,0.28,20,24,0.833,4,34,38,30,12,5,9,18,38,65,0.5846153846153846,1
50,102,0.49,12,26,0.462,18,25,0.72,21,40,61,31,9,4,13,21,38,76,0.5,1
40,89,0.449,10,33,0.303,18,24,0.75,9,30,39,22,10,10,16,25,30,56,0.5357142857142857,0
42,86,0.488,11,30,0.367,14,19,0.737,10,38,48,21,5,5,18,24,31,56,0.5535714285714286,0
40,94,0.426,14,38,0.368,19,24,0.792,12,29,41,31,11,4,13,21,26,56,0.4642857142857143,1
42,92,0.457,11,31,0.355,19,24,0.792,14,39,53,21,5,10,17,19,31,61,0.5081967213114754,1
39,97,0.402,15,42,0.357,14,21,0.667,12,30,42,21,7,5,15,20,24,55,0.43636363636363634,0
44,109,0.404,9,37,0.243,15,18,0.833,18,36,54,28,7,5,12,26,35,72,0.4861111111111111,0
42,108,0.389,17,50,0.34,14,23,0.609,20,44,64,27,6,7,14,17,25,58,0.43103448275862066,1
41,93,0.441,13,36,0.361,21,28,0.75,12,34,46,23,12,6,15,26,28,57,0.49122807017543857,1
37,80,0.463,12,28,0.429,22,28,0.786,8,38,46,21,6,2,19,24,25,52,0.4807692307692308,0
38,99,0.384,14,45,0.311,18,22,0.818,16,41,57,22,6,6,14,26,24,54,0.4444444444444444,0
39,94,0.415,10,38,0.263,27,33,0.818,14,41,55,25,6,5,14,21,29,56,0.5178571428571429,1
35,75,0.467,14,35,0.4,21,34,0.618,5,35,40,17,6,4,12,22,21,40,0.525,0
40,85,0.471,8,22,0.364,19,22,0.864,8,32,40,25,4,5,12,29,32,63,0.5079365079365079,1
39,88,0.443,11,28,0.393,26,33,0.788,11,33,44,20,11,2,11,17,28,60,0.4666666666666667,1
39,85,0.459,17,44,0.386,13,19,0.684,4,37,41,27,8,5,16,25,22,41,0.5365853658536586,0
48,94,0.511,13,29,0.448,20,23,0.87,14,37,51,26,7,10,15,20,35,65,0.5384615384615384,1
40,99,0.404,7,34,0.206,15,21,0.714,14,30,44,22,8,8,15,19,33,65,0.5076923076923077,0
38,77,0.494,10,28,0.357,19,23,0.826,6,32,38,25,5,5,17,21,28,49,0.5714285714285714,0
36,86,0.419,13,30,0.433,23,32,0.719,12,29,41,19,15,4,13,23,23,56,0.4107142857142857,1
40,83,0.482,5,22,0.227,17,18,0.944,10,25,35,21,10,3,21,23,35,61,0.5737704918032787,0
42,83,0.506,16,38,0.421,23,31,0.742,11,32,43,27,10,1,20,21,26,45,0.5777777777777777,1
37,80,0.463,9,29,0.31,20,31,0.645,10,48,58,18,7,7,23,24,28,51,0.5490196078431373,1
33,94,0.351,9,45,0.2,22,26,0.846,8,30,38,23,13,5,10,24,24,49,0.4897959183673469,0
34,84,0.405,13,42,0.31,9,14,0.643,7,41,48,24,4,6,14,16,21,42,0.5,1
36,83,0.434,5,24,0.208,11,13,0.846,6,38,44,17,6,5,10,14,31,59,0.5254237288135594,0
33,80,0.413,8,34,0.235,24,30,0.8,10,34,44,16,9,7,19,19,25,46,0.5434782608695652,0
40,89,0.449,13,31,0.419,15,16,0.938,9,37,46,26,10,2,17,22,27,58,0.46551724137931033,1
41,84,0.488,11,28,0.393,12,18,0.667,8,33,41,25,9,4,15,21,30,56,0.5357142857142857,0
38,80,0.475,13,35,0.371,20,29,0.69,13,31,44,26,3,13,13,19,25,45,0.5555555555555556,1
42,89,0.472,8,22,0.364,32,37,0.865,15,38,53,23,9,7,16,14,34,67,0.5074626865671642,1
44,97,0.454,13,34,0.382,11,14,0.786,11,26,37,30,9,4,14,24,31,63,0.49206349206349204,0
46,86,0.535,15,34,0.441,21,25,0.84,12,29,41,30,10,2,20,22,31,52,0.5961538461538461,1
42,88,0.477,15,44,0.341,24,27,0.889,7,28,35,34,10,3,19,23,27,44,0.6136363636363636,0
45,98,0.459,19,42,0.452,20,29,0.69,17,33,50,26,8,10,12,21,26,56,0.4642857142857143,1
44,93,0.473,16,35,0.457,18,30,0.6,13,32,45,18,4,6,14,22,28,58,0.4827586206896552,0
44,81,0.543,17,31,0.548,32,44,0.727,7,30,37,34,9,4,17,22,27,50,0.54,1
51,104,0.49,11,35,0.314,21,22,0.955,14,28,42,32,8,6,16,34,40,69,0.5797101449275363,0
41,79,0.519,14,33,0.424,15,15,1.0,12,31,43,17,4,11,20,23,27,46,0.5869565217391305,1
42,92,0.457,8,26,0.308,12,15,0.8,11,25,36,23,8,3,10,18,34,66,0.5151515151515151,0
49,111,0.441,20,50,0.4,14,21,0.667,19,35,54,39,11,8,13,23,29,61,0.47540983606557374,1
49,107,0.458,11,33,0.333,17,23,0.739,21,39,60,20,5,7,20,22,38,74,0.5135135135135135,0
39,90,0.433,9,36,0.25,19,32,0.594,13,36,49,26,6,2,15,21,30,54,0.5555555555555556,0
50,95,0.526,16,38,0.421,14,22,0.636,11,39,50,29,4,6,12,26,34,57,0.5964912280701754,1
43,94,0.457,10,27,0.37,15,21,0.714,9,32,41,31,14,1,17,29,33,67,0.4925373134328358,0
36,82,0.439,10,29,0.345,31,36,0.861,13,35,48,14,8,5,21,19,26,53,0.49056603773584906,1
33,79,0.418,7,27,0.259,27,33,0.818,10,28,38,19,8,3,13,15,26,52,0.5,0
41,80,0.513,10,26,0.385,10,11,0.909,5,34,39,26,8,8,17,22,31,54,0.5740740740740741,1
48,85,0.565,16,27,0.593,16,18,0.889,8,40,48,32,4,5,18,17,32,58,0.5517241379310345,1
34,84,0.405,7,29,0.241,21,25,0.84,10,25,35,19,12,7,10,19,27,55,0.4909090909090909,0
34,79,0.43,9,33,0.273,19,24,0.792,6,23,29,20,4,8,18,29,25,46,0.5434782608695652,0
45,90,0.5,17,39,0.436,30,36,0.833,15,37,52,23,7,7,15,24,28,51,0.5490196078431373,1
42,94,0.447,15,38,0.395,18,23,0.783,10,37,47,29,10,5,13,27,27,56,0.48214285714285715,0
42,85,0.494,20,38,0.526,18,31,0.581,9,37,46,33,5,6,18,21,22,47,0.46808510638297873,1
37,95,0.389,18,42,0.429,23,30,0.767,17,36,53,26,5,3,14,20,19,53,0.3584905660377358,0
45,103,0.437,16,42,0.381,18,24,0.75,20,39,59,28,7,15,11,21,29,61,0.47540983606557374,1
37,87,0.425,14,39,0.359,21,28,0.75,8,29,37,24,9,5,6,25,23,48,0.4791666666666667,0
38,76,0.5,11,30,0.367,25,27,0.926,6,38,44,28,2,2,16,26,27,46,0.5869565217391305,1
36,93,0.387,16,37,0.432,17,22,0.773,15,32,47,20,9,6,14,22,20,56,0.35714285714285715,0
48,85,0.565,16,31,0.516,13,21,0.619,8,39,47,29,6,10,16,22,32,54,0.5925925925925926,1
42,87,0.483,19,47,0.404,23,28,0.821,7,30,37,24,5,6,8,21,23,40,0.575,1
45,95,0.474,15,34,0.441,15,23,0.652,12,36,48,21,5,7,9,24,30,61,0.4918032786885246,0
43,89,0.483,16,38,0.421,12,15,0.8,12,31,43,27,5,7,14,20,27,51,0.5294117647058824,1
37,84,0.44,10,31,0.323,21,28,0.75,12,28,40,26,6,5,12,15,27,53,0.5094339622641509,0
41,81,0.506,9,22,0.409,20,22,0.909,5,35,40,24,8,3,13,21,32,59,0.5423728813559322,1
40,85,0.471,14,35,0.4,15,26,0.577,9,30,39,24,5,5,12,21,26,50,0.52,0
47,90,0.522,11,26,0.423,21,30,0.7,14,38,52,28,7,6,14,24,36,64,0.5625,1
39,95,0.411,8,35,0.229,23,28,0.821,16,29,45,23,8,9,12,21,31,60,0.5166666666666667,0
43,87,0.494,12,28,0.429,9,15,0.6,4,31,35,25,9,4,20,24,31,59,0.5254237288135594,0
41,96,0.427,13,33,0.394,22,25,0.88,16,32,48,19,10,5,13,20,28,63,0.4444444444444444,1
47,100,0.47,11,43,0.256,20,25,0.8,13,38,51,31,10,2,16,29,36,57,0.631578947368421,0
45,87,0.517,14,33,0.424,26,36,0.722,6,31,37,24,7,5,13,21,31,54,0.5740740740740741,1
43,93,0.462,15,42,0.357,11,12,0.917,13,36,49,29,5,3,13,18,28,51,0.5490196078431373,1
36,82,0.439,9,32,0.281,14,20,0.7,9,34,43,16,10,0,15,18,27,50,0.54,0
37,84,0.44,10,27,0.37,22,27,0.815,13,39,52,19,6,5,19,20,27,57,0.47368421052631576,1
41,92,0.446,6,33,0.182,16,20,0.8,10,30,40,26,9,9,13,24,35,59,0.5932203389830508,0
43,98,0.439,13,38,0.342,23,28,0.821,15,29,44,29,13,6,17,20,30,60,0.5,1
48,102,0.471,8,27,0.296,17,22,0.773,14,31,45,30,8,6,17,22,40,75,0.5333333333333333,0
46,88,0.523,10,34,0.294,14,22,0.636,12,42,54,24,9,3,15,17,36,54,0.6666666666666666,1
41,94,0.436,9,41,0.22,15,21,0.714,11,31,42,24,7,4,11,15,32,53,0.6037735849056604,0
37,100,0.37,18,48,0.375,10,12,0.833,14,31,45,26,5,7,11,24,19,52,0.36538461538461536,0
42,87,0.483,10,21,0.476,26,29,0.897,14,46,60,29,4,6,14,18,32,66,0.48484848484848486,1
44,93,0.473,11,32,0.344,9,16,0.563,18,31,49,23,8,10,20,27,33,61,0.5409836065573771,0
38,90,0.422,11,35,0.314,27,32,0.844,17,30,47,17,7,7,16,20,27,55,0.4909090909090909,1
47,87,0.54,9,29,0.31,21,26,0.808,9,26,35,27,4,7,11,30,38,58,0.6551724137931034,0
47,94,0.5,16,34,0.471,24,31,0.774,12,26,38,21,7,3,9,22,31,60,0.5166666666666667,1
34,86,0.395,14,32,0.438,16,20,0.8,10,42,52,22,6,6,12,22,20,54,0.37037037037037035,1
29,83,0.349,8,34,0.235,24,27,0.889,8,38,46,19,5,3,12,15,21,49,0.42857142857142855,0
48,105,0.457,12,37,0.324,7,13,0.538,14,36,50,37,11,0,13,21,36,68,0.5294117647058824,1
38,86,0.442,8,31,0.258,22,24,0.917,10,40,50,24,7,5,16,18,30,55,0.5454545454545454,0
36,86,0.419,7,35,0.2,23,27,0.852,13,28,41,14,6,4,13,23,29,51,0.5686274509803921,0
43,93,0.462,11,37,0.297,18,25,0.72,18,32,50,24,7,3,14,24,32,56,0.5714285714285714,1
38,90,0.422,12,44,0.273,18,23,0.783,14,33,47,27,3,4,13,23,26,46,0.5652173913043478,0
38,80,0.475,19,43,0.442,25,28,0.893,7,32,39,25,8,7,8,20,19,37,0.5135135135135135,1
45,91,0.495,12,31,0.387,8,14,0.571,10,28,38,28,4,1,8,28,33,60,0.55,0
48,83,0.578,16,35,0.457,23,31,0.742,9,36,45,23,3,6,10,15,32,48,0.6666666666666666,1
41,82,0.5,12,39,0.308,17,24,0.708,11,26,37,18,8,5,12,16,29,43,0.6744186046511628,0
44,76,0.579,12,27,0.444,13,18,0.722,4,22,26,25,7,3,14,21,32,49,0.6530612244897959,1
35,83,0.422,10,31,0.323,14,18,0.778,7,40,47,21,5,14,19,18,25,52,0.4807692307692308,0
42,110,0.382,4,30,0.133,20,25,0.8,21,39,60,19,12,8,6,13,38,80,0.475,1
41,91,0.451,10,35,0.286,13,17,0.765,10,30,40,28,7,7,16,28,31,56,0.5535714285714286,0
47,92,0.511,12,29,0.414,28,34,0.824,14,34,48,31,8,4,14,19,35,63,0.5555555555555556,1
36,88,0.409,8,28,0.286,19,25,0.76,11,30,41,12,6,1,13,26,28,60,0.4666666666666667,0
44,85,0.518,10,33,0.303,22,26,0.846,9,38,47,26,7,7,12,21,34,52,0.6538461538461539,1
37,86,0.43,16,40,0.4,19,24,0.792,6,32,38,31,5,12,20,18,21,46,0.45652173913043476,0
43,87,0.494,16,30,0.533,22,24,0.917,9,35,44,34,10,5,18,25,27,57,0.47368421052631576,1
35,81,0.432,6,24,0.25,16,21,0.762,10,33,43,19,6,6,17,29,29,57,0.5087719298245614,0
36,87,0.414,10,33,0.303,21,30,0.7,12,31,43,25,6,3,13,22,26,54,0.48148148148148145,1
40,90,0.444,8,30,0.267,11,16,0.688,7,40,47,25,8,4,14,16,32,60,0.5333333333333333,0
42,92,0.457,9,34,0.265,17,21,0.81,9,45,54,34,12,5,11,17,33,58,0.5689655172413793,1
45,91,0.495,8,22,0.364,20,25,0.8,10,36,46,22,6,12,12,20,37,69,0.5362318840579711,1
42,91,0.462,14,32,0.438,15,22,0.682,10,30,40,23,4,6,14,25,28,59,0.4745762711864407,0
34,86,0.395,7,27,0.259,24,30,0.8,7,30,37,23,7,6,14,24,27,59,0.4576271186440678,0
39,88,0.443,10,36,0.278,22,29,0.759,14,40,54,21,8,12,19,22,29,52,0.5576923076923077,1
43,95,0.453,16,36,0.444,20,22,0.909,14,27,41,34,6,2,16,18,27,59,0.4576271186440678,0
52,80,0.65,20,34,0.588,10,16,0.625,0,30,30,37,9,6,17,19,32,46,0.6956521739130435,1
49,99,0.495,13,31,0.419,20,30,0.667,9,33,42,31,9,5,15,24,36,68,0.5294117647058824,0
52,97,0.536,11,30,0.367,19,22,0.864,12,34,46,26,5,11,16,24,41,67,0.6119402985074627,1
44,87,0.506,15,38,0.395,16,19,0.842,15,31,46,34,13,2,18,22,29,49,0.5918367346938775,1
34,78,0.436,12,37,0.324,18,26,0.692,11,27,38,20,9,4,19,17,22,41,0.5365853658536586,0
40,79,0.506,16,36,0.444,13,19,0.684,4,30,34,29,6,2,13,12,24,43,0.5581395348837209,0
46,84,0.548,16,37,0.432,11,14,0.786,6,33,39,32,9,5,9,21,30,47,0.6382978723404256,1
36,94,0.383,11,40,0.275,18,24,0.75,14,35,49,19,7,2,19,30,25,54,0.46296296296296297,0
38,90,0.422,13,45,0.289,20,30,0.667,11,42,53,28,11,5,16,28,25,45,0.5555555555555556,1
41,81,0.506,20,40,0.5,27,35,0.771,7,30,37,25,8,4,18,23,21,41,0.5121951219512195,1
43,93,0.462,12,35,0.343,27,30,0.9,13,32,45,20,10,6,15,28,31,58,0.5344827586206896,0
39,88,0.443,14,43,0.326,18,22,0.818,8,23,31,25,16,5,12,15,25,45,0.5555555555555556,0
46,92,0.5,18,46,0.391,13,15,0.867,16,34,50,30,4,2,21,13,28,46,0.6086956521739131,1
44,82,0.537,9,28,0.321,13,18,0.722,10,34,44,21,6,5,20,17,35,54,0.6481481481481481,0
47,95,0.495,17,38,0.447,7,8,0.875,13,23,36,27,10,4,12,21,30,57,0.5263157894736842,1
49,92,0.533,14,33,0.424,13,18,0.722,11,32,43,27,5,3,14,18,35,59,0.5932203389830508,1
40,83,0.482,12,38,0.316,18,22,0.818,9,31,40,28,5,2,13,20,28,45,0.6222222222222222,0
45,87,0.517,16,35,0.457,26,34,0.765,9,33,42,18,5,2,16,28,29,52,0.5576923076923077,1
42,82,0.512,13,33,0.394,26,32,0.813,5,29,34,28,9,2,19,27,29,49,0.5918367346938775,0
38,91,0.418,10,39,0.256,15,19,0.789,8,30,38,24,7,8,10,30,28,52,0.5384615384615384,0
39,85,0.459,17,37,0.459,22,34,0.647,17,41,58,18,2,4,12,18,22,48,0.4583333333333333,1
55,97,0.567,12,29,0.414,14,18,0.778,10,35,45,31,5,8,7,26,43,68,0.6323529411764706,1
37,86,0.43,7,32,0.219,31,38,0.816,14,28,42,18,2,4,11,22,30,54,0.5555555555555556,0
37,93,0.398,12,35,0.343,22,32,0.688,13,41,54,19,6,5,13,19,25,58,0.43103448275862066,0
42,109,0.385,13,45,0.289,22,27,0.815,19,41,60,23,8,8,7,23,29,64,0.453125,1
37,89,0.416,9,29,0.31,19,27,0.704,12,43,55,20,8,5,22,21,28,60,0.4666666666666667,0
41,99,0.414,13,40,0.325,16,24,0.667,14,35,49,27,13,8,10,21,28,59,0.4745762711864407,1
33,86,0.384,11,38,0.289,16,24,0.667,10,37,47,21,3,4,15,18,22,48,0.4583333333333333,0
42,85,0.494,10,37,0.27,19,26,0.731,5,43,48,28,8,5,12,22,32,48,0.6666666666666666,1
38,86,0.442,15,37,0.405,20,22,0.909,9,24,33,25,10,1,14,21,23,49,0.46938775510204084,0
48,92,0.522,10,33,0.303,18,20,0.9,14,33,47,33,7,7,12,18,38,59,0.6440677966101694,1
40,94,0.426,14,38,0.368,17,21,0.81,13,26,39,23,10,6,17,18,26,56,0.4642857142857143,0
48,90,0.533,13,35,0.371,16,20,0.8,11,34,45,30,9,6,16,19,35,55,0.6363636363636364,1
47,99,0.475,9,27,0.333,21,26,0.808,15,27,42,20,13,3,13,19,38,72,0.5277777777777778,0
46,86,0.535,16,38,0.421,21,26,0.808,8,34,42,37,7,3,21,17,30,48,0.625,1
43,82,0.524,16,38,0.421,10,11,0.909,7,34,41,25,11,6,15,20,27,44,0.6136363636363636,1
33,86,0.384,9,39,0.231,15,24,0.625,15,30,45,20,9,5,17,15,24,47,0.5106382978723404,0
41,81,0.506,15,29,0.517,30,33,0.909,5,36,41,30,4,7,14,19,26,52,0.5,1
41,86,0.477,12,30,0.4,23,28,0.821,9,29,38,25,5,3,13,23,29,56,0.5178571428571429,0
40,94,0.426,23,46,0.5,22,26,0.846,17,36,53,31,7,1,12,25,17,48,0.3541666666666667,1
41,82,0.5,14,39,0.359,20,26,0.769,6,28,34,29,6,9,9,20,27,43,0.627906976744186,0
39,79,0.494,14,29,0.483,22,27,0.815,8,33,41,28,8,6,19,22,25,50,0.5,1
36,80,0.45,11,31,0.355,26,29,0.897,9,31,40,22,7,3,18,20,25,49,0.5102040816326531,0
44,100,0.44,13,44,0.295,12,16,0.75,10,39,49,31,8,6,10,31,31,56,0.5535714285714286,0
43,102,0.422,10,31,0.323,24,31,0.774,15,40,55,32,2,2,10,14,33,71,0.4647887323943662,1
44,89,0.494,5,25,0.2,24,31,0.774,9,38,47,25,9,6,15,29,39,64,0.609375,1
38,95,0.4,8,40,0.2,27,34,0.794,12,37,49,17,8,5,16,30,30,55,0.5454545454545454,0
45,94,0.479,13,29,0.448,12,15,0.8,12,30,42,19,5,2,13,23,32,65,0.49230769230769234,0
45,92,0.489,14,36,0.389,19,29,0.655,14,35,49,24,8,5,12,18,31,56,0.5535714285714286,1
38,89,0.427,11,28,0.393,26,31,0.839,9,25,34,18,7,3,9,25,27,61,0.4426229508196721,0
42,76,0.553,14,31,0.452,21,29,0.724,6,37,43,27,1,6,21,29,28,45,0.6222222222222222,1
50,88,0.568,12,27,0.444,11,15,0.733,10,30,40,24,11,5,20,26,38,61,0.6229508196721312,0
45,87,0.517,19,44,0.432,15,20,0.75,10,24,34,30,8,6,20,17,26,43,0.6046511627906976,1
38,98,0.388,7,32,0.219,11,16,0.688,15,36,51,22,5,6,10,20,31,66,0.4696969696969697,0
36,79,0.456,21,47,0.447,19,20,0.95,4,43,47,29,4,5,14,15,15,32,0.46875,1
45,92,0.489,10,27,0.37,8,16,0.5,12,33,45,26,9,2,14,25,35,65,0.5384615384615384,0
41,89,0.461,23,50,0.46,16,19,0.842,10,33,43,33,3,5,14,22,18,39,0.46153846153846156,1
37,81,0.457,11,29,0.379,20,27,0.741,11,36,47,20,2,5,12,23,26,52,0.5,0
41,83,0.494,11,35,0.314,21,28,0.75,5,32,37,15,10,1,4,22,30,48,0.625,1
39,92,0.424,12,39,0.308,24,25,0.96,13,29,42,23,8,4,15,24,27,53,0.5094339622641509,0
40,83,0.482,14,33,0.424,34,38,0.895,12,35,47,24,4,3,16,25,26,50,0.52,1
46,93,0.495,15,36,0.417,5,8,0.625,12,38,50,32,9,1,13,15,31,57,0.543859649122807,1
36,86,0.419,11,39,0.282,8,13,0.615,8,31,39,24,3,6,15,15,25,47,0.5319148936170213,0
41,96,0.427,15,40,0.375,13,18,0.722,13,35,48,24,3,8,9,15,26,56,0.4642857142857143,0
46,96,0.479,13,30,0.433,16,20,0.8,13,38,51,24,5,5,9,17,33,66,0.5,1
38,87,0.437,11,34,0.324,22,26,0.846,17,32,49,18,7,1,15,25,27,53,0.5094339622641509,0
45,84,0.536,12,40,0.3,22,30,0.733,10,26,36,29,9,8,12,22,33,44,0.75,1
40,99,0.404,4,29,0.138,14,20,0.7,16,29,45,21,11,7,11,23,36,70,0.5142857142857142,0
36,86,0.419,16,40,0.4,19,25,0.76,14,38,52,27,6,7,20,21,20,46,0.43478260869565216,1
41,87,0.471,11,39,0.282,16,23,0.696,10,28,38,23,11,5,24,24,30,48,0.625,0
43,80,0.538,11,30,0.367,19,20,0.95,6,33,39,26,11,9,20,18,32,50,0.64,1
37,85,0.435,17,44,0.386,24,28,0.857,10,32,42,26,8,4,19,19,20,41,0.4878048780487805,1
43,84,0.512,14,29,0.483,8,14,0.571,6,32,38,31,11,6,21,26,29,55,0.5272727272727272,0
34,88,0.386,8,28,0.286,17,23,0.739,7,37,44,17,9,8,15,16,26,60,0.43333333333333335,0
37,87,0.425,9,36,0.25,12,17,0.706,8,38,46,23,7,10,14,18,28,51,0.5490196078431373,1
41,92,0.446,8,29,0.276,18,21,0.857,13,30,43,19,9,3,12,24,33,63,0.5238095238095238,0
38,87,0.437,11,40,0.275,23,29,0.793,14,36,50,20,5,5,16,21,27,47,0.574468085106383,1
39,84,0.464,11,29,0.379,20,25,0.8,7,30,37,28,1,4,18,27,28,55,0.509090909090909,0
46,92,0.5,14,34,0.412,33,40,0.825,12,32,44,25,13,9,7,22,32,58,0.5517241379310345,1
38,92,0.413,6,26,0.231,23,42,0.548,18,34,52,14,8,4,16,17,32,66,0.48484848484848486,0
42,89,0.472,19,47,0.404,18,22,0.818,11,37,48,26,10,6,16,30,23,42,0.5476190476190477,1
46,83,0.554,12,30,0.4,14,20,0.7,4,33,37,26,14,3,14,20,34,53,0.6415094339622641,1
38,81,0.469,10,25,0.4,25,26,0.962,9,32,41,22,8,4,16,18,28,56,0.5,0
39,89,0.438,12,30,0.4,18,21,0.857,11,33,44,20,8,4,10,13,27,59,0.4576271186440678,1
36,74,0.486,12,32,0.375,15,19,0.789,4,34,38,27,4,7,18,20,24,42,0.5714285714285714,0
39,84,0.464,18,49,0.367,13,17,0.765,10,31,41,31,8,5,20,22,21,35,0.6,0
40,88,0.455,16,42,0.381,20,20,1.0,9,30,39,32,7,3,15,16,24,46,0.5217391304347826,1
39,87,0.448,10,29,0.345,20,20,1.0,12,37,49,20,7,10,25,14,29,58,0.5,0
45,95,0.474,10,34,0.294,16,20,0.8,8,28,36,28,13,9,17,17,35,61,0.5737704918032787,1
37,87,0.425,13,34,0.382,20,24,0.833,10,32,42,24,5,4,18,24,24,53,0.4528301886792453,0
41,89,0.461,17,43,0.395,17,22,0.773,7,27,34,31,9,8,11,20,24,46,0.5217391304347826,1
36,92,0.391,7,32,0.219,9,16,0.563,13,34,47,22,12,12,17,14,29,60,0.48333333333333334,0
38,88,0.432,14,31,0.452,16,18,0.889,11,40,51,28,6,9,20,18,24,57,0.42105263157894735,1
38,93,0.409,11,41,0.268,26,27,0.963,8,44,52,26,5,9,14,24,27,52,0.5192307692307693,0
42,100,0.42,11,39,0.282,19,24,0.792,9,42,51,24,6,4,11,23,31,61,0.5081967213114754,1
39,84,0.464,10,30,0.333,12,14,0.857,12,28,40,28,6,1,17,17,29,54,0.5370370370370371,0
42,84,0.5,11,38,0.289,8,15,0.533,7,30,37,20,9,4,12,14,31,46,0.6739130434782609,1
41,84,0.488,12,33,0.364,15,19,0.789,9,34,43,20,10,6,15,20,29,51,0.5686274509803921,1
37,88,0.42,11,38,0.289,16,21,0.762,16,34,50,17,9,5,19,22,26,50,0.52,0
47,102,0.461,8,25,0.32,15,21,0.714,11,40,51,35,10,5,14,20,39,77,0.5064935064935064,0
45,98,0.459,10,36,0.278,20,23,0.87,11,45,56,30,6,8,18,17,35,62,0.5645161290322581,1
41,86,0.477,13,36,0.361,12,14,0.857,4,35,39,29,4,3,12,18,28,50,0.56,0
44,89,0.494,11,34,0.324,11,13,0.846,9,37,46,27,5,5,11,20,33,55,0.6,1
33,79,0.418,11,31,0.355,14,15,0.933,2,33,35,18,7,3,21,22,22,48,0.4583333333333333,0
43,92,0.467,10,38,0.263,20,24,0.833,15,37,52,24,17,5,16,16,33,54,0.6111111111111112,1
44,107,0.411,12,34,0.353,12,16,0.75,17,34,51,28,11,4,9,18,32,73,0.4383561643835616,1
37,90,0.411,10,36,0.278,15,20,0.75,12,40,52,23,3,9,17,19,27,54,0.5,0
45,78,0.577,5,21,0.238,26,32,0.813,7,36,43,27,4,9,8,18,40,57,0.7017543859649122,1
39,84,0.464,19,36,0.528,14,20,0.7,6,26,32,25,3,1,8,25,20,48,0.4166666666666667,0
38,83,0.458,13,28,0.464,22,27,0.815,10,36,46,28,7,5,15,19,25,55,0.45454545454545453,1
36,89,0.404,13,33,0.394,21,26,0.808,16,30,46,27,5,3,20,17,23,56,0.4107142857142857,0
57,106,0.538,14,33,0.424,15,16,0.938,9,41,50,31,16,6,11,17,43,73,0.589041095890411,1
37,94,0.394,14,43,0.326,12,14,0.857,13,33,46,29,3,6,23,20,23,51,0.45098039215686275,0
45,84,0.536,18,31,0.581,14,16,0.875,8,39,47,32,5,2,20,15,27,53,0.5094339622641509,1
45,93,0.484,6,29,0.207,14,19,0.737,10,30,40,19,9,5,10,19,39,64,0.609375,0
50,97,0.515,19,43,0.442,10,15,0.667,9,26,35,31,5,3,14,32,31,54,0.5740740740740741,0
42,78,0.538,13,30,0.433,33,46,0.717,11,35,46,20,9,6,19,22,29,48,0.6041666666666666,1
43,83,0.518,11,28,0.393,22,25,0.88,4,33,37,21,8,5,17,28,32,55,0.5818181818181818,0
41,83,0.494,9,31,0.29,32,39,0.821,7,32,39,24,5,7,14,23,32,52,0.6153846153846154,1
39,88,0.443,11,34,0.324,21,25,0.84,18,26,44,20,10,4,19,22,28,54,0.5185185185185185,0
39,77,0.506,12,34,0.353,21,25,0.84,6,25,31,23,12,3,19,21,27,43,0.627906976744186,1
44,81,0.543,11,26,0.423,13,16,0.813,10,37,47,30,5,13,19,15,33,55,0.6,1
31,83,0.373,13,37,0.351,13,15,0.867,9,25,34,16,10,6,19,22,18,46,0.391304347826087,0
31,81,0.383,11,39,0.282,26,26,1.0,8,34,42,17,10,2,19,22,20,42,0.47619047619047616,0
37,80,0.463,12,39,0.308,15,23,0.652,5,37,42,28,7,5,19,19,25,41,0.6097560975609756,1
52,103,0.505,17,40,0.425,9,10,0.9,15,33,48,31,8,3,8,22,35,63,0.5555555555555556,1
40,83,0.482,11,26,0.423,25,28,0.893,9,31,40,22,6,6,11,17,29,57,0.5087719298245614,0
33,86,0.384,8,27,0.296,25,31,0.806,12,29,41,22,11,7,18,17,25,59,0.423728813559322,0
50,98,0.51,16,36,0.444,14,18,0.778,18,42,60,34,6,10,19,20,34,62,0.5483870967741935,1
41,85,0.482,17,38,0.447,16,28,0.571,7,44,51,29,7,2,13,22,24,47,0.5106382978723404,1
39,92,0.424,11,41,0.268,13,17,0.765,10,37,47,22,2,4,16,25,28,51,0.5490196078431373,0
35,71,0.493,12,32,0.375,23,25,0.92,3,26,29,23,7,1,23,25,23,39,0.5897435897435898,0
41,81,0.506,12,29,0.414,20,29,0.69,9,28,37,24,10,2,16,21,29,52,0.5576923076923077,1
37,80,0.463,9,33,0.273,23,27,0.852,10,40,50,24,5,8,22,21,28,47,0.5957446808510638,1
37,98,0.378,13,47,0.277,17,21,0.81,13,31,44,27,12,8,15,25,24,51,0.47058823529411764,0
43,85,0.506,10,23,0.435,12,15,0.8,11,31,42,30,6,3,18,24,33,62,0.532258064516129,1
36,83,0.434,14,34,0.412,20,21,0.952,13,26,39,26,8,4,17,22,22,49,0.4489795918367347,0
42,80,0.525,15,33,0.455,14,19,0.737,3,41,44,26,6,5,16,25,27,47,0.574468085106383,1
42,88,0.477,12,31,0.387,10,18,0.556,6,29,35,23,7,2,13,17,30,57,0.5263157894736842,0
50,90,0.556,14,28,0.5,14,14,1.0,7,41,48,32,8,7,9,19,36,62,0.5806451612903226,1
30,83,0.361,8,34,0.235,18,22,0.818,7,32,39,18,4,3,13,15,22,49,0.4489795918367347,0
47,108,0.435,7,23,0.304,20,28,0.714,19,40,59,23,8,6,16,24,40,85,0.47058823529411764,0
47,103,0.456,9,36,0.25,21,25,0.84,12,38,50,28,12,8,13,23,38,67,0.5671641791044776,1
33,84,0.393,12,36,0.333,20,22,0.909,9,32,41,23,8,10,11,21,21,48,0.4375,1
32,86,0.372,14,42,0.333,16,23,0.696,13,37,50,22,3,6,15,21,18,44,0.4090909090909091,0
39,80,0.488,12,30,0.4,11,19,0.579,6,22,28,28,8,3,15,13,27,50,0.54,0
53,87,0.609,15,29,0.517,5,10,0.5,10,37,47,37,10,0,18,15,38,58,0.6551724137931034,1
36,84,0.429,12,35,0.343,10,16,0.625,9,29,38,22,6,3,16,18,24,49,0.4897959183673469,0
38,90,0.422,17,47,0.362,15,17,0.882,18,37,55,23,7,6,19,16,21,43,0.4883720930232558,1
40,84,0.476,16,38,0.421,21,31,0.677,12,21,33,27,10,0,23,18,24,46,0.5217391304347826,0
49,80,0.613,15,33,0.455,16,20,0.8,9,27,36,38,11,5,24,27,34,47,0.723404255319149,1
47,88,0.534,27,51,0.529,12,12,1.0,8,26,34,30,5,2,13,17,20,37,0.5405405405405406,1
46,90,0.511,11,27,0.407,15,16,0.938,12,32,44,22,6,4,14,14,35,63,0.5555555555555556,0
47,93,0.505,15,40,0.375,17,26,0.654,6,30,36,24,5,4,14,20,32,53,0.6037735849056604,1
50,92,0.543,4,23,0.174,19,20,0.95,7,41,48,27,8,4,18,26,46,69,0.6666666666666666,0
30,79,0.38,7,15,0.467,15,24,0.625,8,32,40,22,5,7,18,26,23,64,0.359375,0
35,82,0.427,11,30,0.367,21,28,0.75,11,33,44,22,7,14,14,22,24,52,0.46153846153846156,1
35,75,0.467,15,40,0.375,25,26,0.962,7,35,42,18,5,4,21,15,20,35,0.5714285714285714,1
43,87,0.494,8,33,0.242,8,13,0.615,4,28,32,22,11,2,14,26,35,54,0.6481481481481481,0
37,84,0.44,8,32,0.25,32,36,0.889,9,39,48,19,7,6,14,20,29,52,0.5576923076923077,1
40,87,0.46,8,27,0.296,12,21,0.571,10,33,43,24,4,4,17,26,32,60,0.5333333333333333,0
41,96,0.427,8,41,0.195,7,10,0.7,15,34,49,25,5,5,10,21,33,55,0.6,0
39,91,0.429,9,29,0.31,16,20,0.8,12,38,50,20,8,2,11,17,30,62,0.4838709677419355,1
40,88,0.455,13,36,0.361,11,13,0.846,15,31,46,27,5,10,17,20,27,52,0.5192307692307693,0
44,103,0.427,10,37,0.27,15,20,0.75,23,29,52,28,11,10,9,16,34,66,0.5151515151515151,1
36,87,0.414,13,40,0.325,13,16,0.813,6,35,41,21,5,9,19,18,23,47,0.48936170212765956,0
46,99,0.465,11,29,0.379,14,17,0.824,12,36,48,23,11,3,12,18,35,70,0.5,1
36,85,0.424,9,28,0.321,16,22,0.727,5,26,31,24,10,7,15,20,27,57,0.47368421052631576,0
42,80,0.525,9,28,0.321,18,22,0.818,9,40,49,30,7,7,22,21,33,52,0.6346153846153846,1
42,80,0.525,5,19,0.263,19,30,0.633,10,37,47,21,2,6,15,18,37,61,0.6065573770491803,1
42,101,0.416,5,32,0.156,11,16,0.688,17,28,45,27,8,7,11,23,37,69,0.5362318840579711,0
35,80,0.438,10,29,0.345,14,19,0.737,14,20,34,22,13,5,14,26,25,51,0.49019607843137253,0
32,72,0.444,12,28,0.429,20,24,0.833,12,29,41,18,7,3,22,20,20,44,0.45454545454545453,1
41,102,0.402,10,33,0.303,11,17,0.647,16,30,46,23,9,11,10,26,31,69,0.4492753623188406,0
39,93,0.419,9,33,0.273,25,33,0.758,16,42,58,20,6,9,16,19,30,60,0.5,1
37,91,0.407,14,40,0.35,25,29,0.862,9,34,43,24,9,0,11,20,23,51,0.45098039215686275,0
44,88,0.5,14,38,0.368,14,21,0.667,8,40,48,28,5,4,15,21,30,50,0.6,1
48,97,0.495,14,34,0.412,12,17,0.706,13,30,43,32,7,4,10,20,34,63,0.5396825396825397,0
43,86,0.5,22,48,0.458,21,23,0.913,10,35,45,33,6,8,17,19,21,38,0.5526315789473685,1
43,83,0.518,16,33,0.485,15,21,0.714,10,38,48,29,6,2,17,21,27,50,0.54,0
40,79,0.506,17,38,0.447,22,28,0.786,4,27,31,19,8,2,9,19,23,41,0.5609756097560976,1
38,82,0.463,12,37,0.324,21,28,0.75,7,38,45,26,5,6,15,19,26,45,0.5777777777777777,1
41,91,0.451,15,44,0.341,9,14,0.643,8,37,45,27,4,4,11,23,26,47,0.5531914893617021,0
38,72,0.528,16,37,0.432,18,21,0.857,4,33,37,27,7,2,19,16,22,35,0.6285714285714286,1
40,84,0.476,14,39,0.359,13,15,0.867,5,27,32,28,11,2,12,18,26,45,0.5777777777777777,0
39,89,0.438,19,48,0.396,23,25,0.92,9,34,43,26,13,2,19,23,20,41,0.4878048780487805,1
38,81,0.469,11,41,0.268,20,24,0.833,4,35,39,28,7,8,18,18,27,40,0.675,0
46,87,0.529,24,48,0.5,18,25,0.72,14,26,40,31,9,6,22,23,22,39,0.5641025641025641,1
45,82,0.549,12,25,0.48,25,31,0.806,11,26,37,27,7,4,20,25,33,57,0.5789473684210527,0
32,73,0.438,6,19,0.316,18,22,0.818,6,31,37,19,8,5,15,24,26,54,0.48148148148148145,0
31,80,0.388,12,32,0.375,26,31,0.839,15,33,48,22,5,6,16,17,19,48,0.3958333333333333,1
47,88,0.534,8,24,0.333,13,20,0.65,8,32,40,33,14,7,22,14,39,64,0.609375,1
43,82,0.524,12,33,0.364,11,18,0.611,10,28,38,31,14,5,24,17,31,49,0.6326530612244898,0
40,82,0.488,9,24,0.375,27,30,0.9,7,26,33,15,7,5,16,21,31,58,0.5344827586206896,0
53,95,0.558,16,38,0.421,17,22,0.773,10,31,41,30,10,7,15,23,37,57,0.6491228070175439,1
44,94,0.468,17,39,0.436,20,24,0.833,13,34,47,27,5,6,13,20,27,55,0.4909090909090909,1
51,109,0.468,8,28,0.286,9,11,0.818,17,37,54,24,5,5,11,16,43,81,0.5308641975308642,0
37,89,0.416,7,33,0.212,31,40,0.775,15,33,48,15,7,3,10,19,30,56,0.5357142857142857,0
47,88,0.534,18,46,0.391,16,21,0.762,8,35,43,31,5,4,13,25,29,42,0.6904761904761905,1
28,87,0.322,12,43,0.279,17,26,0.654,11,35,46,21,5,4,15,18,16,44,0.36363636363636365,0
42,87,0.483,14,34,0.412,14,20,0.7,11,44,55,30,11,5,15,22,28,53,0.5283018867924528,1
42,84,0.5,3,19,0.158,28,36,0.778,13,37,50,20,8,5,16,18,39,65,0.6,1
44,87,0.506,7,27,0.259,16,18,0.889,6,29,35,23,5,8,15,23,37,60,0.6166666666666667,0
40,75,0.533,11,34,0.324,14,25,0.56,8,37,45,28,5,4,18,19,29,41,0.7073170731707317,1
34,91,0.374,10,40,0.25,17,24,0.708,20,22,42,21,10,3,11,22,24,51,0.47058823529411764,0
43,88,0.489,12,28,0.429,24,26,0.923,11,36,47,27,10,7,22,15,31,60,0.5166666666666667,1
45,96,0.469,14,42,0.333,15,19,0.789,11,33,44,28,9,5,18,23,31,54,0.5740740740740741,0
40,88,0.455,10,32,0.313,11,17,0.647,8,35,43,26,7,2,16,20,30,56,0.5357142857142857,0
41,81,0.506,12,33,0.364,20,26,0.769,6,35,41,24,10,7,15,24,29,48,0.6041666666666666,1
47,97,0.485,16,35,0.457,19,20,0.95,10,26,36,31,10,3,11,21,31,62,0.5,1
41,78,0.526,9,27,0.333,26,32,0.813,8,30,38,26,4,6,19,22,32,51,0.6274509803921569,0
50,106,0.472,17,36,0.472,19,22,0.864,11,44,55,27,8,7,17,23,33,70,0.4714285714285714,1
50,111,0.45,18,45,0.4,14,19,0.737,16,39,55,24,9,9,13,26,32,66,0.48484848484848486,0
32,85,0.376,11,42,0.262,12,19,0.632,4,25,29,17,14,4,6,19,21,43,0.4883720930232558,0
36,73,0.493,8,21,0.381,14,21,0.667,4,45,49,20,1,6,19,20,28,52,0.5384615384615384,1
46,86,0.535,11,26,0.423,17,20,0.85,12,30,42,24,4,1,18,23,35,60,0.5833333333333334,0
40,76,0.526,17,39,0.436,30,35,0.857,2,22,24,30,12,4,9,20,23,37,0.6216216216216216,1
50,98,0.51,14,32,0.438,10,13,0.769,18,35,53,24,4,2,20,22,36,66,0.5454545454545454,1
47,98,0.48,12,37,0.324,16,23,0.696,13,26,39,30,8,2,12,17,35,61,0.5737704918032787,0
37,84,0.44,9,35,0.257,26,31,0.839,16,33,49,29,9,7,16,18,28,49,0.5714285714285714,0
42,102,0.412,15,44,0.341,17,20,0.85,22,28,50,19,12,9,13,26,27,58,0.46551724137931033,1
32,83,0.386,6,30,0.2,25,30,0.833,9,36,45,15,10,5,17,22,26,53,0.49056603773584906,0
39,88,0.443,6,26,0.231,20,23,0.87,11,43,54,19,8,2,18,22,33,62,0.532258064516129,1
43,88,0.489,14,39,0.359,12,20,0.6,8,42,50,23,4,2,21,30,29,49,0.5918367346938775,0
39,90,0.433,10,36,0.278,29,36,0.806,8,30,38,21,9,1,11,25,29,54,0.5370370370370371,1
37,85,0.435,12,34,0.353,20,26,0.769,11,35,46,25,8,2,9,14,25,51,0.49019607843137253,1
33,79,0.418,10,28,0.357,19,24,0.792,9,36,45,19,3,5,17,21,23,51,0.45098039215686275,0
37,86,0.43,18,47,0.383,13,21,0.619,7,34,41,19,9,1,13,13,19,39,0.48717948717948717,0
41,84,0.488,12,30,0.4,19,20,0.95,8,44,52,25,5,5,17,21,29,54,0.5370370370370371,1
42,92,0.457,12,29,0.414,16,20,0.8,11,27,38,26,3,1,6,16,30,63,0.47619047619047616,0
50,90,0.556,16,37,0.432,15,20,0.75,10,36,46,30,3,5,7,19,34,53,0.6415094339622641,1
37,92,0.402,8,30,0.267,19,26,0.731,14,32,46,25,6,3,13,17,29,62,0.46774193548387094,0
40,82,0.488,15,36,0.417,11,14,0.786,8,36,44,29,5,3,15,27,25,46,0.5434782608695652,1
45,87,0.517,12,36,0.333,18,21,0.857,10,30,40,27,10,4,15,17,33,51,0.6470588235294118,1
42,88,0.477,10,25,0.4,20,26,0.769,14,27,41,22,11,5,14,22,32,63,0.5079365079365079,0
37,79,0.468,10,30,0.333,19,22,0.864,7,26,33,29,10,4,15,25,27,49,0.5510204081632653,0
44,88,0.5,7,33,0.212,19,27,0.704,15,31,46,25,8,3,14,19,37,55,0.6727272727272727,1
37,80,0.463,7,31,0.226,31,41,0.756,12,31,43,22,6,6,15,23,30,49,0.6122448979591837,0
42,94,0.447,10,40,0.25,27,29,0.931,16,31,47,23,7,3,11,31,32,54,0.5925925925925926,1
38,88,0.432,11,30,0.367,26,36,0.722,14,25,39,20,13,4,16,16,27,58,0.46551724137931033,0
52,93,0.559,15,36,0.417,13,17,0.765,15,29,44,31,10,6,19,27,37,57,0.6491228070175439,1
38,95,0.4,13,42,0.31,8,9,0.889,11,27,38,22,7,4,11,14,25,53,0.4716981132075472,0
43,82,0.524,15,33,0.455,13,15,0.867,9,41,50,23,2,4,15,11,28,49,0.5714285714285714,1
32,98,0.327,12,43,0.279,17,23,0.739,21,27,48,22,7,5,17,14,20,55,0.36363636363636365,0
43,85,0.506,12,31,0.387,13,15,0.867,9,41,50,22,3,13,19,22,31,54,0.5740740740740741,1
36,80,0.45,13,31,0.419,27,35,0.771,12,32,44,20,6,2,12,21,23,49,0.46938775510204084,0
41,81,0.506,14,43,0.326,21,26,0.808,7,33,40,26,8,2,11,27,27,38,0.7105263157894737,1
39,91,0.429,18,48,0.375,21,24,0.875,9,33,42,27,6,4,7,17,21,43,0.4883720930232558,1
37,89,0.416,16,38,0.421,18,21,0.857,11,39,50,23,4,3,14,23,21,51,0.4117647058823529,0
37,94,0.394,7,35,0.2,23,29,0.793,16,27,43,14,12,8,12,18,30,59,0.5084745762711864,0
41,82,0.5,19,43,0.442,17,23,0.739,11,40,51,33,4,6,21,23,22,39,0.5641025641025641,1
40,83,0.482,16,35,0.457,14,21,0.667,6,35,41,27,9,6,13,18,24,48,0.5,1
34,85,0.4,11,31,0.355,16,20,0.8,10,36,46,22,4,6,18,17,23,54,0.42592592592592593,0
46,90,0.511,9,31,0.29,14,16,0.875,4,33,37,25,4,3,12,21,37,59,0.6271186440677966,0
49,93,0.527,16,41,0.39,18,21,0.857,9,37,46,32,7,5,12,19,33,52,0.6346153846153846,1
40,79,0.506,12,36,0.333,14,18,0.778,10,33,43,24,7,4,26,23,28,43,0.6511627906976745,0
42,86,0.488,8,29,0.276,27,31,0.871,12,24,36,28,13,1,12,23,34,57,0.5964912280701754,1
40,89,0.449,6,24,0.25,23,27,0.852,12,31,43,20,4,2,19,19,34,65,0.5230769230769231,0
44,80,0.55,8,24,0.333,25,31,0.806,2,29,31,24,10,5,12,26,36,56,0.6428571428571429,1
44,94,0.468,14,40,0.35,10,11,0.909,7,35,42,33,4,3,12,17,30,54,0.5555555555555556,0
44,88,0.5,16,36,0.444,17,20,0.85,6,40,46,27,6,8,9,14,28,52,0.5384615384615384,1
48,80,0.6,13,27,0.481,17,21,0.81,5,31,36,33,11,3,16,17,35,53,0.660377358490566,1
40,81,0.494,6,22,0.273,17,21,0.81,8,28,36,24,9,4,19,19,34,59,0.576271186440678,0
46,82,0.561,12,24,0.5,25,34,0.735,11,36,47,30,5,4,13,30,34,58,0.5862068965517241,1
40,89,0.449,17,34,0.5,27,39,0.692,16,24,40,22,6,1,10,22,23,55,0.41818181818181815,0
36,80,0.45,7,27,0.259,24,31,0.774,8,33,41,22,5,5,13,17,29,53,0.5471698113207547,0
44,91,0.484,11,27,0.407,17,20,0.85,12,33,45,25,3,2,9,22,33,64,0.515625,1
55,88,0.625,17,31,0.548,18,20,0.9,4,34,38,31,9,5,19,27,38,57,0.6666666666666666,1
48,97,0.495,10,31,0.323,29,33,0.879,13,22,35,25,13,2,13,18,38,66,0.5757575757575758,0
37,94,0.394,11,37,0.297,13,23,0.565,18,32,50,23,3,4,18,17,26,57,0.45614035087719296,0
40,83,0.482,4,23,0.174,21,26,0.808,8,31,39,21,12,14,12,19,36,60,0.6,1
42,90,0.467,16,47,0.34,15,16,0.938,8,35,43,27,5,5,18,20,26,43,0.6046511627906976,0
47,91,0.516,16,37,0.432,12,19,0.632,9,36,45,31,8,2,16,17,31,54,0.5740740740740741,1
38,96,0.396,9,28,0.321,7,10,0.7,14,37,51,21,7,6,17,24,29,68,0.4264705882352941,0
36,86,0.419,19,40,0.475,11,21,0.524,9,38,47,26,9,6,15,15,17,46,0.3695652173913043,1
47,98,0.48,11,30,0.367,17,21,0.81,10,41,51,21,4,6,20,21,36,68,0.5294117647058824,0
46,96,0.479,10,37,0.27,24,29,0.828,10,36,46,25,15,7,14,20,36,59,0.6101694915254238,1
40,82,0.488,8,27,0.296,27,28,0.964,12,30,42,27,7,8,17,27,32,55,0.5818181818181818,1
35,77,0.455,10,31,0.323,31,43,0.721,11,28,39,23,8,2,19,23,25,46,0.5434782608695652,0
36,100,0.36,10,40,0.25,13,19,0.684,22,31,53,18,6,6,19,17,26,60,0.43333333333333335,0
47,88,0.534,23,45,0.511,15,16,0.938,5,35,40,35,9,3,13,17,24,43,0.5581395348837209,1
41,81,0.506,14,38,0.368,26,33,0.788,9,35,44,25,6,4,17,23,27,43,0.627906976744186,1
39,86,0.453,9,30,0.3,19,31,0.613,10,30,40,20,11,3,14,22,30,56,0.5357142857142857,0
48,99,0.485,14,36,0.389,2,4,0.5,20,25,45,22,9,4,14,22,34,63,0.5396825396825397,0
38,83,0.458,15,33,0.455,22,25,0.88,17,25,42,23,6,4,15,10,23,50,0.46,1
44,92,0.478,7,20,0.35,26,30,0.867,13,32,45,23,4,4,9,23,37,72,0.5138888888888888,1
34,82,0.415,6,29,0.207,32,41,0.78,11,35,46,21,4,3,17,26,28,53,0.5283018867924528,0
42,88,0.477,7,35,0.2,21,24,0.875,14,23,37,22,15,7,13,23,35,53,0.660377358490566,1
36,88,0.409,14,36,0.389,19,23,0.826,22,26,48,23,3,7,22,18,22,52,0.4230769230769231,0
34,64,0.531,12,28,0.429,21,26,0.808,3,37,40,23,8,2,21,27,22,36,0.6111111111111112,0
35,80,0.438,17,43,0.395,16,24,0.667,8,26,34,20,12,1,12,20,18,37,0.4864864864864865,1
38,92,0.413,9,35,0.257,17,25,0.68,14,37,51,16,6,8,11,17,29,57,0.5087719298245614,0
43,91,0.473,18,38,0.474,9,12,0.75,7,36,43,31,2,8,10,20,25,53,0.4716981132075472,1
44,85,0.518,9,29,0.31,13,17,0.765,11,27,38,34,7,5,19,25,35,56,0.625,0
41,79,0.519,15,32,0.469,20,26,0.769,9,30,39,22,6,3,17,17,26,47,0.5531914893617021,1
40,81,0.494,11,28,0.393,30,33,0.909,3,26,29,25,5,3,17,18,29,53,0.5471698113207547,0
56,94,0.596,20,41,0.488,21,25,0.84,9,34,43,39,9,4,17,24,36,53,0.6792452830188679,1
44,93,0.473,11,32,0.344,19,25,0.76,13,30,43,26,10,3,14,25,33,61,0.5409836065573771,1
36,83,0.434,14,43,0.326,25,30,0.833,15,34,49,29,7,5,21,22,22,40,0.55,0
48,88,0.545,21,46,0.457,9,10,0.9,6,43,49,29,4,8,15,20,27,42,0.6428571428571429,1
42,101,0.416,7,32,0.219,10,13,0.769,14,31,45,21,5,5,9,11,35,69,0.5072463768115942,0
44,82,0.537,11,28,0.393,26,31,0.839,7,27,34,27,11,9,14,18,33,54,0.6111111111111112,1
43,94,0.457,12,33,0.364,15,18,0.833,14,30,44,29,8,4,18,23,31,61,0.5081967213114754,0
35,75,0.467,10,22,0.455,21,24,0.875,9,47,56,21,1,19,23,19,25,53,0.4716981132075472,1
31,102,0.304,12,55,0.218,18,19,0.947,13,25,38,21,9,2,6,19,19,47,0.40425531914893614,0
37,84,0.44,8,34,0.235,24,31,0.774,6,34,40,24,12,5,8,18,29,50,0.58,1
36,82,0.439,14,38,0.368,17,20,0.85,8,34,42,18,3,5,15,25,22,44,0.5,0
36,84,0.429,12,28,0.429,14,17,0.824,6,28,34,22,7,7,8,18,24,56,0.42857142857142855,0
41,86,0.477,16,39,0.41,15,27,0.556,13,39,52,26,5,6,14,16,25,47,0.5319148936170213,1
44,89,0.494,11,32,0.344,11,17,0.647,7,30,37,25,2,1,12,18,33,57,0.5789473684210527,0
43,85,0.506,17,33,0.515,21,24,0.875,12,34,46,30,4,6,15,18,26,52,0.5,1
46,88,0.523,12,36,0.333,22,28,0.786,8,32,40,28,15,6,11,15,34,52,0.6538461538461539,1
42,93,0.452,9,35,0.257,15,17,0.882,12,35,47,21,6,5,16,26,33,58,0.5689655172413793,0
42,92,0.457,18,42,0.429,17,17,1.0,6,34,40,30,5,3,17,23,24,50,0.48,0
44,86,0.512,21,40,0.525,21,25,0.84,8,39,47,33,5,8,16,22,23,46,0.5,1
36,66,0.545,13,35,0.371,19,22,0.864,4,19,23,19,5,4,23,20,23,31,0.7419354838709677,0
44,86,0.512,7,26,0.269,17,22,0.773,16,26,42,23,5,3,14,23,37,60,0.6166666666666667,1
44,81,0.543,16,31,0.516,17,26,0.654,9,28,37,24,4,7,15,22,28,50,0.56,1
44,86,0.512,17,34,0.5,15,17,0.882,11,30,41,32,8,5,19,20,27,52,0.5192307692307693,0
33,88,0.375,6,31,0.194,19,24,0.792,10,33,43,15,9,7,13,26,27,57,0.47368421052631576,0
33,81,0.407,11,30,0.367,19,24,0.792,10,41,51,17,1,1,18,21,22,51,0.43137254901960786,1
40,79,0.506,11,29,0.379,18,23,0.783,5,42,47,32,4,5,17,24,29,50,0.58,1
36,93,0.387,13,36,0.361,22,27,0.815,8,31,39,22,9,5,10,22,23,57,0.40350877192982454,0
46,84,0.548,11,26,0.423,9,12,0.75,7,25,32,29,8,6,19,22,35,58,0.603448275862069,0
48,83,0.578,12,30,0.4,22,24,0.917,6,31,37,28,7,1,12,15,36,53,0.6792452830188679,1
38,77,0.494,12,28,0.429,20,22,0.909,6,35,41,25,4,7,16,25,26,49,0.5306122448979592,1
41,89,0.461,5,21,0.238,20,25,0.8,13,33,46,27,6,6,11,19,36,68,0.5294117647058824,0
44,110,0.4,14,44,0.318,20,24,0.833,17,36,53,24,11,6,16,33,30,66,0.45454545454545453,0
49,92,0.533,8,28,0.286,26,32,0.813,7,43,50,25,8,8,20,25,41,64,0.640625,1
38,90,0.422,10,30,0.333,13,18,0.722,13,23,36,24,4,1,13,20,28,60,0.4666666666666667,0
46,77,0.597,13,32,0.406,22,28,0.786,6,38,44,29,5,3,10,19,33,45,0.7333333333333333,1
30,87,0.345,9,34,0.265,32,34,0.941,13,32,45,16,8,7,16,16,21,53,0.39622641509433965,0
41,91,0.451,18,50,0.36,11,20,0.55,12,39,51,32,8,3,18,26,23,41,0.5609756097560976,1
33,82,0.402,12,41,0.293,21,27,0.778,12,33,45,25,8,10,15,26,21,41,0.5121951219512195,1
29,86,0.337,6,28,0.214,27,32,0.844,14,35,49,15,8,4,17,24,23,58,0.39655172413793105,0
43,92,0.467,11,34,0.324,24,32,0.75,10,27,37,27,9,4,11,30,32,58,0.5517241379310345,0
43,78,0.551,7,20,0.35,35,40,0.875,7,37,44,29,2,7,16,24,36,58,0.6206896551724138,1
45,96,0.469,11,34,0.324,9,11,0.818,8,35,43,34,5,9,11,28,34,62,0.5483870967741935,0
39,93,0.419,14,39,0.359,29,40,0.725,17,40,57,26,4,7,11,13,25,54,0.46296296296296297,1
41,85,0.482,20,46,0.435,15,17,0.882,11,35,46,28,6,3,17,13,21,39,0.5384615384615384,1
43,87,0.494,13,35,0.371,10,13,0.769,7,30,37,24,13,3,13,18,30,52,0.5769230769230769,0
41,90,0.456,12,36,0.333,8,21,0.381,8,34,42,22,8,7,13,18,29,54,0.5370370370370371,0
40,78,0.513,13,28,0.464,17,26,0.654,6,35,41,28,5,5,18,18,27,50,0.54,1
49,94,0.521,9,30,0.3,26,28,0.929,12,30,42,29,7,6,14,25,40,64,0.625,0
51,91,0.56,16,31,0.516,16,24,0.667,11,25,36,32,6,3,17,28,35,60,0.5833333333333334,1
35,98,0.357,11,43,0.256,25,32,0.781,10,43,53,23,6,4,10,15,24,55,0.43636363636363634,0
41,96,0.427,15,46,0.326,10,14,0.714,8,46,54,33,6,4,16,25,26,50,0.52,1
48,108,0.444,8,37,0.216,18,22,0.818,17,34,51,27,11,6,14,25,40,71,0.5633802816901409,0
46,92,0.5,7,25,0.28,25,32,0.781,11,39,50,23,5,5,15,20,39,67,0.582089552238806,1
39,91,0.429,16,42,0.381,19,26,0.731,11,30,41,16,8,6,11,17,23,49,0.46938775510204084,0
41,90,0.456,18,46,0.391,14,19,0.737,12,30,42,27,5,6,15,18,23,44,0.5227272727272727,1
36,87,0.414,7,26,0.269,18,21,0.857,15,28,43,22,4,2,15,13,29,61,0.47540983606557374,0
44,81,0.543,21,40,0.525,10,19,0.526,7,28,35,32,9,1,13,20,23,41,0.5609756097560976,1
40,85,0.471,12,36,0.333,20,24,0.833,8,35,43,28,9,2,20,25,28,49,0.5714285714285714,1
34,71,0.479,14,32,0.438,27,32,0.844,4,35,39,21,10,1,22,24,20,39,0.5128205128205128,0
42,91,0.462,14,39,0.359,20,23,0.87,11,31,42,23,6,4,13,20,28,52,0.5384615384615384,1
39,83,0.47,13,42,0.31,22,27,0.815,10,33,43,27,11,8,18,22,26,41,0.6341463414634146,0
43,99,0.434,12,37,0.324,17,31,0.548,13,31,44,28,13,0,10,12,31,62,0.5,0
50,83,0.602,16,34,0.471,11,15,0.733,5,40,45,33,5,5,19,25,34,49,0.6938775510204082,1
31,80,0.388,6,31,0.194,19,22,0.864,11,19,30,17,6,3,16,16,25,49,0.5102040816326531,0
44,83,0.53,13,37,0.351,12,16,0.75,13,36,49,31,7,1,20,23,31,46,0.6739130434782609,1
37,78,0.474,9,27,0.333,15,19,0.789,4,40,44,22,10,5,16,20,28,51,0.5490196078431373,1
35,78,0.449,15,42,0.357,12,21,0.571,6,30,36,24,5,3,13,18,20,36,0.5555555555555556,0
46,86,0.535,24,47,0.511,11,15,0.733,8,32,40,38,8,5,17,22,22,39,0.5641025641025641,1
41,90,0.456,15,45,0.333,23,27,0.852,12,33,45,24,13,1,14,12,26,45,0.5777777777777777,0
41,105,0.39,7,34,0.206,3,10,0.3,13,31,44,26,7,2,10,17,34,71,0.4788732394366197,0
45,85,0.529,12,34,0.353,21,24,0.875,5,49,54,29,5,2,15,10,33,51,0.6470588235294118,1
34,85,0.4,7,25,0.28,20,25,0.8,10,29,39,20,4,7,11,15,27,60,0.45,0
43,101,0.426,17,39,0.436,13,18,0.722,22,38,60,35,3,8,13,22,26,62,0.41935483870967744,1
47,89,0.528,15,29,0.517,20,23,0.87,10,25,35,20,4,3,12,24,32,60,0.5333333333333333,0
47,85,0.553,12,35,0.343,31,35,0.886,8,33,41,29,4,0,11,18,35,50,0.7,1
39,100,0.39,8,32,0.25,16,23,0.696,15,36,51,19,5,5,13,18,31,68,0.45588235294117646,0
40,93,0.43,13,34,0.382,13,18,0.722,14,35,49,19,6,13,17,19,27,59,0.4576271186440678,1
38,87,0.437,19,50,0.38,12,17,0.706,5,33,38,28,3,4,15,18,19,37,0.5135135135135135,0
46,89,0.517,14,29,0.483,15,20,0.75,8,43,51,26,10,1,15,19,32,60,0.5333333333333333,1
38,87,0.437,11,34,0.324,15,17,0.882,10,25,35,24,11,3,17,21,27,53,0.5094339622641509,0
42,70,0.6,10,19,0.526,20,23,0.87,3,34,37,24,8,3,20,17,32,51,0.6274509803921569,1
36,85,0.424,11,35,0.314,19,25,0.76,12,26,38,20,10,2,17,25,25,50,0.5,0
43,86,0.5,13,46,0.283,24,27,0.889,12,36,48,32,9,5,21,23,30,40,0.75,1
40,89,0.449,12,38,0.316,22,24,0.917,16,29,45,22,8,5,17,18,28,51,0.5490196078431373,0
47,91,0.516,9,24,0.375,18,19,0.947,12,29,41,26,6,6,16,20,38,67,0.5671641791044776,1
44,93,0.473,8,29,0.276,15,19,0.789,12,28,40,19,5,3,16,17,36,64,0.5625,0
47,86,0.547,9,28,0.321,16,25,0.64,10,32,42,31,12,8,14,17,38,58,0.6551724137931034,1
35,90,0.389,11,38,0.289,20,30,0.667,12,34,46,26,9,5,15,20,24,52,0.46153846153846156,0
37,85,0.435,14,47,0.298,17,20,0.85,6,34,40,30,9,6,18,25,23,38,0.6052631578947368,1
28,74,0.378,10,43,0.233,17,19,0.895,4,30,34,17,9,5,27,20,18,31,0.5806451612903226,0
49,91,0.538,15,42,0.357,15,21,0.714,11,39,50,30,15,5,14,16,34,49,0.6938775510204082,1
51,97,0.526,11,34,0.324,16,20,0.8,14,34,48,21,10,2,15,28,40,63,0.6349206349206349,1
43,88,0.489,8,24,0.333,25,32,0.781,11,27,38,25,5,5,14,18,35,64,0.546875,0
45,88,0.511,8,28,0.286,12,14,0.857,12,28,40,27,7,5,16,24,37,60,0.6166666666666667,1
43,86,0.5,5,19,0.263,17,26,0.654,15,27,42,28,7,8,18,21,38,67,0.5671641791044776,0
39,90,0.433,15,45,0.333,20,27,0.741,9,36,45,27,11,2,20,25,24,45,0.5333333333333333,1
41,91,0.451,8,30,0.267,19,30,0.633,13,36,49,26,12,10,18,23,33,61,0.5409836065573771,0
44,80,0.55,9,28,0.321,9,13,0.692,4,31,35,31,5,13,15,15,35,52,0.6730769230769231,0
43,99,0.434,16,32,0.5,13,16,0.813,20,29,49,19,9,4,10,12,27,67,0.40298507462686567,1
36,85,0.424,4,22,0.182,29,35,0.829,7,38,45,19,8,7,17,12,32,63,0.5079365079365079,0
48,102,0.471,16,34,0.471,3,5,0.6,8,41,49,23,8,7,15,22,32,68,0.47058823529411764,1
41,89,0.461,9,31,0.29,15,21,0.714,10,38,48,27,6,2,19,23,32,58,0.5517241379310345,0
41,92,0.446,11,30,0.367,22,23,0.957,10,37,47,23,9,6,13,20,30,62,0.4838709677419355,1
44,82,0.537,11,31,0.355,13,21,0.619,5,30,35,20,4,3,14,23,33,51,0.6470588235294118,0
45,84,0.536,17,34,0.5,18,21,0.857,6,32,38,29,4,4,12,22,28,50,0.56,1
38,86,0.442,9,38,0.237,16,18,0.889,8,37,45,20,9,3,19,23,29,48,0.6041666666666666,0
44,92,0.478,6,23,0.261,13,21,0.619,11,33,44,25,8,1,16,15,38,69,0.5507246376811594,1
35,78,0.449,13,31,0.419,13,13,1.0,11,21,32,28,9,4,17,24,22,47,0.46808510638297873,0
41,74,0.554,12,27,0.444,20,23,0.87,11,28,39,22,4,4,17,14,29,47,0.6170212765957447,1
39,86,0.453,11,29,0.379,18,27,0.667,10,33,43,22,5,2,17,13,28,57,0.49122807017543857,0
48,97,0.495,19,51,0.373,9,13,0.692,12,33,45,36,11,5,13,26,29,46,0.6304347826086957,1
47,77,0.61,8,22,0.364,13,17,0.765,8,42,50,31,9,10,23,18,39,55,0.7090909090909091,1
37,96,0.385,16,44,0.364,11,16,0.688,13,17,30,25,16,5,13,16,21,52,0.40384615384615385,0
42,89,0.472,10,38,0.263,11,19,0.579,7,36,43,27,7,5,14,20,32,51,0.6274509803921569,0
39,93,0.419,16,41,0.39,19,22,0.864,14,39,53,20,7,5,13,18,23,52,0.4423076923076923,1
43,87,0.494,18,42,0.429,14,18,0.778,5,30,35,30,9,12,13,20,25,45,0.5555555555555556,1
41,90,0.456,12,38,0.316,19,25,0.76,11,37,48,24,5,3,20,17,29,52,0.5576923076923077,0
42,88,0.477,14,38,0.368,33,41,0.805,17,38,55,31,4,8,19,24,28,50,0.56,1
42,97,0.433,18,40,0.45,24,28,0.857,12,27,39,26,6,7,10,27,24,57,0.42105263157894735,0
47,82,0.573,14,33,0.424,21,30,0.7,8,34,42,33,8,5,21,22,33,49,0.673469387755102,1
41,85,0.482,10,34,0.294,18,28,0.643,8,29,37,31,11,1,20,23,31,51,0.6078431372549019,0
45,82,0.549,17,38,0.447,5,7,0.714,7,32,39,32,10,11,21,24,28,44,0.6363636363636364,1
36,101,0.356,7,29,0.241,19,25,0.76,23,29,52,16,12,2,14,13,29,72,0.4027777777777778,0
44,89,0.494,12,24,0.5,25,27,0.926,8,30,38,24,9,2,7,20,32,65,0.49230769230769234,1
41,83,0.494,18,41,0.439,16,19,0.842,7,31,38,31,4,7,16,21,23,42,0.5476190476190477,0
36,87,0.414,9,36,0.25,23,26,0.885,11,34,45,20,3,4,18,22,27,51,0.5294117647058824,0
41,83,0.494,16,37,0.432,24,27,0.889,4,34,38,27,9,6,10,24,25,46,0.5434782608695652,1
41,96,0.427,9,41,0.22,17,18,0.944,11,34,45,24,7,9,16,27,32,55,0.5818181818181818,0
40,89,0.449,8,25,0.32,22,32,0.688,15,40,55,24,6,4,18,18,32,64,0.5,1
46,97,0.474,11,45,0.244,15,17,0.882,15,27,42,28,12,6,13,15,35,52,0.6730769230769231,0
52,101,0.515,20,45,0.444,5,6,0.833,16,33,49,33,8,3,21,15,32,56,0.5714285714285714,1
39,82,0.476,15,39,0.385,29,36,0.806,6,22,28,14,9,6,14,26,24,43,0.5581395348837209,0
41,87,0.471,12,35,0.343,34,41,0.829,22,37,59,25,9,4,22,29,29,52,0.5576923076923077,1
47,88,0.534,15,41,0.366,8,10,0.8,5,33,38,27,2,8,19,28,32,47,0.6808510638297872,0
43,86,0.5,12,34,0.353,30,38,0.789,5,36,41,28,13,4,10,11,31,52,0.5961538461538461,1
44,89,0.494,10,30,0.333,16,23,0.696,10,27,37,27,9,5,6,24,34,59,0.576271186440678,1
37,68,0.544,11,22,0.5,19,34,0.559,4,29,33,22,1,5,14,20,26,46,0.5652173913043478,0
37,86,0.43,10,31,0.323,27,31,0.871,11,30,41,26,9,4,13,22,27,55,0.4909090909090909,0
47,91,0.516,18,38,0.474,20,27,0.741,13,33,46,26,4,4,14,20,29,53,0.5471698113207547,1
40,93,0.43,11,39,0.282,16,20,0.8,13,32,45,27,7,9,12,18,29,54,0.5370370370370371,0
42,89,0.472,7,26,0.269,19,23,0.826,10,37,47,24,5,5,13,19,35,63,0.5555555555555556,1
34,87,0.391,12,33,0.364,22,26,0.846,10,31,41,12,9,2,9,17,22,54,0.4074074074074074,0
42,83,0.506,15,32,0.469,18,25,0.72,8,35,43,27,4,9,13,22,27,51,0.5294117647058824,1
42,85,0.494,10,32,0.313,38,51,0.745,13,35,48,24,3,3,13,24,32,53,0.6037735849056604,1
46,105,0.438,13,41,0.317,24,28,0.857,12,32,44,27,7,5,10,35,33,64,0.515625,0
44,101,0.436,12,33,0.364,19,23,0.826,14,33,47,25,5,4,15,24,32,68,0.47058823529411764,0
44,95,0.463,7,29,0.241,28,32,0.875,10,40,50,24,7,5,13,21,37,66,0.5606060606060606,1
39,82,0.476,14,36,0.389,15,18,0.833,13,34,47,25,7,1,16,19,25,46,0.5434782608695652,1
34,80,0.425,9,35,0.257,22,27,0.815,9,26,35,20,7,6,14,15,25,45,0.5555555555555556,0
39,92,0.424,9,26,0.346,15,16,0.938,19,30,49,21,6,3,19,22,30,66,0.45454545454545453,0
42,87,0.483,7,29,0.241,17,26,0.654,11,32,43,25,7,7,13,18,35,58,0.603448275862069,1
40,83,0.482,8,27,0.296,17,20,0.85,10,39,49,28,12,5,22,16,32,56,0.5714285714285714,1
38,100,0.38,6,33,0.182,12,16,0.75,20,30,50,21,11,3,16,18,32,67,0.47761194029850745,0
38,97,0.392,10,44,0.227,19,23,0.826,16,25,41,19,12,3,15,15,28,53,0.5283018867924528,0
45,86,0.523,18,36,0.5,10,14,0.714,11,42,53,25,9,3,25,19,27,50,0.54,1
40,79,0.506,13,32,0.406,19,25,0.76,8,32,40,20,5,2,12,19,27,47,0.574468085106383,0
42,92,0.457,6,22,0.273,23,30,0.767,18,30,48,23,8,6,6,20,36,70,0.5142857142857142,1
47,81,0.58,17,33,0.515,32,37,0.865,3,36,39,25,4,7,17,20,30,48,0.625,1
53,105,0.505,18,37,0.486,14,20,0.7,17,30,47,33,8,5,10,32,35,68,0.5147058823529411,0
35,73,0.479,11,39,0.282,19,24,0.792,4,30,34,28,7,5,16,26,24,34,0.7058823529411765,0
38,88,0.432,8,26,0.308,21,26,0.808,17,31,48,20,10,2,13,21,30,62,0.4838709677419355,1
40,82,0.488,9,33,0.273,17,19,0.895,6,40,46,28,8,5,14,16,31,49,0.6326530612244898,1
35,88,0.398,10,36,0.278,18,19,0.947,8,34,42,24,6,3,12,12,25,52,0.4807692307692308,0
44,82,0.537,7,28,0.25,26,33,0.788,6,23,29,23,8,1,4,21,37,54,0.6851851851851852,0
44,80,0.55,16,34,0.471,26,26,1.0,10,28,38,25,2,5,14,23,28,46,0.6086956521739131,1
35,79,0.443,12,33,0.364,15,22,0.682,11,31,42,27,4,2,13,16,23,46,0.5,0
41,78,0.526,15,35,0.429,14,18,0.778,4,34,38,27,6,2,8,24,26,43,0.6046511627906976,1
33,77,0.429,8,28,0.286,28,33,0.848,10,31,41,14,3,4,14,20,25,49,0.5102040816326531,1
36,79,0.456,8,28,0.286,14,26,0.538,7,29,36,14,9,6,16,26,28,51,0.5490196078431373,0
36,94,0.383,9,42,0.214,19,23,0.826,9,30,39,23,14,4,13,28,27,52,0.5192307692307693,0
42,94,0.447,6,32,0.188,24,32,0.75,18,44,62,33,7,4,18,18,36,62,0.5806451612903226,1
41,80,0.513,17,41,0.415,16,25,0.64,6,26,32,23,6,2,13,17,24,39,0.6153846153846154,0
48,86,0.558,17,37,0.459,11,15,0.733,8,32,40,28,8,5,14,24,31,49,0.6326530612244898,1
50,87,0.575,20,47,0.426,17,20,0.85,8,39,47,36,7,6,16,26,30,40,0.75,1
39,88,0.443,14,35,0.4,22,29,0.759,6,25,31,22,7,2,14,19,25,53,0.4716981132075472,0
46,95,0.484,12,32,0.375,23,31,0.742,16,34,50,32,4,2,11,23,34,63,0.5396825396825397,1
44,87,0.506,10,30,0.333,25,30,0.833,12,30,42,30,3,7,8,27,34,57,0.5964912280701754,0
50,77,0.649,11,27,0.407,22,27,0.815,6,37,43,32,10,8,16,19,39,50,0.78,1
36,79,0.456,12,40,0.3,19,25,0.76,7,19,26,21,9,4,16,20,24,39,0.6153846153846154,0
42,86,0.488,11,29,0.379,10,15,0.667,13,24,37,28,7,2,20,14,31,57,0.543859649122807,0
55,93,0.591,24,52,0.462,6,7,0.857,9,30,39,40,10,5,16,18,31,41,0.7560975609756098,1
38,80,0.475,13,31,0.419,13,22,0.591,9,26,35,18,9,5,18,18,25,49,0.5102040816326531,0
44,81,0.543,9,28,0.321,12,14,0.857,8,34,42,20,7,8,18,19,35,53,0.660377358490566,1
39,85,0.459,16,44,0.364,19,25,0.76,12,25,37,25,4,2,17,20,23,41,0.5609756097560976,0
50,88,0.568,12,30,0.4,17,20,0.85,13,30,43,31,8,4,14,22,38,58,0.6551724137931034,1
43,105,0.41,17,49,0.347,13,16,0.813,12,37,49,29,6,10,10,24,26,56,0.4642857142857143,1
40,93,0.43,11,31,0.355,24,31,0.774,18,39,57,23,3,7,14,16,29,62,0.46774193548387094,0
34,92,0.37,12,38,0.316,21,23,0.913,18,29,47,16,11,4,19,22,22,54,0.4074074074074074,0
39,87,0.448,9,32,0.281,18,20,0.9,14,35,49,21,12,8,22,18,30,55,0.5454545454545454,1
37,74,0.5,12,27,0.444,15,22,0.682,8,34,42,26,7,6,20,21,25,47,0.5319148936170213,0
39,86,0.453,10,28,0.357,16,18,0.889,10,27,37,23,10,3,12,19,29,58,0.5,1
50,94,0.532,10,32,0.313,12,14,0.857,11,34,45,26,9,7,17,20,40,62,0.6451612903225806,1
46,88,0.523,9,25,0.36,16,18,0.889,8,29,37,32,9,7,16,15,37,63,0.5873015873015873,0
34,90,0.378,7,38,0.184,13,16,0.813,13,34,47,21,7,3,10,18,27,52,0.5192307692307693,0
37,84,0.44,12,28,0.429,14,17,0.824,7,38,45,23,4,5,12,17,25,56,0.44642857142857145,1
43,93,0.462,6,22,0.273,22,25,0.88,13,37,50,21,6,3,8,17,37,71,0.5211267605633803,1
41,85,0.482,19,49,0.388,6,15,0.4,9,36,45,30,5,4,14,17,22,36,0.6111111111111112,0
42,84,0.5,7,27,0.259,36,42,0.857,15,30,45,20,4,3,18,23,35,57,0.6140350877192983,0
52,91,0.571,15,31,0.484,23,27,0.852,7,27,34,31,12,5,7,25,37,60,0.6166666666666667,1
42,88,0.477,11,43,0.256,18,23,0.783,10,40,50,27,6,3,18,23,31,45,0.6888888888888889,0
42,91,0.462,15,44,0.341,17,27,0.63,8,31,39,21,7,4,14,21,27,47,0.574468085106383,1
54,96,0.563,16,35,0.457,16,21,0.762,17,34,51,31,9,1,14,19,38,61,0.6229508196721312,1
42,83,0.506,13,39,0.333,13,20,0.65,7,23,30,28,7,4,16,17,29,44,0.6590909090909091,0
41,89,0.461,13,31,0.419,23,28,0.821,14,34,48,26,6,7,13,18,28,58,0.4827586206896552,1
42,90,0.467,17,35,0.486,11,15,0.733,9,34,43,24,6,7,11,23,25,55,0.45454545454545453,0
47,90,0.522,18,40,0.45,9,9,1.0,9,23,32,25,8,3,15,21,29,50,0.58,0
46,83,0.554,22,45,0.489,20,23,0.87,11,30,41,32,7,0,18,18,24,38,0.631578947368421,1
39,89,0.438,6,24,0.25,23,34,0.676,14,37,51,19,6,5,14,21,33,65,0.5076923076923077,0
39,84,0.464,11,26,0.423,24,26,0.923,4,31,35,22,8,7,9,25,28,58,0.4827586206896552,1
32,77,0.416,6,26,0.231,15,18,0.833,7,23,30,19,7,1,16,11,26,51,0.5098039215686274,0
45,74,0.608,15,29,0.517,8,10,0.8,6,34,40,28,10,3,19,13,30,45,0.6666666666666666,1
37,88,0.42,12,41,0.293,14,18,0.778,10,29,39,18,5,6,14,20,25,47,0.5319148936170213,0
44,83,0.53,17,32,0.531,15,20,0.75,8,34,42,30,6,8,12,21,27,51,0.5294117647058824,1
42,90,0.467,8,24,0.333,17,21,0.81,12,33,45,21,4,5,12,25,34,66,0.5151515151515151,0
48,97,0.495,14,37,0.378,18,26,0.692,13,35,48,28,5,6,8,18,34,60,0.5666666666666667,1
37,87,0.425,9,26,0.346,18,30,0.6,20,39,59,17,7,4,27,20,28,61,0.45901639344262296,0
41,89,0.461,12,39,0.308,15,19,0.789,5,24,29,26,13,11,13,25,29,50,0.58,1
42,88,0.477,11,38,0.289,13,19,0.684,3,27,30,29,12,7,16,21,31,50,0.62,0
45,86,0.523,14,33,0.424,22,26,0.846,12,40,52,28,10,4,20,16,31,53,0.5849056603773585,1
39,90,0.433,10,35,0.286,21,26,0.808,14,38,52,23,3,6,6,15,29,55,0.5272727272727272,1
42,100,0.42,6,30,0.2,13,20,0.65,19,36,55,18,2,3,8,20,36,70,0.5142857142857142,0
41,92,0.446,10,37,0.27,19,25,0.76,13,31,44,27,5,2,11,20,31,55,0.5636363636363636,0
48,94,0.511,9,27,0.333,14,21,0.667,15,37,52,17,4,4,12,20,39,67,0.582089552238806,1
51,94,0.543,8,32,0.25,15,19,0.789,14,35,49,25,8,3,12,17,43,62,0.6935483870967742,1
39,79,0.494,8,27,0.296,22,25,0.88,6,27,33,26,5,3,18,21,31,52,0.5961538461538461,0
41,82,0.5,4,25,0.16,27,33,0.818,5,30,35,21,5,6,12,19,37,57,0.6491228070175439,0
49,93,0.527,15,33,0.455,19,21,0.905,10,36,46,22,3,5,14,28,34,60,0.5666666666666667,1
40,100,0.4,12,37,0.324,22,30,0.733,12,35,47,28,8,5,16,21,28,63,0.4444444444444444,0
48,95,0.505,16,43,0.372,25,29,0.862,11,47,58,28,8,5,18,25,32,52,0.6153846153846154,1
37,93,0.398,10,30,0.333,28,36,0.778,17,22,39,16,9,5,11,23,27,63,0.42857142857142855,0
45,81,0.556,14,32,0.438,21,28,0.75,13,33,46,24,4,7,18,24,31,49,0.6326530612244898,1
46,86,0.535,19,46,0.413,14,29,0.483,4,26,30,25,8,7,13,24,27,40,0.675,0
51,94,0.543,15,35,0.429,14,24,0.583,13,39,52,29,9,0,13,26,36,59,0.6101694915254238,1
45,85,0.529,12,32,0.375,7,13,0.538,9,24,33,31,8,0,16,12,33,53,0.6226415094339622,0
49,88,0.557,10,28,0.357,9,14,0.643,12,31,43,24,7,3,12,14,39,60,0.65,1
48,101,0.475,11,35,0.314,13,18,0.722,12,38,50,19,11,3,17,24,37,66,0.5606060606060606,1
40,87,0.46,15,45,0.333,21,28,0.75,7,41,48,26,6,2,20,18,25,42,0.5952380952380952,0
38,87,0.437,7,24,0.292,22,30,0.733,11,32,43,16,7,2,14,19,31,63,0.49206349206349204,0
44,82,0.537,11,32,0.344,15,22,0.682,7,34,41,27,7,5,18,27,33,50,0.66,1
39,86,0.453,12,33,0.364,26,35,0.743,18,38,56,23,3,9,14,23,27,53,0.5094339622641509,0
40,95,0.421,12,29,0.414,25,31,0.806,19,26,45,25,6,3,4,24,28,66,0.42424242424242425,1
40,81,0.494,8,23,0.348,8,12,0.667,11,29,40,19,6,4,18,13,32,58,0.5517241379310345,0
41,84,0.488,16,42,0.381,9,9,1.0,5,28,33,22,7,5,13,14,25,42,0.5952380952380952,1
43,93,0.462,9,27,0.333,16,24,0.667,6,38,44,28,7,1,12,28,34,66,0.5151515151515151,0
42,87,0.483,20,50,0.4,15,23,0.652,7,43,50,32,2,5,20,19,22,37,0.5945945945945946,1
40,91,0.44,14,33,0.424,15,17,0.882,10,32,42,23,7,5,13,21,26,58,0.4482758620689655,0
42,97,0.433,11,30,0.367,22,28,0.786,19,38,57,22,8,11,12,18,31,67,0.4626865671641791,1
52,96,0.542,11,26,0.423,18,24,0.75,12,32,44,32,6,4,4,16,41,70,0.5857142857142857,1
50,94,0.532,17,43,0.395,12,15,0.8,10,32,42,29,2,5,10,18,33,51,0.6470588235294118,0
40,81,0.494,8,24,0.333,34,43,0.791,13,28,41,19,12,2,17,22,32,57,0.5614035087719298,1
45,85,0.529,17,37,0.459,14,19,0.737,9,28,37,30,9,5,18,28,28,48,0.5833333333333334,0
40,92,0.435,12,42,0.286,25,26,0.962,10,43,53,25,9,5,9,18,28,50,0.56,1
38,98,0.388,11,39,0.282,12,16,0.75,10,39,49,26,4,4,12,23,27,59,0.4576271186440678,0
40,92,0.435,12,34,0.353,27,33,0.818,9,26,35,25,12,5,19,35,28,58,0.4827586206896552,0
46,83,0.554,15,34,0.441,32,37,0.865,8,39,47,29,7,2,26,28,31,49,0.6326530612244898,1
39,83,0.47,12,32,0.375,15,19,0.789,8,39,47,24,5,8,22,17,27,51,0.5294117647058824,1
34,87,0.391,5,24,0.208,23,26,0.885,9,35,44,15,9,4,14,19,29,63,0.4603174603174603,0
40,91,0.44,3,28,0.107,18,20,0.9,14,31,45,17,6,4,15,14,37,63,0.5873015873015873,0
45,85,0.529,25,52,0.481,5,10,0.5,6,29,35,34,8,5,14,24,20,33,0.6060606060606061,1
46,89,0.517,11,32,0.344,20,30,0.667,8,38,46,31,7,6,9,22,35,57,0.6140350877192983,1
33,93,0.355,9,33,0.273,21,26,0.808,17,33,50,15,4,3,18,23,24,60,0.4,0
48,93,0.516,11,26,0.423,28,35,0.8,13,29,42,26,11,5,21,18,37,67,0.5522388059701493,1
47,89,0.528,10,30,0.333,24,30,0.8,12,32,44,25,13,10,23,23,37,59,0.6271186440677966,0
43,100,0.43,24,61,0.393,11,14,0.786,14,36,50,27,7,5,11,20,19,39,0.48717948717948717,1
35,77,0.455,10,31,0.323,20,28,0.714,7,38,45,18,7,1,20,17,25,46,0.5434782608695652,0
38,78,0.487,11,28,0.393,21,26,0.808,5,24,29,23,9,2,16,20,27,50,0.54,0
47,84,0.56,9,29,0.31,18,25,0.72,12,31,43,31,12,4,17,24,38,55,0.6909090909090909,1
41,85,0.482,10,25,0.4,24,31,0.774,12,37,49,19,5,6,13,20,31,60,0.5166666666666667,1
38,84,0.452,13,36,0.361,22,28,0.786,10,34,44,20,8,4,13,22,25,48,0.5208333333333334,0
35,81,0.432,15,38,0.395,18,20,0.9,8,40,48,18,11,9,17,19,20,43,0.46511627906976744,1
34,84,0.405,9,26,0.346,15,22,0.682,11,34,45,17,6,7,15,18,25,58,0.43103448275862066,0
43,92,0.467,15,35,0.429,21,29,0.724,12,34,46,28,9,5,14,21,28,57,0.49122807017543857,1
37,84,0.44,13,35,0.371,25,30,0.833,8,31,39,26,7,7,15,24,24,49,0.4897959183673469,0
41,81,0.506,8,31,0.258,16,24,0.667,9,34,43,24,5,5,19,22,33,50,0.66,0
41,81,0.506,11,26,0.423,28,36,0.778,6,30,36,29,10,5,11,22,30,55,0.5454545454545454,1
29,83,0.349,8,35,0.229,15,20,0.75,8,31,39,17,7,6,19,15,21,48,0.4375,0
35,86,0.407,5,29,0.172,17,21,0.81,14,40,54,17,6,3,21,16,30,57,0.5263157894736842,1
40,91,0.44,10,33,0.303,10,12,0.833,12,32,44,22,10,5,15,22,30,58,0.5172413793103449,0
42,86,0.488,17,40,0.425,15,22,0.682,11,34,45,32,10,3,15,17,25,46,0.5434782608695652,1
38,86,0.442,9,25,0.36,16,19,0.842,7,32,39,17,9,5,16,16,29,61,0.47540983606557374,0
40,86,0.465,13,43,0.302,17,19,0.895,5,41,46,30,10,2,19,17,27,43,0.627906976744186,1
49,94,0.521,19,37,0.514,16,20,0.8,14,31,45,38,5,0,11,18,30,57,0.5263157894736842,1
38,87,0.437,6,31,0.194,13,18,0.722,12,28,40,19,5,3,19,24,32,56,0.5714285714285714,0
52,96,0.542,10,26,0.385,16,22,0.727,9,42,51,34,5,5,15,14,42,70,0.6,1
49,105,0.467,10,39,0.256,11,15,0.733,11,33,44,24,10,8,10,23,39,66,0.5909090909090909,0
43,95,0.453,12,34,0.353,23,24,0.958,14,35,49,25,8,4,16,19,31,61,0.5081967213114754,1
44,102,0.431,13,38,0.342,13,17,0.765,17,37,54,24,7,4,18,24,31,64,0.484375,0
45,93,0.484,15,36,0.417,14,21,0.667,13,34,47,30,4,5,12,17,30,57,0.5263157894736842,1
47,98,0.48,12,34,0.353,11,17,0.647,14,35,49,29,8,4,10,16,35,64,0.546875,0
40,91,0.44,13,37,0.351,18,26,0.692,13,28,41,28,5,5,13,16,27,54,0.5,0
44,84,0.524,20,41,0.488,22,26,0.846,10,31,41,23,7,6,13,23,24,43,0.5581395348837209,1
43,90,0.478,15,39,0.385,11,18,0.611,7,40,47,26,3,8,17,18,28,51,0.5490196078431373,1
38,94,0.404,13,44,0.295,15,19,0.789,12,35,47,26,6,6,12,19,25,50,0.5,0
39,87,0.448,17,36,0.472,28,36,0.778,11,28,39,23,10,6,20,34,22,51,0.43137254901960786,0
42,94,0.447,14,39,0.359,34,44,0.773,16,35,51,19,9,3,21,27,28,55,0.509090909090909,1
31,79,0.392,14,40,0.35,17,22,0.773,9,36,45,23,7,3,17,11,17,39,0.4358974358974359,0
42,90,0.467,8,32,0.25,9,9,1.0,4,37,41,23,10,5,12,14,34,58,0.5862068965517241,1
38,85,0.447,13,40,0.325,20,26,0.769,7,38,45,31,9,4,17,20,25,45,0.5555555555555556,1
34,93,0.366,8,32,0.25,26,29,0.897,15,37,52,21,8,2,14,19,26,61,0.4262295081967213,0
44,90,0.489,13,36,0.361,15,21,0.714,13,36,49,27,6,3,11,22,31,54,0.5740740740740741,1
39,85,0.459,10,28,0.357,22,30,0.733,12,34,46,19,6,5,13,20,29,57,0.5087719298245614,0
38,89,0.427,6,36,0.167,20,24,0.833,14,29,43,16,4,6,16,13,32,53,0.6037735849056604,0
48,93,0.516,7,27,0.259,13,17,0.765,9,35,44,25,11,3,8,20,41,66,0.6212121212121212,1
36,72,0.5,17,36,0.472,27,31,0.871,4,31,35,27,10,4,17,32,19,36,0.5277777777777778,1
40,78,0.513,13,32,0.406,22,28,0.786,8,28,36,30,8,4,17,28,27,46,0.5869565217391305,0
43,87,0.494,19,41,0.463,11,15,0.733,9,31,40,27,8,1,13,19,24,46,0.5217391304347826,1
33,77,0.429,10,32,0.313,20,26,0.769,7,33,40,21,7,2,15,20,23,45,0.5111111111111111,0
47,88,0.534,10,24,0.417,12,23,0.522,10,30,40,25,4,3,11,18,37,64,0.578125,0
49,86,0.57,12,31,0.387,12,16,0.75,5,34,39,33,3,8,11,20,37,55,0.6727272727272727,1
41,84,0.488,9,31,0.29,20,29,0.69,6,32,38,22,12,6,18,16,32,53,0.6037735849056604,0
45,90,0.5,10,23,0.435,15,17,0.882,6,35,41,29,11,4,19,20,35,67,0.5223880597014925,1
34,92,0.37,14,38,0.368,20,23,0.87,14,34,48,25,9,3,19,16,20,54,0.37037037037037035,0
48,94,0.511,14,38,0.368,13,16,0.813,10,40,50,32,13,9,17,19,34,56,0.6071428571428571,1
43,91,0.473,12,38,0.316,15,16,0.938,8,32,40,19,2,4,8,17,31,53,0.5849056603773585,0
46,96,0.479,14,33,0.424,20,24,0.833,17,33,50,34,3,2,7,15,32,63,0.5079365079365079,1
39,81,0.481,19,42,0.452,18,24,0.75,4,27,31,22,10,4,19,17,20,39,0.5128205128205128,0
44,93,0.473,8,23,0.348,25,27,0.926,16,35,51,25,15,2,23,21,36,70,0.5142857142857142,1
35,90,0.389,15,42,0.357,13,16,0.813,8,34,42,17,5,1,13,23,20,48,0.4166666666666667,0
39,85,0.459,8,27,0.296,18,23,0.783,10,40,50,21,8,9,19,21,31,58,0.5344827586206896,1
32,85,0.376,6,36,0.167,19,24,0.792,11,28,39,16,4,6,11,17,26,49,0.5306122448979592,0
37,83,0.446,17,36,0.472,22,24,0.917,13,42,55,26,6,2,14,23,20,47,0.425531914893617,1
39,95,0.411,15,41,0.366,18,26,0.692,17,36,53,26,3,9,17,19,24,54,0.4444444444444444,0
40,95,0.421,8,28,0.286,28,31,0.903,16,37,53,20,8,5,13,21,32,67,0.47761194029850745,1
49,101,0.485,16,45,0.356,11,13,0.846,11,42,53,29,14,3,13,20,33,56,0.5892857142857143,1
37,93,0.398,8,32,0.25,16,19,0.842,13,36,49,19,5,4,18,17,29,61,0.47540983606557374,0
37,87,0.425,7,33,0.212,32,35,0.914,10,36,46,16,6,3,15,17,30,54,0.5555555555555556,0
47,106,0.443,12,43,0.279,20,24,0.833,17,37,54,25,10,5,11,22,35,63,0.5555555555555556,1
45,98,0.459,14,42,0.333,19,25,0.76,14,28,42,26,8,5,14,18,31,56,0.5535714285714286,0
46,86,0.535,15,35,0.429,17,21,0.81,9,31,40,26,6,7,17,17,31,51,0.6078431372549019,1
37,80,0.463,17,36,0.472,19,21,0.905,7,36,43,24,3,3,16,16,20,44,0.45454545454545453,0
46,90,0.511,12,32,0.375,11,14,0.786,7,36,43,24,11,1,8,20,34,58,0.5862068965517241,1
47,91,0.516,12,30,0.4,15,22,0.682,16,32,48,28,6,5,16,16,35,61,0.5737704918032787,1
44,91,0.484,16,40,0.4,16,16,1.0,13,25,38,30,10,3,13,20,28,51,0.5490196078431373,0
44,98,0.449,10,29,0.345,11,15,0.733,16,26,42,23,3,4,14,19,34,69,0.4927536231884058,0
46,83,0.554,13,36,0.361,13,15,0.867,7,31,38,25,5,7,17,19,33,47,0.7021276595744681,1
46,93,0.495,10,29,0.345,14,16,0.875,12,26,38,21,12,4,18,18,36,64,0.5625,0
45,83,0.542,13,30,0.433,17,21,0.81,9,29,38,30,10,5,21,18,32,53,0.6037735849056604,1
41,93,0.441,13,34,0.382,26,30,0.867,16,32,48,25,6,7,14,21,28,59,0.4745762711864407,1
37,84,0.44,6,26,0.231,22,28,0.786,12,33,45,16,8,6,13,26,31,58,0.5344827586206896,0
35,66,0.53,16,33,0.485,20,32,0.625,5,33,38,21,11,5,19,22,19,33,0.5757575757575758,1
34,79,0.43,10,30,0.333,17,22,0.773,8,28,36,20,7,4,20,23,24,49,0.4897959183673469,0
38,87,0.437,11,32,0.344,19,23,0.826,13,38,51,27,5,4,17,21,27,55,0.4909090909090909,1
41,88,0.466,13,40,0.325,10,24,0.417,12,31,43,21,8,6,11,21,28,48,0.5833333333333334,0
41,77,0.532,10,29,0.345,19,25,0.76,12,26,38,25,6,3,14,19,31,48,0.6458333333333334,0
43,85,0.506,18,41,0.439,17,20,0.85,13,27,40,23,7,2,12,21,25,44,0.5681818181818182,1
36,90,0.4,11,35,0.314,20,27,0.741,13,34,47,23,6,7,19,29,25,55,0.45454545454545453,0
44,91,0.484,9,32,0.281,17,32,0.531,12,36,48,30,11,8,14,19,35,59,0.5932203389830508,1
43,86,0.5,22,44,0.5,9,13,0.692,8,29,37,30,6,3,17,25,21,42,0.5,0
46,90,0.511,8,27,0.296,28,35,0.8,13,31,44,27,10,1,11,15,38,63,0.6031746031746031,1
36,85,0.424,10,35,0.286,27,33,0.818,7,26,33,23,10,5,7,17,26,50,0.52,0
42,71,0.592,10,26,0.385,19,21,0.905,3,40,43,24,3,4,20,27,32,45,0.7111111111111111,1
44,88,0.5,11,31,0.355,23,30,0.767,7,30,37,29,12,4,21,23,33,57,0.5789473684210527,0
48,90,0.533,18,40,0.45,19,22,0.864,7,35,42,30,14,2,23,30,30,50,0.6,1
42,79,0.532,14,35,0.4,20,26,0.769,6,38,44,30,7,3,17,21,28,44,0.6363636363636364,1
39,90,0.433,13,44,0.295,17,24,0.708,12,28,40,22,9,0,11,20,26,46,0.5652173913043478,0
41,90,0.456,11,44,0.25,22,26,0.846,8,29,37,24,5,4,8,17,30,46,0.6521739130434783,0
54,85,0.635,19,34,0.559,17,24,0.708,4,40,44,33,8,5,10,17,35,51,0.6862745098039216,1
38,83,0.458,10,29,0.345,16,20,0.8,7,33,40,25,8,6,11,26,28,54,0.5185185185185185,0
40,85,0.471,12,32,0.375,18,26,0.692,12,36,48,25,6,4,13,14,28,53,0.5283018867924528,1
39,85,0.459,15,41,0.366,17,21,0.81,10,32,42,20,5,6,14,20,24,44,0.5454545454545454,0
47,86,0.547,8,26,0.308,13,16,0.813,6,33,39,28,5,8,9,17,39,60,0.65,1
38,87,0.437,12,40,0.3,19,26,0.731,6,33,39,17,8,6,10,14,26,47,0.5531914893617021,0
47,92,0.511,13,39,0.333,16,20,0.8,11,42,53,26,3,6,15,20,34,53,0.6415094339622641,1
52,100,0.52,9,28,0.321,23,32,0.719,29,30,59,19,7,3,18,24,43,72,0.5972222222222222,1
47,85,0.553,21,44,0.477,18,24,0.75,7,23,30,30,10,3,19,27,26,41,0.6341463414634146,0
42,78,0.538,7,21,0.333,24,31,0.774,9,37,46,24,8,4,18,21,35,57,0.6140350877192983,1
39,81,0.481,13,34,0.382,20,28,0.714,5,27,32,26,5,3,10,22,26,47,0.5531914893617021,0
45,83,0.542,10,23,0.435,18,24,0.75,4,24,28,22,11,4,13,21,35,60,0.5833333333333334,0
43,83,0.518,13,34,0.382,25,28,0.893,11,34,45,20,5,4,16,24,30,49,0.6122448979591837,1
40,94,0.426,19,48,0.396,15,16,0.938,9,33,42,22,9,7,10,16,21,46,0.45652173913043476,1
37,85,0.435,16,34,0.471,17,19,0.895,8,42,50,24,8,3,15,15,21,51,0.4117647058823529,0
48,100,0.48,7,27,0.259,19,23,0.826,13,40,53,28,11,6,19,21,41,73,0.5616438356164384,0
47,98,0.48,13,39,0.333,16,21,0.762,8,37,45,28,3,6,15,22,34,59,0.576271186440678,1
46,84,0.548,11,26,0.423,21,27,0.778,6,36,42,31,8,4,11,14,35,58,0.603448275862069,1
43,93,0.462,17,45,0.378,14,17,0.824,10,30,40,28,9,3,12,19,26,48,0.5416666666666666,0
33,90,0.367,12,43,0.279,14,18,0.778,13,39,52,18,5,6,16,12,21,47,0.44680851063829785,0
40,91,0.44,6,27,0.222,11,12,0.917,10,39,49,23,11,8,12,17,34,64,0.53125,1
49,105,0.467,13,38,0.342,13,17,0.765,19,23,42,34,7,5,15,24,36,67,0.5373134328358209,0
50,86,0.581,8,25,0.32,21,28,0.75,7,36,43,31,10,3,17,26,42,61,0.6885245901639344,1
33,83,0.398,10,39,0.256,23,35,0.657,11,30,41,20,7,0,17,21,23,44,0.5227272727272727,0
40,89,0.449,8,35,0.229,24,27,0.889,15,40,55,19,8,4,17,22,32,54,0.5925925925925926,1
30,75,0.4,6,25,0.24,33,38,0.868,7,21,28,18,9,7,9,25,24,50,0.48,0
36,77,0.468,14,31,0.452,25,31,0.806,11,31,42,25,3,7,18,28,22,46,0.4782608695652174,1
38,93,0.409,11,30,0.367,26,30,0.867,15,30,45,21,12,3,16,24,27,63,0.42857142857142855,0
46,83,0.554,13,27,0.481,26,32,0.813,9,32,41,31,6,6,16,24,33,56,0.5892857142857143,1
42,88,0.477,10,31,0.323,20,21,0.952,10,32,42,21,4,1,13,22,32,57,0.5614035087719298,0
39,93,0.419,22,54,0.407,21,25,0.84,16,34,50,24,4,3,14,19,17,39,0.4358974358974359,1
32,83,0.386,9,34,0.265,14,18,0.778,9,39,48,23,7,2,14,17,23,49,0.46938775510204084,1
28,79,0.354,11,39,0.282,15,20,0.75,8,37,45,16,7,11,18,18,17,40,0.425,0
33,76,0.434,9,39,0.231,18,26,0.692,5,31,36,27,5,6,15,17,24,37,0.6486486486486487,0
44,90,0.489,10,25,0.4,15,21,0.714,11,35,46,18,10,2,10,26,34,65,0.5230769230769231,1
37,104,0.356,12,37,0.324,17,22,0.773,20,19,39,20,13,1,16,17,25,67,0.373134328358209,0
50,83,0.602,13,32,0.406,15,18,0.833,5,44,49,36,8,12,23,17,37,51,0.7254901960784313,1
46,93,0.495,10,27,0.37,10,19,0.526,7,30,37,25,12,2,10,19,36,66,0.5454545454545454,0
48,89,0.539,21,46,0.457,16,21,0.762,11,43,54,32,4,4,19,21,27,43,0.627906976744186,1
45,92,0.489,5,23,0.217,16,17,0.941,15,29,44,21,7,7,15,13,40,69,0.5797101449275363,0
46,97,0.474,9,27,0.333,11,16,0.688,19,27,46,25,6,2,13,19,37,70,0.5285714285714286,1
44,89,0.494,8,27,0.296,16,18,0.889,7,34,41,25,8,7,13,20,36,62,0.5806451612903226,1
37,79,0.468,11,31,0.355,15,22,0.682,6,38,44,21,6,2,20,16,26,48,0.5416666666666666,0
33,103,0.32,13,51,0.255,18,19,0.947,18,26,44,22,13,7,10,24,20,52,0.38461538461538464,0
34,81,0.42,12,35,0.343,31,34,0.912,17,50,67,16,6,9,23,21,22,46,0.4782608695652174,1
46,104,0.442,19,48,0.396,11,16,0.688,13,38,51,27,6,2,14,22,27,56,0.48214285714285715,1
44,93,0.473,8,29,0.276,22,30,0.733,7,42,49,23,7,9,12,17,36,64,0.5625,0
38,95,0.4,20,50,0.4,15,19,0.789,12,25,37,25,7,2,18,22,18,45,0.4,0
45,82,0.549,12,29,0.414,26,32,0.813,12,43,55,22,8,5,23,18,33,53,0.6226415094339622,1
38,92,0.413,10,42,0.238,17,20,0.85,13,35,48,21,5,4,17,22,28,50,0.56,0
43,84,0.512,16,35,0.457,21,27,0.778,4,38,42,34,10,4,12,21,27,49,0.5510204081632653,1
37,93,0.398,4,27,0.148,22,33,0.667,15,28,43,25,12,3,17,17,33,66,0.5,0
49,103,0.476,15,47,0.319,8,12,0.667,19,40,59,31,4,10,22,23,34,56,0.6071428571428571,1
45,91,0.495,18,34,0.529,20,25,0.8,15,33,48,25,7,5,18,25,27,57,0.47368421052631576,1
46,84,0.548,9,28,0.321,19,22,0.864,3,28,31,25,6,7,12,18,37,56,0.6607142857142857,0
48,93,0.516,18,40,0.45,27,36,0.75,12,40,52,25,0,8,16,29,30,53,0.5660377358490566,1
47,114,0.412,17,51,0.333,23,29,0.793,17,35,52,21,7,6,5,29,30,63,0.47619047619047616,0
41,78,0.526,8,24,0.333,15,19,0.789,5,38,43,26,5,2,9,20,33,54,0.6111111111111112,1
29,74,0.392,13,38,0.342,19,26,0.731,6,27,33,17,2,3,13,15,16,36,0.4444444444444444,0
48,91,0.527,19,39,0.487,13,23,0.565,4,20,24,40,10,5,14,28,29,52,0.5576923076923077,0
54,83,0.651,4,16,0.25,29,35,0.829,7,38,45,31,8,7,19,17,50,67,0.746268656716418,1
40,86,0.465,14,33,0.424,25,29,0.862,12,34,46,27,5,4,24,20,26,53,0.49056603773584906,0
44,87,0.506,16,39,0.41,21,25,0.84,5,29,34,30,10,8,18,25,28,48,0.5833333333333334,1
31,74,0.419,4,22,0.182,22,30,0.733,7,36,43,15,9,4,17,20,27,52,0.5192307692307693,0
34,89,0.382,14,46,0.304,17,21,0.81,14,38,52,21,8,2,15,21,20,43,0.46511627906976744,1
37,86,0.43,24,56,0.429,12,15,0.8,7,32,39,25,9,1,14,21,13,30,0.43333333333333335,1
41,82,0.5,9,24,0.375,17,23,0.739,7,37,44,26,7,4,14,16,32,58,0.5517241379310345,0
44,88,0.5,12,35,0.343,24,27,0.889,11,28,39,30,2,6,13,21,32,53,0.6037735849056604,0
47,93,0.505,16,36,0.444,25,30,0.833,14,32,46,28,10,6,14,22,31,57,0.543859649122807,1
49,81,0.605,18,40,0.45,12,17,0.706,5,35,40,26,5,3,17,20,31,41,0.7560975609756098,1
45,97,0.464,11,29,0.379,11,19,0.579,14,26,40,23,9,3,11,16,34,68,0.5,0
45,93,0.484,17,46,0.37,17,20,0.85,13,37,50,29,3,3,15,16,28,47,0.5957446808510638,1
47,94,0.5,6,21,0.286,23,27,0.852,11,28,39,25,8,7,7,18,41,73,0.5616438356164384,0
39,88,0.443,16,47,0.34,17,23,0.739,14,26,40,21,10,6,14,19,23,41,0.5609756097560976,1
44,94,0.468,9,33,0.273,11,17,0.647,18,33,51,22,10,4,15,19,35,61,0.5737704918032787,0
44,95,0.463,9,32,0.281,14,18,0.778,15,38,53,27,8,8,9,18,35,63,0.5555555555555556,1
34,90,0.378,12,33,0.364,15,21,0.714,21,31,52,21,4,3,18,18,22,57,0.38596491228070173,0
35,94,0.372,13,50,0.26,18,27,0.667,11,28,39,22,5,1,9,18,22,44,0.5,0
56,102,0.549,12,32,0.375,18,23,0.783,14,42,56,30,5,7,8,19,44,70,0.6285714285714286,1
47,99,0.475,12,30,0.4,23,28,0.821,19,30,49,24,8,6,18,30,35,69,0.5072463768115942,0
42,92,0.457,18,47,0.383,30,37,0.811,11,33,44,24,8,6,16,25,24,45,0.5333333333333333,1
42,91,0.462,9,33,0.273,24,28,0.857,15,38,53,19,7,1,18,26,33,58,0.5689655172413793,1
35,84,0.417,11,46,0.239,28,34,0.824,10,28,38,17,9,12,14,21,24,38,0.631578947368421,0
37,92,0.402,17,44,0.386,23,32,0.719,15,35,50,19,13,2,12,13,20,48,0.4166666666666667,1
36,77,0.468,12,30,0.4,7,8,0.875,2,37,39,26,3,2,20,25,24,47,0.5106382978723404,0
41,75,0.547,15,29,0.517,28,34,0.824,4,37,41,25,3,5,14,22,26,46,0.5652173913043478,1
39,98,0.398,15,43,0.349,13,19,0.684,15,28,43,26,8,5,13,25,24,55,0.43636363636363634,0
42,80,0.525,11,36,0.306,17,19,0.895,5,28,33,34,6,4,10,22,31,44,0.7045454545454546,0
38,76,0.5,14,31,0.452,28,32,0.875,6,28,34,23,6,2,10,15,24,45,0.5333333333333333,1
39,89,0.438,13,37,0.351,19,25,0.76,10,32,42,21,4,2,12,22,26,52,0.5,0
45,81,0.556,18,43,0.419,22,26,0.846,3,37,40,25,4,5,13,19,27,38,0.7105263157894737,1
43,82,0.524,12,31,0.387,24,29,0.828,4,29,33,30,8,1,14,25,31,51,0.6078431372549019,1
39,85,0.459,10,29,0.345,25,31,0.806,14,32,46,22,7,1,17,26,29,56,0.5178571428571429,0
39,81,0.481,9,27,0.333,21,28,0.75,9,30,39,25,7,4,19,17,30,54,0.5555555555555556,0
48,91,0.527,12,33,0.364,18,24,0.75,11,34,45,29,11,4,15,21,36,58,0.6206896551724138,1
43,87,0.494,12,25,0.48,14,25,0.56,11,32,43,23,16,6,16,18,31,62,0.5,1
41,88,0.466,11,37,0.297,17,21,0.81,9,36,45,29,7,4,22,21,30,51,0.5882352941176471,0
39,94,0.415,17,43,0.395,11,13,0.846,13,35,48,31,8,6,17,21,22,51,0.43137254901960786,0
39,85,0.459,15,38,0.395,25,31,0.806,11,38,49,23,11,5,15,13,24,47,0.5106382978723404,1
46,76,0.605,9,26,0.346,18,23,0.783,4,33,37,22,5,6,15,25,37,50,0.74,1
41,84,0.488,9,24,0.375,25,29,0.862,7,25,32,17,5,1,9,19,32,60,0.5333333333333333,0
36,88,0.409,15,49,0.306,12,19,0.632,5,40,45,19,5,6,12,20,21,39,0.5384615384615384,0
40,94,0.426,7,36,0.194,13,22,0.591,9,42,51,23,6,5,13,24,33,58,0.5689655172413793,1
40,85,0.471,13,36,0.361,14,19,0.737,10,26,36,20,8,4,14,20,27,49,0.5510204081632653,1
36,90,0.4,3,29,0.103,20,29,0.69,18,33,51,19,7,6,17,18,33,61,0.5409836065573771,0
36,84,0.429,9,25,0.36,12,13,0.923,7,35,42,20,10,2,16,21,27,59,0.4576271186440678,0
37,86,0.43,12,29,0.414,16,26,0.615,12,37,49,19,6,5,14,16,25,57,0.43859649122807015,1
39,86,0.453,16,47,0.34,3,6,0.5,7,22,29,24,5,2,14,13,23,39,0.5897435897435898,0
48,90,0.533,18,38,0.474,9,11,0.818,15,39,54,30,5,3,15,13,30,52,0.5769230769230769,1
34,90,0.378,12,45,0.267,29,37,0.784,10,43,53,15,5,5,10,20,22,45,0.4888888888888889,0
38,92,0.413,19,45,0.422,20,31,0.645,9,44,53,29,7,0,10,25,19,47,0.40425531914893614,1
45,77,0.584,14,30,0.467,10,13,0.769,4,32,36,27,2,5,17,27,31,47,0.6595744680851063,0
39,83,0.47,15,41,0.366,25,35,0.714,10,25,35,23,6,3,8,13,24,42,0.5714285714285714,1
42,82,0.512,11,30,0.367,16,23,0.696,8,32,40,25,14,3,14,27,31,52,0.5961538461538461,1
33,77,0.429,10,27,0.37,25,33,0.758,7,31,38,29,8,3,17,19,23,50,0.46,0
33,86,0.384,12,29,0.414,17,19,0.895,6,40,46,20,9,3,13,18,21,57,0.3684210526315789,1
31,89,0.348,12,47,0.255,18,21,0.857,11,43,54,22,7,7,17,17,19,42,0.4523809523809524,0
41,96,0.427,12,38,0.316,21,23,0.913,12,36,48,26,7,7,11,26,29,58,0.5,0
43,94,0.457,11,33,0.333,22,34,0.647,15,40,55,33,6,3,14,17,32,61,0.5245901639344263,1
44,80,0.55,15,29,0.517,21,23,0.913,4,31,35,26,5,8,13,24,29,51,0.5686274509803921,1
42,88,0.477,8,30,0.267,29,34,0.853,11,30,41,20,9,2,9,19,34,58,0.5862068965517241,0
39,83,0.47,8,26,0.308,23,30,0.767,14,35,49,13,7,9,16,21,31,57,0.543859649122807,1
39,90,0.433,13,38,0.342,15,23,0.652,12,32,44,20,5,3,15,28,26,52,0.5,0
44,95,0.463,10,39,0.256,19,24,0.792,10,38,48,24,5,6,10,20,34,56,0.6071428571428571,0
46,92,0.5,11,27,0.407,16,22,0.727,6,37,43,29,4,5,9,18,35,65,0.5384615384615384,1
46,88,0.523,16,38,0.421,18,24,0.75,6,24,30,31,6,1,11,16,30,50,0.6,0
57,87,0.655,23,43,0.535,13,16,0.813,4,35,39,38,5,5,13,21,34,44,0.7727272727272727,1
43,81,0.531,18,39,0.462,22,26,0.846,12,29,41,31,6,2,17,21,25,42,0.5952380952380952,1
40,95,0.421,13,33,0.394,17,22,0.773,18,25,43,21,6,2,14,22,27,62,0.43548387096774194,0
45,95,0.474,12,34,0.353,23,25,0.92,10,35,45,29,8,8,8,17,33,61,0.5409836065573771,0
48,94,0.511,12,32,0.375,18,20,0.9,6,35,41,29,7,3,10,18,36,62,0.5806451612903226,1
36,93,0.387,10,34,0.294,17,23,0.739,15,20,35,19,9,2,14,22,26,59,0.4406779661016949,0
43,70,0.614,15,26,0.577,21,26,0.808,4,41,45,24,5,4,23,20,28,44,0.6363636363636364,1
46,83,0.554,17,34,0.5,15,19,0.789,9,37,46,30,6,6,19,23,29,49,0.5918367346938775,1
40,94,0.426,5,24,0.208,20,31,0.645,16,25,41,23,13,3,11,16,35,70,0.5,0
31,76,0.408,19,45,0.422,25,31,0.806,8,34,42,23,5,5,16,23,12,31,0.3870967741935484,0
42,89,0.472,12,31,0.387,20,24,0.833,9,35,44,19,5,4,11,24,30,58,0.5172413793103449,1
45,81,0.556,13,40,0.325,25,31,0.806,8,36,44,26,8,6,18,21,32,41,0.7804878048780488,1
42,99,0.424,18,45,0.4,17,24,0.708,17,27,44,30,9,0,15,20,24,54,0.4444444444444444,0
44,88,0.5,16,37,0.432,17,21,0.81,14,31,45,26,5,2,16,28,28,51,0.5490196078431373,0
40,88,0.455,11,31,0.355,32,37,0.865,11,28,39,20,7,5,12,21,29,57,0.5087719298245614,1
37,88,0.42,11,40,0.275,16,20,0.8,9,41,50,24,6,3,16,20,26,48,0.5416666666666666,0
32,80,0.4,15,42,0.357,25,27,0.926,4,37,41,22,8,1,16,21,17,38,0.4473684210526316,1
39,87,0.448,12,28,0.429,14,17,0.824,10,28,38,13,5,5,15,16,27,59,0.4576271186440678,0
46,93,0.495,20,39,0.513,18,24,0.75,15,36,51,21,10,5,9,16,26,54,0.48148148148148145,1
49,95,0.516,10,31,0.323,17,23,0.739,11,45,56,26,4,7,14,25,39,64,0.609375,1
45,95,0.474,12,33,0.364,17,31,0.548,10,32,42,23,8,2,8,23,33,62,0.532258064516129,0
36,81,0.444,5,26,0.192,14,21,0.667,7,35,42,25,11,7,16,21,31,55,0.5636363636363636,0
40,89,0.449,10,27,0.37,15,25,0.6,13,35,48,28,9,5,17,19,30,62,0.4838709677419355,1
47,93,0.505,20,46,0.435,12,19,0.632,12,31,43,27,7,5,12,22,27,47,0.574468085106383,1
41,81,0.506,9,25,0.36,20,27,0.741,9,34,43,22,6,1,14,19,32,56,0.5714285714285714,0
40,73,0.548,13,31,0.419,20,24,0.833,5,34,39,24,7,0,17,16,27,42,0.6428571428571429,1
38,81,0.469,15,44,0.341,12,17,0.706,9,26,35,26,9,0,13,16,23,37,0.6216216216216216,0
35,74,0.473,12,35,0.343,12,13,0.923,4,25,29,23,3,2,20,22,23,39,0.5897435897435898,0
45,87,0.517,17,40,0.425,25,32,0.781,14,33,47,27,8,1,12,15,28,47,0.5957446808510638,1
38,80,0.475,11,27,0.407,26,37,0.703,9,32,41,22,9,4,10,14,27,53,0.5094339622641509,1
41,89,0.461,13,32,0.406,15,19,0.789,15,29,44,26,2,1,14,23,28,57,0.49122807017543857,0
43,86,0.5,7,24,0.292,17,22,0.773,8,39,47,20,9,4,11,15,36,62,0.5806451612903226,1
39,91,0.429,14,37,0.378,16,16,1.0,9,38,47,22,6,7,15,15,25,54,0.46296296296296297,0
46,98,0.469,18,39,0.462,7,9,0.778,12,35,47,27,10,3,14,22,28,59,0.4745762711864407,1
39,101,0.386,13,41,0.317,21,25,0.84,25,37,62,26,11,5,17,9,26,60,0.43333333333333335,0
41,83,0.494,12,33,0.364,19,25,0.76,9,27,36,32,6,1,21,14,29,50,0.58,0
54,84,0.643,21,33,0.636,14,16,0.875,3,29,32,42,10,4,15,23,33,51,0.6470588235294118,1
39,83,0.47,13,30,0.433,15,22,0.682,13,33,46,20,7,5,21,23,26,53,0.49056603773584906,0
41,85,0.482,10,32,0.313,22,28,0.786,9,28,37,22,8,3,10,21,31,53,0.5849056603773585,1
41,91,0.451,11,37,0.297,23,33,0.697,11,34,45,19,11,6,11,18,30,54,0.5555555555555556,1
41,88,0.466,17,43,0.395,11,17,0.647,9,40,49,22,6,4,17,23,24,45,0.5333333333333333,0
37,92,0.402,9,31,0.29,22,29,0.759,11,29,40,25,15,2,15,18,28,61,0.45901639344262296,0
41,81,0.506,23,49,0.469,21,23,0.913,5,43,48,29,6,7,27,22,18,32,0.5625,1
34,75,0.453,13,39,0.333,23,27,0.852,7,32,39,17,6,3,13,12,21,36,0.5833333333333334,1
42,85,0.494,8,30,0.267,7,10,0.7,8,31,39,23,7,4,13,24,34,55,0.6181818181818182,0
42,94,0.447,9,34,0.265,20,22,0.909,16,22,38,17,7,4,5,16,33,60,0.55,1
42,76,0.553,11,26,0.423,11,18,0.611,9,29,38,25,2,3,17,19,31,50,0.62,0
39,79,0.494,14,36,0.389,6,9,0.667,9,27,36,29,9,5,20,22,25,43,0.5813953488372093,0
36,77,0.468,8,24,0.333,21,25,0.84,9,28,37,19,9,3,18,16,28,53,0.5283018867924528,1
31,79,0.392,6,23,0.261,25,34,0.735,11,35,46,15,6,1,22,15,25,56,0.44642857142857145,0
41,93,0.441,11,37,0.297,20,22,0.909,13,36,49,27,8,7,12,23,30,56,0.5357142857142857,1
42,84,0.5,11,24,0.458,25,30,0.833,5,34,39,25,6,5,15,24,31,60,0.5166666666666667,0
48,95,0.505,17,47,0.362,21,28,0.75,10,36,46,29,6,2,12,23,31,48,0.6458333333333334,1
43,90,0.478,9,28,0.321,22,27,0.815,14,30,44,23,8,2,17,24,34,62,0.5483870967741935,0
44,91,0.484,13,34,0.382,25,27,0.926,16,30,46,25,10,6,17,24,31,57,0.543859649122807,1
46,82,0.561,7,21,0.333,13,17,0.765,3,34,37,20,5,2,11,15,39,61,0.639344262295082,0
42,86,0.488,16,35,0.457,20,21,0.952,8,32,40,16,5,3,11,16,26,51,0.5098039215686274,1
37,90,0.411,9,33,0.273,22,29,0.759,9,34,43,17,7,3,14,19,28,57,0.49122807017543857,0
49,92,0.533,12,34,0.353,20,24,0.833,8,40,48,30,10,8,8,20,37,58,0.6379310344827587,1
44,91,0.484,10,32,0.313,11,15,0.733,11,34,45,25,3,8,17,18,34,59,0.576271186440678,0
44,100,0.44,13,46,0.283,20,26,0.769,20,33,53,28,9,6,12,16,31,54,0.5740740740740741,1
37,84,0.44,9,37,0.243,17,22,0.773,13,32,45,17,7,1,18,13,28,47,0.5957446808510638,0
46,93,0.495,14,32,0.438,12,13,0.923,12,33,45,30,11,2,12,18,32,61,0.5245901639344263,1
42,84,0.5,19,37,0.514,15,18,0.833,11,34,45,25,10,2,19,20,23,47,0.48936170212765956,1
39,76,0.513,11,33,0.333,18,30,0.6,6,29,35,27,9,4,15,17,28,43,0.6511627906976745,0
39,87,0.448,9,35,0.257,20,26,0.769,13,30,43,24,5,3,14,21,30,52,0.5769230769230769,0
47,81,0.58,10,21,0.476,16,26,0.615,4,34,38,31,9,2,11,19,37,60,0.6166666666666667,1
36,80,0.45,16,44,0.364,24,27,0.889,7,27,34,20,10,7,14,21,20,36,0.5555555555555556,1
37,81,0.457,8,26,0.308,24,28,0.857,12,33,45,26,9,3,15,21,29,55,0.5272727272727272,0
52,94,0.553,16,41,0.39,14,18,0.778,11,30,41,30,11,5,16,21,36,53,0.6792452830188679,1
48,92,0.522,19,44,0.432,15,22,0.682,12,30,42,27,5,1,17,19,29,48,0.6041666666666666,0
40,83,0.482,21,47,0.447,10,14,0.714,9,34,43,26,5,6,16,23,19,36,0.5277777777777778,1
41,95,0.432,13,33,0.394,13,14,0.929,13,25,38,23,7,3,10,13,28,62,0.45161290322580644,0
45,93,0.484,14,31,0.452,14,18,0.778,11,30,41,24,6,4,4,22,31,62,0.5,1
43,86,0.5,16,35,0.457,15,26,0.577,12,35,47,23,2,4,10,17,27,51,0.5294117647058824,0
41,94,0.436,13,37,0.351,33,40,0.825,13,42,55,30,10,4,21,21,28,57,0.49122807017543857,1
47,102,0.461,13,35,0.371,18,25,0.72,10,37,47,27,9,5,18,26,34,67,0.5074626865671642,0
44,97,0.454,12,38,0.316,13,18,0.722,13,25,38,28,10,6,13,18,32,59,0.5423728813559322,0
50,87,0.575,17,32,0.531,16,20,0.8,7,37,44,30,8,2,19,15,33,55,0.6,1
41,81,0.506,14,38,0.368,18,23,0.783,6,27,33,25,5,9,11,16,27,43,0.627906976744186,0
47,88,0.534,12,29,0.414,13,14,0.929,6,33,39,31,7,3,9,20,35,59,0.5932203389830508,1
45,91,0.495,7,23,0.304,28,38,0.737,19,34,53,30,11,5,12,22,38,68,0.5588235294117647,1
38,87,0.437,9,35,0.257,15,26,0.577,11,24,35,23,6,5,15,26,29,52,0.5576923076923077,0
49,88,0.557,10,32,0.313,17,24,0.708,5,35,40,30,9,4,10,23,39,56,0.6964285714285714,1
37,84,0.44,10,32,0.313,27,35,0.771,13,34,47,19,5,2,13,20,27,52,0.5192307692307693,0
42,84,0.5,13,36,0.361,21,27,0.778,8,31,39,22,8,1,15,16,29,48,0.6041666666666666,0
50,85,0.588,19,39,0.487,20,25,0.8,5,30,35,29,9,1,12,18,31,46,0.6739130434782609,1
39,80,0.488,9,28,0.321,28,32,0.875,6,29,35,18,5,2,10,23,30,52,0.5769230769230769,0
44,84,0.524,18,44,0.409,18,25,0.72,11,27,38,31,6,3,11,26,26,40,0.65,1
45,94,0.479,17,35,0.486,18,26,0.692,12,34,46,32,7,9,14,30,28,59,0.4745762711864407,0
45,94,0.479,13,36,0.361,25,34,0.735,12,36,48,29,8,4,13,23,32,58,0.5517241379310345,1
39,94,0.415,9,39,0.231,22,30,0.733,9,35,44,19,5,6,13,23,30,55,0.5454545454545454,0
43,91,0.473,18,44,0.409,19,26,0.731,9,42,51,31,6,5,12,18,25,47,0.5319148936170213,1
39,77,0.506,18,39,0.462,23,29,0.793,5,27,32,22,5,2,8,19,21,38,0.5526315789473685,1
43,90,0.478,12,32,0.375,14,17,0.824,12,34,46,30,4,6,8,19,31,58,0.5344827586206896,0
50,90,0.556,17,44,0.386,16,22,0.727,8,37,45,28,7,5,13,15,33,46,0.717391304347826,1
45,92,0.489,13,35,0.371,15,21,0.714,8,27,35,27,6,2,8,19,32,57,0.5614035087719298,0
47,82,0.573,18,30,0.6,13,17,0.765,7,31,38,27,7,4,17,25,29,52,0.5576923076923077,1
39,82,0.476,13,36,0.361,26,30,0.867,10,23,33,21,8,3,12,14,26,46,0.5652173913043478,0
49,91,0.538,19,44,0.432,25,29,0.862,10,38,48,25,13,3,19,24,30,47,0.6382978723404256,1
44,100,0.44,16,34,0.471,27,34,0.794,16,29,45,32,10,4,18,23,28,66,0.42424242424242425,0
43,79,0.544,15,34,0.441,9,14,0.643,8,36,44,31,4,3,22,14,28,45,0.6222222222222222,0
47,102,0.461,13,49,0.265,6,8,0.75,13,27,40,27,9,3,10,17,34,53,0.6415094339622641,1
35,83,0.422,9,35,0.257,14,20,0.7,6,30,36,23,9,5,13,18,26,48,0.5416666666666666,0
41,90,0.456,12,40,0.3,19,24,0.792,16,38,54,30,10,6,16,19,29,50,0.58,1
41,103,0.398,12,36,0.333,19,25,0.76,18,27,45,25,8,3,13,21,29,67,0.43283582089552236,0
43,86,0.5,14,38,0.368,24,28,0.857,10,40,50,28,8,9,15,20,29,48,0.6041666666666666,1
39,97,0.402,13,43,0.302,31,37,0.838,16,29,45,20,10,3,12,22,26,54,0.48148148148148145,0
48,87,0.552,6,18,0.333,24,34,0.706,6,35,41,27,11,8,14,25,42,69,0.6086956521739131,1
38,95,0.4,14,45,0.311,12,14,0.857,13,36,49,24,5,2,15,16,24,50,0.48,0
43,91,0.473,20,56,0.357,20,23,0.87,9,40,49,32,8,5,11,14,23,35,0.6571428571428571,1
45,103,0.437,16,50,0.32,15,24,0.625,17,38,55,27,5,0,10,23,29,53,0.5471698113207547,0
44,90,0.489,13,46,0.283,25,33,0.758,7,40,47,20,4,5,9,25,31,44,0.7045454545454546,1
38,92,0.413,10,38,0.263,19,25,0.76,9,38,47,22,6,7,14,20,28,54,0.5185185185185185,0
41,95,0.432,8,37,0.216,20,24,0.833,9,40,49,31,3,2,14,22,33,58,0.5689655172413793,1
40,89,0.449,12,30,0.4,22,29,0.759,9,33,42,26,4,3,9,19,28,59,0.4745762711864407,0
47,92,0.511,13,35,0.371,22,27,0.815,7,42,49,28,3,2,13,16,34,57,0.5964912280701754,1
43,87,0.494,17,31,0.548,22,25,0.88,15,32,47,26,7,9,22,23,26,56,0.4642857142857143,1
36,91,0.396,8,30,0.267,28,34,0.824,15,25,40,18,9,6,15,23,28,61,0.45901639344262296,0
46,99,0.465,10,29,0.345,12,14,0.857,16,25,41,20,9,4,15,21,36,70,0.5142857142857142,0
46,86,0.535,13,24,0.542,25,31,0.806,13,32,45,25,10,10,14,18,33,62,0.532258064516129,1
49,90,0.544,17,43,0.395,14,17,0.824,9,37,46,32,4,2,14,16,32,47,0.6808510638297872,1
42,84,0.5,10,28,0.357,16,25,0.64,8,29,37,25,8,5,11,17,32,56,0.5714285714285714,0
41,86,0.477,13,37,0.351,18,21,0.857,10,30,40,34,12,3,13,18,28,49,0.5714285714285714,1
40,82,0.488,10,35,0.286,16,19,0.842,8,31,39,20,8,2,16,18,30,47,0.6382978723404256,0
45,93,0.484,15,38,0.395,19,23,0.826,15,32,47,27,8,3,11,17,30,55,0.5454545454545454,1
43,84,0.512,6,23,0.261,21,26,0.808,10,29,39,24,6,4,12,16,37,61,0.6065573770491803,0
39,84,0.464,6,31,0.194,27,31,0.871,10,29,39,21,8,10,16,24,33,53,0.6226415094339622,0
39,85,0.459,11,33,0.333,27,31,0.871,14,25,39,18,7,8,18,23,28,52,0.5384615384615384,1
42,83,0.506,10,26,0.385,14,17,0.824,5,42,47,22,0,13,12,18,32,57,0.5614035087719298,1
42,97,0.433,8,22,0.364,15,22,0.682,11,36,47,22,5,6,4,14,34,75,0.4533333333333333,0
41,110,0.373,9,44,0.205,22,32,0.688,22,39,61,18,7,6,14,21,32,66,0.48484848484848486,0
42,92,0.457,9,23,0.391,26,30,0.867,7,45,52,21,5,10,14,23,33,69,0.4782608695652174,1
35,85,0.412,5,22,0.227,26,34,0.765,15,32,47,24,5,5,13,26,30,63,0.47619047619047616,0
36,80,0.45,18,42,0.429,31,40,0.775,11,38,49,25,7,4,13,25,18,38,0.47368421052631576,1
37,91,0.407,15,46,0.326,18,26,0.692,10,40,50,26,3,6,12,22,22,45,0.4888888888888889,0
37,87,0.425,16,45,0.356,22,27,0.815,10,41,51,22,6,3,13,26,21,42,0.5,1
37,77,0.481,13,36,0.361,11,15,0.733,8,36,44,25,2,4,26,16,24,41,0.5853658536585366,0
44,92,0.478,11,35,0.314,13,16,0.813,10,27,37,20,14,4,6,15,33,57,0.5789473684210527,1
42,83,0.506,10,29,0.345,24,32,0.75,5,30,35,18,6,8,11,28,32,54,0.5925925925925926,0
39,81,0.481,11,23,0.478,30,43,0.698,9,34,43,22,6,4,15,24,28,58,0.4827586206896552,1
49,85,0.576,12,27,0.444,16,18,0.889,7,27,34,31,6,8,16,24,37,58,0.6379310344827587,0
47,89,0.528,14,31,0.452,19,25,0.76,11,23,34,32,10,6,12,17,33,58,0.5689655172413793,1
39,87,0.448,13,31,0.419,11,16,0.688,11,19,30,25,7,4,11,21,26,56,0.4642857142857143,0
47,82,0.573,8,26,0.308,25,28,0.893,12,34,46,27,7,6,13,15,39,56,0.6964285714285714,1
43,89,0.483,15,39,0.385,9,14,0.643,8,33,41,26,4,4,13,20,28,50,0.56,0
44,91,0.484,11,39,0.282,17,22,0.773,11,38,49,22,3,7,12,17,33,52,0.6346153846153846,1
42,99,0.424,11,36,0.306,18,21,0.857,11,30,41,15,9,1,12,27,31,63,0.49206349206349204,0
46,84,0.548,10,32,0.313,19,29,0.655,12,40,52,33,8,11,18,17,36,52,0.6923076923076923,1
38,86,0.442,12,34,0.353,26,37,0.703,12,36,48,21,5,0,13,23,26,52,0.5,0
47,91,0.516,18,45,0.4,17,25,0.68,6,38,44,30,7,8,9,26,29,46,0.6304347826086957,1
50,96,0.521,12,28,0.429,14,20,0.7,17,27,44,29,7,4,11,17,38,68,0.5588235294117647,0
48,85,0.565,19,31,0.613,20,21,0.952,4,28,32,28,6,8,9,18,29,54,0.5370370370370371,1
38,90,0.422,15,41,0.366,24,31,0.774,13,25,38,20,7,2,13,21,23,49,0.46938775510204084,0
45,88,0.511,11,28,0.393,21,29,0.724,14,34,48,25,5,7,13,23,34,60,0.5666666666666667,1
48,95,0.505,13,29,0.448,10,14,0.714,17,36,53,37,4,4,16,20,35,66,0.5303030303030303,1
39,96,0.406,10,28,0.357,18,24,0.75,17,30,47,21,11,7,8,20,29,68,0.4264705882352941,0
52,96,0.542,10,32,0.313,16,18,0.889,12,43,55,34,7,6,16,17,42,64,0.65625,1
48,101,0.475,11,38,0.289,14,20,0.7,12,29,41,22,6,5,10,19,37,63,0.5873015873015873,0
41,86,0.477,17,39,0.436,19,24,0.792,13,22,35,28,8,1,16,16,24,47,0.5106382978723404,0
53,92,0.576,12,27,0.444,14,15,0.933,12,26,38,21,10,4,14,20,41,65,0.6307692307692307,1
39,87,0.448,14,35,0.4,27,30,0.9,11,25,36,21,13,4,15,19,25,52,0.4807692307692308,0
45,76,0.592,17,28,0.607,17,22,0.773,5,31,36,34,6,1,20,19,28,48,0.5833333333333334,1
42,91,0.462,12,39,0.308,16,23,0.696,17,32,49,22,2,4,16,20,30,52,0.5769230769230769,0
42,91,0.462,17,43,0.395,17,21,0.81,17,29,46,29,9,2,13,22,25,48,0.5208333333333334,1
40,92,0.435,8,30,0.267,26,34,0.765,7,29,36,18,10,5,8,28,32,62,0.5161290322580645,0
43,93,0.462,14,39,0.359,23,33,0.697,20,48,68,25,5,8,21,25,29,54,0.5370370370370371,1
42,75,0.56,14,34,0.412,18,22,0.818,3,26,29,28,5,7,19,22,28,41,0.6829268292682927,0
43,80,0.538,15,31,0.484,26,36,0.722,7,29,36,19,14,3,14,20,28,49,0.5714285714285714,1
42,75,0.56,15,35,0.429,20,25,0.8,4,49,53,33,4,10,26,18,27,40,0.675,1
42,100,0.42,5,27,0.185,11,16,0.688,8,27,35,24,8,2,11,18,37,73,0.5068493150684932,0
46,84,0.548,8,32,0.25,25,30,0.833,7,30,37,30,7,2,13,20,38,52,0.7307692307692307,0
50,90,0.556,12,30,0.4,14,19,0.737,10,28,38,32,5,3,15,21,38,60,0.6333333333333333,1
35,71,0.493,14,30,0.467,20,23,0.87,9,33,42,26,7,1,27,17,21,41,0.5121951219512195,0
40,81,0.494,11,33,0.333,22,26,0.846,8,23,31,20,15,3,12,22,29,48,0.6041666666666666,1
39,85,0.459,13,38,0.342,12,19,0.632,15,35,50,20,9,5,21,18,26,47,0.5531914893617021,1
39,81,0.481,7,21,0.333,17,24,0.708,9,31,40,14,15,6,15,15,32,60,0.5333333333333333,0
48,80,0.6,13,34,0.382,14,19,0.737,2,40,42,26,7,6,14,16,35,46,0.7608695652173914,1
38,96,0.396,11,41,0.268,19,21,0.905,14,31,45,28,7,2,12,17,27,55,0.4909090909090909,0
35,90,0.389,15,51,0.294,23,32,0.719,16,30,46,20,10,5,10,20,20,39,0.5128205128205128,1
29,77,0.377,14,46,0.304,16,23,0.696,12,40,52,20,4,6,25,24,15,31,0.4838709677419355,0
43,80,0.538,16,34,0.471,28,29,0.966,8,31,39,23,7,6,16,23,27,46,0.5869565217391305,0
46,88,0.523,14,38,0.368,25,29,0.862,8,28,36,28,10,4,12,20,32,50,0.64,1
32,91,0.352,8,30,0.267,29,36,0.806,15,31,46,16,6,4,20,21,24,61,0.39344262295081966,0
47,92,0.511,5,29,0.172,17,22,0.773,13,39,52,26,14,11,19,27,42,63,0.6666666666666666,1
43,89,0.483,10,27,0.37,20,28,0.714,15,37,52,21,6,6,14,22,33,62,0.532258064516129,1
36,83,0.434,10,34,0.294,22,26,0.846,9,30,39,17,6,5,15,22,26,49,0.5306122448979592,0
46,99,0.465,11,34,0.324,12,17,0.706,14,42,56,29,7,9,13,24,35,65,0.5384615384615384,1
35,92,0.38,12,36,0.333,14,22,0.636,15,35,50,16,7,6,16,21,23,56,0.4107142857142857,0
50,86,0.581,14,34,0.412,12,21,0.571,6,20,26,21,5,3,5,24,36,52,0.6923076923076923,1
47,85,0.553,8,19,0.421,23,32,0.719,15,33,48,28,1,0,13,21,39,66,0.5909090909090909,0
45,89,0.506,13,39,0.333,23,30,0.767,10,27,37,32,10,1,12,32,32,50,0.64,1
35,81,0.432,17,40,0.425,36,44,0.818,16,33,49,23,6,3,16,23,18,41,0.43902439024390244,0
40,87,0.46,9,33,0.273,22,27,0.815,10,31,41,30,8,3,13,15,31,54,0.5740740740740741,0
45,79,0.57,17,30,0.567,16,18,0.889,1,34,35,31,5,4,17,17,28,49,0.5714285714285714,1
39,96,0.406,15,43,0.349,15,15,1.0,14,33,47,24,7,4,16,18,24,53,0.4528301886792453,0
46,100,0.46,10,32,0.313,16,24,0.667,21,36,57,25,11,8,12,18,36,68,0.5294117647058824,1
50,94,0.532,7,27,0.259,11,16,0.688,12,42,54,29,9,6,18,10,43,67,0.6417910447761194,1
34,96,0.354,13,49,0.265,14,15,0.933,14,30,44,22,11,3,16,15,21,47,0.44680851063829785,0
42,97,0.433,8,31,0.258,11,18,0.611,15,28,43,26,5,4,18,13,34,66,0.5151515151515151,0
58,93,0.624,11,20,0.55,12,15,0.8,7,38,45,31,13,7,13,16,47,73,0.6438356164383562,1
45,93,0.484,10,30,0.333,21,30,0.7,9,44,53,26,6,5,15,21,35,63,0.5555555555555556,1
42,93,0.452,11,32,0.344,20,29,0.69,8,39,47,24,8,7,14,22,31,61,0.5081967213114754,0
47,95,0.495,10,33,0.303,30,34,0.882,6,36,42,22,8,2,7,33,37,62,0.5967741935483871,0
48,92,0.522,16,46,0.348,33,45,0.733,13,34,47,27,1,3,10,27,32,46,0.6956521739130435,1
53,109,0.486,11,35,0.314,24,29,0.828,10,43,53,30,9,10,13,17,42,74,0.5675675675675675,0
54,121,0.446,19,59,0.322,16,24,0.667,23,46,69,34,9,6,19,23,35,62,0.5645161290322581,1
34,81,0.42,13,43,0.302,30,34,0.882,8,33,41,19,8,6,8,19,21,38,0.5526315789473685,1
38,82,0.463,9,29,0.31,21,29,0.724,8,38,46,21,4,4,10,28,29,53,0.5471698113207547,0
41,91,0.451,14,42,0.333,18,23,0.783,12,24,36,26,5,11,11,27,27,49,0.5510204081632653,0
45,93,0.484,10,27,0.37,22,26,0.846,15,35,50,24,4,2,13,19,35,66,0.5303030303030303,1
39,85,0.459,12,36,0.333,20,24,0.833,12,36,48,22,7,2,11,23,27,49,0.5510204081632653,1
29,67,0.433,12,29,0.414,30,34,0.882,3,31,34,19,7,1,15,18,17,38,0.4473684210526316,0
42,91,0.462,11,29,0.379,16,20,0.8,18,27,45,27,8,1,15,21,31,62,0.5,0
45,87,0.517,13,36,0.361,21,27,0.778,11,30,41,29,7,4,12,22,32,51,0.6274509803921569,1
34,87,0.391,10,37,0.27,5,7,0.714,5,31,36,22,4,0,8,17,24,50,0.48,0
36,74,0.486,13,33,0.394,17,25,0.68,5,40,45,26,1,2,8,13,23,41,0.5609756097560976,1
42,84,0.5,11,29,0.379,16,20,0.8,10,39,49,26,3,6,17,22,31,55,0.5636363636363636,0
41,86,0.477,15,35,0.429,23,28,0.821,7,28,35,26,9,6,10,22,26,51,0.5098039215686274,1
34,82,0.415,6,18,0.333,32,41,0.78,9,36,45,16,8,4,21,27,28,64,0.4375,0
48,84,0.571,14,31,0.452,25,35,0.714,6,38,44,29,16,6,18,27,34,53,0.6415094339622641,1
42,97,0.433,8,27,0.296,21,23,0.913,14,32,46,27,9,4,10,16,34,70,0.4857142857142857,0
48,100,0.48,11,40,0.275,16,17,0.941,15,34,49,27,8,6,12,14,37,60,0.6166666666666667,1
40,88,0.455,12,40,0.3,25,31,0.806,11,27,38,29,4,7,17,15,28,48,0.5833333333333334,0
58,98,0.592,20,40,0.5,14,22,0.636,9,35,44,31,14,3,13,23,38,58,0.6551724137931034,1
46,86,0.535,9,32,0.281,16,18,0.889,7,33,40,23,7,4,18,26,37,54,0.6851851851851852,1
38,88,0.432,13,44,0.295,26,29,0.897,12,32,44,21,9,3,16,19,25,44,0.5681818181818182,0
42,91,0.462,12,37,0.324,16,21,0.762,5,29,34,24,9,7,11,22,30,54,0.5555555555555556,0
43,81,0.531,8,20,0.4,27,29,0.931,6,40,46,21,7,7,17,16,35,61,0.5737704918032787,1
47,94,0.5,9,30,0.3,28,37,0.757,11,48,59,28,10,8,14,16,38,64,0.59375,1
38,94,0.404,11,38,0.289,20,24,0.833,10,34,44,25,11,8,12,23,27,56,0.48214285714285715,0
32,81,0.395,10,28,0.357,14,18,0.778,8,41,49,24,8,3,15,19,22,53,0.41509433962264153,0
30,77,0.39,11,36,0.306,19,23,0.826,7,39,46,15,9,4,15,17,19,41,0.4634146341463415,1
45,92,0.489,16,36,0.444,16,23,0.696,11,30,41,29,9,1,10,11,29,56,0.5178571428571429,1
45,87,0.517,15,40,0.375,14,15,0.933,9,31,40,31,3,4,14,20,30,47,0.6382978723404256,0
43,95,0.453,8,29,0.276,15,21,0.714,14,29,43,24,9,4,13,20,35,66,0.5303030303030303,0
40,81,0.494,8,27,0.296,24,30,0.8,9,33,42,20,10,4,17,18,32,54,0.5925925925925926,1
33,75,0.44,9,29,0.31,31,42,0.738,12,27,39,18,8,7,18,30,24,46,0.5217391304347826,0
39,76,0.513,9,24,0.375,26,36,0.722,8,25,33,25,8,6,15,30,30,52,0.5769230769230769,1
39,88,0.443,12,38,0.316,18,27,0.667,12,31,43,25,10,4,13,22,27,50,0.54,0
41,89,0.461,14,38,0.368,23,26,0.885,15,36,51,25,6,6,15,19,27,51,0.5294117647058824,1
41,82,0.5,11,28,0.393,21,26,0.808,9,29,38,25,5,3,17,24,30,54,0.5555555555555556,0
45,94,0.479,10,31,0.323,17,26,0.654,14,33,47,16,7,6,14,21,35,63,0.5555555555555556,1
36,89,0.404,15,37,0.405,28,31,0.903,9,24,33,23,9,3,9,23,21,52,0.40384615384615385,0
42,81,0.519,13,33,0.394,29,36,0.806,13,36,49,26,6,5,17,22,29,48,0.6041666666666666,1
45,95,0.474,13,36,0.361,23,26,0.885,13,32,45,31,7,8,13,18,32,59,0.5423728813559322,0
48,98,0.49,14,36,0.389,19,22,0.864,14,32,46,24,4,7,11,19,34,62,0.5483870967741935,1
45,84,0.536,10,30,0.333,20,22,0.909,7,37,44,21,9,4,16,21,35,54,0.6481481481481481,1
41,88,0.466,10,25,0.4,25,27,0.926,10,32,42,26,9,3,11,19,31,63,0.49206349206349204,0
35,88,0.398,13,39,0.333,21,30,0.7,13,60,73,26,4,4,28,24,22,49,0.4489795918367347,1
38,116,0.328,9,46,0.196,16,20,0.8,14,33,47,22,10,4,9,23,29,70,0.4142857142857143,0
41,84,0.488,16,43,0.372,26,31,0.839,10,42,52,29,6,8,11,22,25,41,0.6097560975609756,1
34,90,0.378,7,32,0.219,20,25,0.8,11,31,42,15,4,3,11,19,27,58,0.46551724137931033,0
34,91,0.374,5,37,0.135,18,25,0.72,8,33,41,24,7,3,8,14,29,54,0.5370370370370371,0
45,89,0.506,14,36,0.389,18,21,0.857,10,47,57,28,6,5,12,16,31,53,0.5849056603773585,1
46,93,0.495,19,48,0.396,20,21,0.952,9,33,42,33,10,5,8,20,27,45,0.6,1
38,92,0.413,15,42,0.357,23,26,0.885,14,35,49,19,4,3,15,21,23,50,0.46,0
48,92,0.522,12,36,0.333,15,23,0.652,9,40,49,24,5,3,13,22,36,56,0.6428571428571429,1
39,84,0.464,11,36,0.306,26,30,0.867,7,32,39,23,6,3,11,22,28,48,0.5833333333333334,0
40,88,0.455,10,26,0.385,18,32,0.563,18,22,40,30,7,5,7,18,30,62,0.4838709677419355,0
43,81,0.531,17,35,0.486,18,23,0.783,13,36,49,28,5,4,14,23,26,46,0.5652173913043478,1
38,94,0.404,9,33,0.273,14,17,0.824,12,40,52,30,5,1,18,19,29,61,0.47540983606557374,0
38,84,0.452,7,25,0.28,25,28,0.893,4,37,41,22,11,6,14,22,31,59,0.5254237288135594,1
44,96,0.458,9,31,0.29,17,22,0.773,7,32,39,24,8,5,12,15,35,65,0.5384615384615384,0
51,93,0.548,16,35,0.457,12,16,0.75,7,44,51,33,6,5,18,18,35,58,0.603448275862069,1
53,102,0.52,20,48,0.417,12,19,0.632,13,36,49,32,11,3,5,17,33,54,0.6111111111111112,1
37,84,0.44,20,48,0.417,15,24,0.625,12,33,45,22,5,4,17,18,17,36,0.4722222222222222,0
44,100,0.44,9,25,0.36,18,27,0.667,18,22,40,22,13,3,10,19,35,75,0.4666666666666667,0
46,81,0.568,13,35,0.371,23,29,0.793,10,35,45,28,4,7,20,22,33,46,0.717391304347826,1
37,85,0.435,15,33,0.455,19,20,0.95,10,33,43,26,8,12,13,23,22,52,0.4230769230769231,1
35,88,0.398,12,29,0.414,20,25,0.8,14,37,51,16,7,4,16,20,23,59,0.3898305084745763,0
38,79,0.481,7,24,0.292,27,36,0.75,11,35,46,21,6,2,20,18,31,55,0.5636363636363636,0
50,98,0.51,17,37,0.459,10,14,0.714,11,30,41,30,9,6,10,26,33,61,0.5409836065573771,1
48,84,0.571,20,34,0.588,10,17,0.588,8,37,45,33,3,4,12,14,28,50,0.56,1
40,92,0.435,18,41,0.439,14,18,0.778,12,26,38,28,6,3,7,15,22,51,0.43137254901960786,0
33,78,0.423,12,38,0.316,26,31,0.839,5,32,37,19,10,3,13,14,21,40,0.525,1
34,82,0.415,6,23,0.261,22,25,0.88,8,36,44,22,5,2,14,20,28,59,0.4745762711864407,0
44,93,0.473,11,31,0.355,10,17,0.588,15,22,37,23,11,0,16,22,33,62,0.532258064516129,0
45,81,0.556,9,24,0.375,22,26,0.846,7,37,44,27,8,4,18,16,36,57,0.631578947368421,1
39,83,0.47,16,37,0.432,18,26,0.692,13,38,51,19,3,4,13,23,23,46,0.5,1
35,83,0.422,10,29,0.345,28,35,0.8,12,34,46,22,7,3,7,23,25,54,0.46296296296296297,0
46,93,0.495,12,41,0.293,14,18,0.778,7,32,39,36,6,2,10,24,34,52,0.6538461538461539,0
44,83,0.53,13,28,0.464,25,32,0.781,7,37,44,22,4,4,10,22,31,55,0.5636363636363636,1
45,94,0.479,5,29,0.172,22,35,0.629,15,29,44,26,14,4,13,25,40,65,0.6153846153846154,0
42,74,0.568,13,29,0.448,30,38,0.789,5,34,39,23,5,7,17,24,29,45,0.6444444444444445,1
44,87,0.506,13,32,0.406,14,24,0.583,7,37,44,26,12,2,11,14,31,55,0.5636363636363636,1
33,88,0.375,18,58,0.31,17,21,0.81,11,38,49,26,7,1,16,17,15,30,0.5,0
50,82,0.61,9,21,0.429,27,33,0.818,10,28,38,26,4,3,17,25,41,61,0.6721311475409836,1
45,86,0.523,14,32,0.438,30,37,0.811,13,21,34,25,5,4,14,26,31,54,0.5740740740740741,0
47,95,0.495,15,34,0.441,12,18,0.667,8,35,43,30,6,10,14,15,32,61,0.5245901639344263,1
49,100,0.49,7,25,0.28,11,14,0.786,12,39,51,25,6,3,13,20,42,75,0.56,0
46,94,0.489,11,37,0.297,20,23,0.87,14,30,44,24,12,5,14,17,35,57,0.6140350877192983,1
44,87,0.506,8,23,0.348,15,18,0.833,10,33,43,25,9,2,23,20,36,64,0.5625,0
38,80,0.475,10,28,0.357,18,22,0.818,9,35,44,23,8,4,19,18,28,52,0.5384615384615384,1
38,89,0.427,11,36,0.306,9,15,0.6,12,29,41,26,8,7,20,19,27,53,0.5094339622641509,0
38,88,0.432,11,33,0.333,24,27,0.889,13,36,49,25,8,4,18,26,27,55,0.4909090909090909,0
38,87,0.437,13,38,0.342,27,33,0.818,8,33,41,27,14,7,16,22,25,49,0.5102040816326531,1
44,89,0.494,8,26,0.308,16,20,0.8,7,36,43,22,7,9,9,18,36,63,0.5714285714285714,1
37,95,0.389,10,30,0.333,24,31,0.774,21,38,59,25,6,5,11,19,27,65,0.4153846153846154,0
45,88,0.511,10,32,0.313,18,22,0.818,8,38,46,29,7,9,21,18,35,56,0.625,0
46,102,0.451,15,38,0.395,16,22,0.727,13,26,39,28,16,7,10,19,31,64,0.484375,1
39,76,0.513,12,33,0.364,12,15,0.8,6,34,40,22,8,8,19,21,27,43,0.627906976744186,1
38,92,0.413,13,35,0.371,12,17,0.706,16,25,41,22,8,4,12,17,25,57,0.43859649122807015,0
31,73,0.425,14,39,0.359,33,42,0.786,8,31,39,21,3,1,13,19,17,34,0.5,0
46,95,0.484,12,28,0.429,16,20,0.8,13,35,48,27,5,8,8,26,34,67,0.5074626865671642,1
45,78,0.577,11,29,0.379,11,17,0.647,3,36,39,29,8,5,14,12,34,49,0.6938775510204082,1
37,84,0.44,14,26,0.538,10,11,0.909,6,30,36,22,7,2,16,14,23,58,0.39655172413793105,0
34,76,0.447,9,30,0.3,28,37,0.757,10,32,42,19,5,4,24,24,25,46,0.5434782608695652,0
40,91,0.44,12,31,0.387,25,29,0.862,13,28,41,26,12,8,10,28,28,60,0.4666666666666667,1
39,86,0.453,12,35,0.343,9,14,0.643,6,36,42,19,6,1,8,18,27,51,0.5294117647058824,0
38,87,0.437,11,41,0.268,20,21,0.952,9,41,50,25,2,7,9,12,27,46,0.5869565217391305,1
41,93,0.441,8,28,0.286,19,25,0.76,11,33,44,20,12,2,14,14,33,65,0.5076923076923077,0
46,99,0.465,15,42,0.357,15,17,0.882,14,41,55,29,7,11,17,19,31,57,0.543859649122807,1
44,97,0.454,11,32,0.344,14,16,0.875,12,30,42,28,8,1,14,24,33,65,0.5076923076923077,0
45,91,0.495,11,26,0.423,20,35,0.571,11,39,50,26,9,7,14,15,34,65,0.5230769230769231,1
39,89,0.438,19,49,0.388,14,18,0.778,12,36,48,27,3,5,14,17,20,40,0.5,1
38,100,0.38,11,41,0.268,20,22,0.909,18,30,48,16,8,1,7,14,27,59,0.4576271186440678,0
41,90,0.456,14,44,0.318,15,20,0.75,9,32,41,24,7,7,13,18,27,46,0.5869565217391305,0
52,97,0.536,23,46,0.5,9,12,0.75,11,37,48,39,4,1,11,16,29,51,0.5686274509803921,1
49,93,0.527,10,26,0.385,24,31,0.774,12,32,44,24,9,5,10,21,39,67,0.582089552238806,1
42,82,0.512,14,34,0.412,14,18,0.778,7,30,37,26,5,1,20,25,28,48,0.5833333333333334,0
41,90,0.456,14,31,0.452,29,31,0.935,19,38,57,26,5,7,22,22,27,59,0.4576271186440678,1
37,96,0.385,18,48,0.375,21,27,0.778,16,29,45,24,13,2,17,26,19,48,0.3958333333333333,0
30,69,0.435,12,38,0.316,29,36,0.806,3,29,32,15,5,6,12,17,18,31,0.5806451612903226,0
39,86,0.453,12,31,0.387,23,30,0.767,12,34,46,20,7,4,10,23,27,55,0.4909090909090909,1
44,91,0.484,9,35,0.257,14,21,0.667,14,30,44,27,8,3,19,27,35,56,0.625,0
31,79,0.392,10,33,0.303,40,40,1.0,13,28,41,18,10,4,20,19,21,46,0.45652173913043476,1
36,89,0.404,14,39,0.359,30,36,0.833,3,23,26,23,9,5,11,22,22,50,0.44,0
54,89,0.607,11,31,0.355,28,30,0.933,10,45,55,36,7,8,19,29,43,58,0.7413793103448276,1
40,78,0.513,9,24,0.375,20,25,0.8,6,29,35,19,10,2,16,20,31,54,0.5740740740740741,1
42,87,0.483,6,35,0.171,16,19,0.842,13,30,43,22,10,7,17,22,36,52,0.6923076923076923,0
47,86,0.547,15,35,0.429,11,15,0.733,6,28,34,33,6,4,10,19,32,51,0.6274509803921569,0
45,91,0.495,20,44,0.455,22,27,0.815,18,31,49,32,4,4,11,17,25,47,0.5319148936170213,1
42,90,0.467,10,37,0.27,20,24,0.833,7,30,37,18,7,7,5,25,32,53,0.6037735849056604,0
38,87,0.437,10,36,0.278,30,37,0.811,15,39,54,21,3,3,16,17,28,51,0.5490196078431373,1
45,98,0.459,18,48,0.375,6,11,0.545,14,43,57,28,6,4,11,15,27,50,0.54,1
39,87,0.448,11,30,0.367,16,18,0.889,6,35,41,25,5,3,11,12,28,57,0.49122807017543857,0
45,87,0.517,11,30,0.367,13,17,0.765,4,29,33,22,5,4,9,17,34,57,0.5964912280701754,0
44,91,0.484,15,44,0.341,22,25,0.88,11,39,50,24,7,5,9,16,29,47,0.6170212765957447,1
39,90,0.433,9,32,0.281,10,14,0.714,15,29,44,28,4,2,20,17,30,58,0.5172413793103449,0
48,85,0.565,15,34,0.441,15,21,0.714,7,31,38,30,9,4,11,20,33,51,0.6470588235294118,1
43,88,0.489,16,33,0.485,16,21,0.762,13,23,36,22,7,2,19,22,27,55,0.4909090909090909,0
48,80,0.6,17,32,0.531,22,28,0.786,7,31,38,30,10,7,17,20,31,48,0.6458333333333334,1
50,107,0.467,11,34,0.324,18,23,0.783,17,31,48,33,7,11,12,18,39,73,0.5342465753424658,0
52,101,0.515,14,22,0.636,17,25,0.68,17,40,57,19,6,8,14,17,38,79,0.4810126582278481,1
43,90,0.478,12,39,0.308,15,21,0.714,8,33,41,27,8,5,13,25,31,51,0.6078431372549019,0
38,84,0.452,15,42,0.357,28,33,0.848,12,38,50,21,9,4,15,16,23,42,0.5476190476190477,1
44,96,0.458,16,41,0.39,11,17,0.647,8,40,48,30,7,3,14,23,28,55,0.509090909090909,0
45,94,0.479,19,48,0.396,26,31,0.839,9,36,45,28,4,4,9,19,26,46,0.5652173913043478,1
41,88,0.466,9,29,0.31,6,9,0.667,8,31,39,16,7,6,12,19,32,59,0.5423728813559322,0
38,82,0.463,7,23,0.304,17,21,0.81,12,40,52,21,5,3,18,18,31,59,0.5254237288135594,1
41,86,0.477,12,36,0.333,15,17,0.882,12,36,48,23,4,6,14,15,29,50,0.58,1
38,84,0.452,13,34,0.382,9,11,0.818,4,27,31,26,8,9,12,19,25,50,0.5,0
48,96,0.5,14,42,0.333,9,17,0.529,3,51,54,25,4,9,19,26,34,54,0.6296296296296297,1
44,112,0.393,10,41,0.244,17,27,0.63,14,42,56,24,7,4,10,18,34,71,0.4788732394366197,0
35,87,0.402,22,57,0.386,10,15,0.667,8,31,39,20,10,2,11,12,13,30,0.43333333333333335,0
42,95,0.442,9,34,0.265,15,16,0.938,18,43,61,22,8,1,13,8,33,61,0.5409836065573771,1
44,86,0.512,14,33,0.424,31,33,0.939,5,34,39,28,7,6,11,22,30,53,0.5660377358490566,1
39,88,0.443,11,36,0.306,25,27,0.926,9,30,39,30,4,3,17,29,28,52,0.5384615384615384,0
44,89,0.494,7,22,0.318,24,31,0.774,12,32,44,28,6,1,11,19,37,67,0.5522388059701493,1
40,78,0.513,11,33,0.333,22,29,0.759,5,31,36,17,6,4,17,27,29,45,0.6444444444444445,0
41,77,0.532,13,33,0.394,19,27,0.704,9,33,42,27,6,5,22,30,28,44,0.6363636363636364,0
43,83,0.518,10,28,0.357,28,36,0.778,8,24,32,30,15,4,9,23,33,55,0.6,1
47,92,0.511,11,33,0.333,19,22,0.864,12,34,46,22,12,6,11,19,36,59,0.6101694915254238,1
38,85,0.447,12,38,0.316,22,24,0.917,10,32,42,30,7,5,16,17,26,47,0.5531914893617021,0
42,86,0.488,11,31,0.355,21,30,0.7,8,40,48,29,7,3,17,21,31,55,0.5636363636363636,1
43,90,0.478,7,30,0.233,17,24,0.708,7,35,42,20,7,3,13,23,36,60,0.6,0
41,94,0.436,16,33,0.485,15,21,0.714,14,36,50,26,6,9,14,22,25,61,0.4098360655737705,1
40,101,0.396,7,30,0.233,24,29,0.828,19,32,51,24,8,9,12,22,33,71,0.4647887323943662,0
41,82,0.5,14,33,0.424,19,25,0.76,10,33,43,24,7,4,11,11,27,49,0.5510204081632653,1
41,87,0.471,10,29,0.345,11,14,0.786,11,32,43,20,6,3,12,18,31,58,0.5344827586206896,0
41,86,0.477,14,23,0.609,20,24,0.833,9,34,43,28,10,3,19,20,27,63,0.42857142857142855,0
47,90,0.522,10,28,0.357,17,20,0.85,4,33,37,24,13,3,15,22,37,62,0.5967741935483871,1
43,91,0.473,12,37,0.324,16,25,0.64,12,22,34,23,10,4,15,24,31,54,0.5740740740740741,0
47,86,0.547,20,40,0.5,25,29,0.862,14,32,46,34,10,8,14,19,27,46,0.5869565217391305,1
55,101,0.545,18,48,0.375,16,20,0.8,12,43,55,33,9,6,13,26,37,53,0.6981132075471698,1
40,88,0.455,8,22,0.364,25,34,0.735,7,31,38,26,6,3,15,19,32,66,0.48484848484848486,0
42,96,0.438,14,36,0.389,10,16,0.625,11,29,40,23,13,3,15,25,28,60,0.4666666666666667,0
36,83,0.434,11,35,0.314,29,40,0.725,17,42,59,15,9,11,24,18,25,48,0.5208333333333334,1
41,92,0.446,8,29,0.276,22,31,0.71,14,40,54,15,3,6,7,23,33,63,0.5238095238095238,1
36,93,0.387,13,42,0.31,23,26,0.885,12,38,50,18,3,4,8,23,23,51,0.45098039215686275,0
47,99,0.475,19,53,0.358,9,10,0.9,14,32,46,35,8,4,7,15,28,46,0.6086956521739131,1
41,88,0.466,8,27,0.296,16,19,0.842,10,36,46,21,3,2,11,11,33,61,0.5409836065573771,0
48,87,0.552,12,32,0.375,22,28,0.786,7,38,45,32,11,8,16,21,36,55,0.6545454545454545,1
38,103,0.369,11,47,0.234,25,28,0.893,16,33,49,26,5,8,20,20,27,56,0.48214285714285715,0
34,84,0.405,19,48,0.396,8,12,0.667,7,25,32,26,7,2,10,13,15,36,0.4166666666666667,0
45,87,0.517,11,22,0.5,10,12,0.833,13,38,51,17,9,3,11,14,34,65,0.5230769230769231,1
37,76,0.487,8,28,0.286,20,23,0.87,8,32,40,24,5,2,18,17,29,48,0.6041666666666666,0
45,80,0.563,9,28,0.321,11,15,0.733,4,27,31,22,10,5,15,21,36,52,0.6923076923076923,1
43,82,0.524,22,46,0.478,11,19,0.579,2,23,25,28,4,3,11,18,21,36,0.5833333333333334,0
49,88,0.557,17,41,0.415,21,22,0.955,10,37,47,34,7,4,12,20,32,47,0.6808510638297872,1
43,84,0.512,11,27,0.407,17,18,0.944,5,35,40,19,6,4,12,22,32,57,0.5614035087719298,1
36,87,0.414,7,29,0.241,24,30,0.8,11,32,43,19,9,3,14,19,29,58,0.5,0
40,89,0.449,17,39,0.436,21,26,0.808,9,28,37,23,5,5,8,17,23,50,0.46,1
43,90,0.478,12,40,0.3,19,23,0.826,10,38,48,20,5,6,12,24,31,50,0.62,0
40,90,0.444,12,31,0.387,20,26,0.769,11,39,50,21,5,7,9,14,28,59,0.4745762711864407,1
39,91,0.429,12,41,0.293,12,19,0.632,14,37,51,24,4,7,16,21,27,50,0.54,0
41,83,0.494,21,51,0.412,15,22,0.682,7,33,40,35,6,4,23,22,20,32,0.625,0
48,95,0.505,15,39,0.385,21,24,0.875,7,31,38,29,12,1,10,18,33,56,0.5892857142857143,1
41,84,0.488,7,29,0.241,27,34,0.794,10,29,39,24,7,2,13,17,34,55,0.6181818181818182,0
48,89,0.539,13,39,0.333,10,19,0.526,12,29,41,32,10,5,16,22,35,50,0.7,1
40,88,0.455,12,30,0.4,25,31,0.806,18,34,52,17,3,6,8,12,28,58,0.4827586206896552,1
37,83,0.446,18,44,0.409,12,15,0.8,9,29,38,23,4,4,12,22,19,39,0.48717948717948717,0
38,84,0.452,7,31,0.226,17,23,0.739,10,29,39,22,8,6,20,17,31,53,0.5849056603773585,0
46,88,0.523,14,32,0.438,15,21,0.714,11,33,44,21,13,6,17,16,32,56,0.5714285714285714,1
43,85,0.506,12,34,0.353,15,19,0.789,5,33,38,29,3,7,10,16,31,51,0.6078431372549019,1
48,87,0.552,6,20,0.3,10,13,0.769,4,34,38,28,4,6,11,19,42,67,0.6268656716417911,0
41,89,0.461,14,42,0.333,27,33,0.818,13,26,39,31,3,2,9,29,27,47,0.574468085106383,0
43,85,0.506,17,44,0.386,37,42,0.881,8,33,41,28,3,6,8,29,26,41,0.6341463414634146,1
49,89,0.551,14,30,0.467,20,25,0.8,7,31,38,24,5,2,6,19,35,59,0.5932203389830508,1
48,93,0.516,10,26,0.385,13,20,0.65,11,29,40,27,1,3,10,21,38,67,0.5671641791044776,0
43,89,0.483,8,31,0.258,19,20,0.95,12,29,41,30,10,4,16,22,35,58,0.603448275862069,0
45,76,0.592,13,27,0.481,18,22,0.818,2,26,28,27,9,5,16,17,32,49,0.6530612244897959,1
43,87,0.494,20,43,0.465,24,25,0.96,14,33,47,34,1,4,12,21,23,44,0.5227272727272727,1
41,90,0.456,13,31,0.419,23,30,0.767,13,25,38,26,7,2,5,18,28,59,0.4745762711864407,0
38,75,0.507,10,27,0.37,17,22,0.773,3,25,28,26,9,1,17,23,28,48,0.5833333333333334,0
39,80,0.488,9,28,0.321,26,33,0.788,13,30,43,22,5,4,15,19,30,52,0.5769230769230769,1
49,100,0.49,11,30,0.367,23,31,0.742,17,31,48,28,0,7,8,25,38,70,0.5428571428571428,0
49,91,0.538,12,33,0.364,30,35,0.857,9,30,39,23,4,5,2,19,37,58,0.6379310344827587,1
39,89,0.438,10,33,0.303,18,19,0.947,9,28,37,33,4,4,15,22,29,56,0.5178571428571429,0
52,98,0.531,16,37,0.432,16,20,0.8,13,38,51,29,8,6,11,19,36,61,0.5901639344262295,1
43,84,0.512,19,40,0.475,14,15,0.933,4,33,37,29,6,5,16,17,24,44,0.5454545454545454,0
48,91,0.527,23,46,0.5,13,15,0.867,9,32,41,32,9,1,14,14,25,45,0.5555555555555556,1
45,84,0.536,13,34,0.382,23,28,0.821,14,36,50,25,0,5,18,12,32,50,0.64,1
46,101,0.455,18,41,0.439,15,18,0.833,16,25,41,28,9,6,6,20,28,60,0.4666666666666667,0
38,96,0.396,13,44,0.295,34,41,0.829,14,28,42,27,8,12,6,25,25,52,0.4807692307692308,1
42,99,0.424,9,31,0.29,28,35,0.8,20,34,54,17,3,5,12,28,33,68,0.4852941176470588,0
45,91,0.495,18,44,0.409,19,21,0.905,9,34,43,28,8,1,12,23,27,47,0.574468085106383,1
42,86,0.488,14,35,0.4,20,23,0.87,6,30,36,31,7,2,14,21,28,51,0.5490196078431373,0
38,83,0.458,13,40,0.325,24,25,0.96,5,30,35,21,3,4,13,24,25,43,0.5813953488372093,0
44,88,0.5,11,32,0.344,23,28,0.821,11,31,42,32,8,6,12,15,33,56,0.5892857142857143,1
39,73,0.534,13,31,0.419,29,34,0.853,8,25,33,25,12,4,15,17,26,42,0.6190476190476191,1
41,82,0.5,12,34,0.353,16,20,0.8,8,25,33,20,4,5,19,23,29,48,0.6041666666666666,0
46,101,0.455,13,35,0.371,17,27,0.63,20,30,50,20,7,5,9,14,33,66,0.5,0
46,86,0.535,19,39,0.487,19,21,0.905,6,36,42,24,5,5,12,19,27,47,0.574468085106383,1
37,88,0.42,3,23,0.13,21,24,0.875,10,39,49,22,10,8,21,26,34,65,0.5230769230769231,0
37,97,0.381,7,34,0.206,25,28,0.893,13,41,54,23,12,4,16,22,30,63,0.47619047619047616,1
49,86,0.57,13,26,0.5,19,20,0.95,7,28,35,28,7,4,12,23,36,60,0.6,1
44,84,0.524,16,42,0.381,18,24,0.75,10,21,31,26,5,3,16,19,28,42,0.6666666666666666,0
42,81,0.519,12,32,0.375,22,28,0.786,12,24,36,26,6,10,19,27,30,49,0.6122448979591837,0
45,85,0.529,8,21,0.381,24,32,0.75,8,26,34,27,10,2,16,19,37,64,0.578125,1
48,96,0.5,9,36,0.25,17,25,0.68,11,26,37,27,14,10,10,20,39,60,0.65,1
46,91,0.505,10,32,0.313,15,20,0.75,12,35,47,21,4,5,20,22,36,59,0.6101694915254238,0
43,87,0.494,9,30,0.3,21,27,0.778,14,33,47,23,3,5,11,14,34,57,0.5964912280701754,1
43,89,0.483,11,34,0.324,14,18,0.778,6,30,36,26,9,3,7,20,32,55,0.5818181818181818,0
42,82,0.512,16,35,0.457,14,21,0.667,11,36,47,29,4,7,19,17,26,47,0.5531914893617021,0
44,97,0.454,11,34,0.324,16,22,0.727,15,27,42,22,10,7,8,19,33,63,0.5238095238095238,1
50,94,0.532,12,35,0.343,12,16,0.75,10,33,43,37,11,2,11,17,38,59,0.6440677966101694,1
37,80,0.463,13,30,0.433,11,18,0.611,9,29,38,27,5,3,18,17,24,50,0.48,0
42,95,0.442,16,42,0.381,16,19,0.842,18,34,52,28,5,9,14,23,26,53,0.49056603773584906,1
40,96,0.417,7,26,0.269,18,27,0.667,20,29,49,14,9,4,9,20,33,70,0.4714285714285714,0
39,94,0.415,12,33,0.364,16,24,0.667,20,28,48,23,9,10,24,19,27,61,0.4426229508196721,0
47,93,0.505,16,38,0.421,16,21,0.762,13,29,42,41,12,7,19,25,31,55,0.5636363636363636,1
37,92,0.402,15,34,0.441,14,21,0.667,16,34,50,23,1,6,13,20,22,58,0.3793103448275862,0
45,87,0.517,19,32,0.594,17,22,0.773,9,35,44,26,4,7,8,19,26,55,0.4727272727272727,1
40,100,0.4,18,52,0.346,20,23,0.87,8,39,47,28,10,7,16,26,22,48,0.4583333333333333,0
43,108,0.398,13,41,0.317,22,30,0.733,18,45,63,21,10,5,17,19,30,67,0.44776119402985076,1
50,92,0.543,7,23,0.304,19,21,0.905,11,37,48,23,11,8,14,17,43,69,0.6231884057971014,1
39,97,0.402,8,34,0.235,22,27,0.815,17,32,49,25,7,3,17,15,31,63,0.49206349206349204,0
46,87,0.529,14,28,0.5,20,27,0.741,8,30,38,26,8,6,16,19,32,59,0.5423728813559322,0
45,89,0.506,17,40,0.425,21,23,0.913,8,29,37,31,12,5,15,20,28,49,0.5714285714285714,1
43,82,0.524,11,26,0.423,15,25,0.6,2,32,34,27,10,6,13,34,32,56,0.5714285714285714,0
39,85,0.459,11,28,0.393,28,41,0.683,12,37,49,30,4,3,16,23,28,57,0.49122807017543857,1
41,81,0.506,8,26,0.308,15,19,0.789,5,38,43,24,8,8,15,23,33,55,0.6,1
32,85,0.376,9,37,0.243,22,29,0.759,13,31,44,19,4,3,16,15,23,48,0.4791666666666667,0
49,83,0.59,13,30,0.433,13,17,0.765,9,25,34,27,5,3,12,15,36,53,0.6792452830188679,0
56,100,0.56,13,34,0.382,14,16,0.875,14,25,39,27,6,4,7,16,43,66,0.6515151515151515,1
42,86,0.488,23,43,0.535,13,19,0.684,14,31,45,25,9,4,18,19,19,43,0.4418604651162791,1
42,84,0.5,14,33,0.424,16,19,0.842,10,25,35,24,7,8,15,15,28,51,0.5490196078431373,0
33,69,0.478,4,20,0.2,20,27,0.741,5,34,39,15,3,1,16,22,29,49,0.5918367346938775,0
37,80,0.463,18,38,0.474,23,28,0.821,10,27,37,21,7,1,10,22,19,42,0.4523809523809524,1
37,84,0.44,8,32,0.25,29,37,0.784,16,23,39,23,7,2,21,18,29,52,0.5576923076923077,0
51,83,0.614,14,28,0.5,18,26,0.692,12,26,38,38,16,4,18,28,37,55,0.6727272727272727,1
43,102,0.422,9,29,0.31,26,40,0.65,24,39,63,24,6,7,14,31,34,73,0.4657534246575342,0
38,93,0.409,13,41,0.317,33,41,0.805,10,37,47,24,7,7,10,26,25,52,0.4807692307692308,1
41,91,0.451,10,35,0.286,18,24,0.75,11,28,39,29,9,5,11,21,31,56,0.5535714285714286,0
39,75,0.52,15,30,0.5,30,34,0.882,5,37,42,28,2,5,15,18,24,45,0.5333333333333333,1
45,93,0.484,16,40,0.4,7,11,0.636,8,28,36,21,4,1,9,20,29,53,0.5471698113207547,0
41,87,0.471,12,38,0.316,24,28,0.857,13,40,53,25,1,2,15,17,29,49,0.5918367346938775,1
51,81,0.63,15,28,0.536,14,20,0.7,11,21,32,31,4,2,9,13,36,53,0.6792452830188679,1
51,89,0.573,14,26,0.538,10,14,0.714,12,22,34,34,3,1,7,15,37,63,0.5873015873015873,0
43,80,0.538,18,41,0.439,13,20,0.65,6,36,42,26,7,6,11,18,25,39,0.6410256410256411,1
37,88,0.42,16,39,0.41,16,23,0.696,13,33,46,24,6,1,11,18,21,49,0.42857142857142855,0
45,89,0.506,13,34,0.382,19,22,0.864,6,30,36,28,11,2,12,18,32,55,0.5818181818181818,1
45,83,0.542,11,25,0.44,17,20,0.85,6,34,40,24,5,4,18,20,34,58,0.5862068965517241,0
39,86,0.453,14,39,0.359,10,11,0.909,7,29,36,24,3,6,16,17,25,47,0.5319148936170213,0
48,86,0.558,7,22,0.318,11,17,0.647,9,32,41,33,9,3,9,13,41,64,0.640625,1
38,79,0.481,9,24,0.375,19,33,0.576,15,41,56,24,4,6,23,19,29,55,0.5272727272727272,0
38,83,0.458,17,41,0.415,20,24,0.833,3,27,30,20,12,9,12,26,21,42,0.5,1
36,96,0.375,13,37,0.351,22,26,0.846,11,37,48,22,10,4,15,29,23,59,0.3898305084745763,0
38,91,0.418,12,31,0.387,24,35,0.686,14,41,55,27,9,8,15,20,26,60,0.43333333333333335,1
49,93,0.527,12,28,0.429,19,23,0.826,16,30,46,27,4,3,15,26,37,65,0.5692307692307692,1
46,84,0.548,13,33,0.394,22,29,0.759,4,25,29,28,6,5,9,20,33,51,0.6470588235294118,0
38,85,0.447,16,35,0.457,14,15,0.933,11,30,41,25,9,8,15,17,22,50,0.44,1
46,86,0.535,7,19,0.368,5,7,0.714,6,35,41,24,7,9,14,13,39,67,0.582089552238806,0
42,90,0.467,14,34,0.412,20,24,0.833,9,32,41,24,3,10,11,19,28,56,0.5,0
51,95,0.537,18,34,0.529,18,25,0.72,9,37,46,34,6,5,8,18,33,61,0.5409836065573771,1
35,77,0.455,12,28,0.429,30,31,0.968,9,37,46,20,6,3,11,23,23,49,0.46938775510204084,1
35,80,0.438,13,35,0.371,15,26,0.577,12,26,38,15,3,3,10,21,22,45,0.4888888888888889,0
40,89,0.449,7,26,0.269,14,16,0.875,14,36,50,21,4,5,8,24,33,63,0.5238095238095238,1
36,82,0.439,10,28,0.357,17,33,0.515,10,32,42,22,7,5,9,16,26,54,0.48148148148148145,0
43,79,0.544,14,27,0.519,20,31,0.645,9,33,42,30,4,7,16,22,29,52,0.5576923076923077,1
41,90,0.456,13,32,0.406,21,27,0.778,10,32,42,28,10,2,12,24,28,58,0.4827586206896552,0
37,78,0.474,8,30,0.267,14,18,0.778,8,33,41,24,17,4,25,22,29,48,0.6041666666666666,0
35,80,0.438,8,34,0.235,22,27,0.815,12,30,42,17,16,1,22,14,27,46,0.5869565217391305,1
40,92,0.435,11,32,0.344,19,27,0.704,15,37,52,28,8,4,20,22,29,60,0.48333333333333334,0
39,88,0.443,13,35,0.371,21,25,0.84,6,34,40,25,10,5,17,26,26,53,0.49056603773584906,1
45,86,0.523,10,30,0.333,21,27,0.778,10,41,51,23,5,5,13,19,35,56,0.625,1
37,86,0.43,17,46,0.37,21,25,0.84,11,27,38,24,5,7,12,24,20,40,0.5,0
40,82,0.488,18,41,0.439,18,26,0.692,14,33,47,30,4,4,17,24,22,41,0.5365853658536586,0
41,90,0.456,15,34,0.441,28,35,0.8,17,28,45,21,12,4,8,20,26,56,0.4642857142857143,1
39,85,0.459,10,33,0.303,12,19,0.632,9,34,43,24,6,4,19,14,29,52,0.5576923076923077,0
44,95,0.463,11,34,0.324,12,18,0.667,15,32,47,28,13,3,11,20,33,61,0.5409836065573771,1
55,98,0.561,23,52,0.442,17,24,0.708,13,37,50,38,11,6,19,27,32,46,0.6956521739130435,1
43,87,0.494,13,32,0.406,31,40,0.775,11,30,41,26,10,3,20,21,30,55,0.5454545454545454,0
41,91,0.451,16,42,0.381,16,22,0.727,12,29,41,19,8,7,19,22,25,49,0.5102040816326531,0
44,88,0.5,11,30,0.367,20,30,0.667,12,35,47,24,11,5,23,15,33,58,0.5689655172413793,1
36,83,0.434,18,46,0.391,8,11,0.727,8,29,37,24,5,4,18,23,18,37,0.4864864864864865,0
43,84,0.512,11,27,0.407,16,24,0.667,8,32,40,22,10,3,11,12,32,57,0.5614035087719298,1
47,90,0.522,13,27,0.481,20,26,0.769,14,26,40,30,7,4,15,18,34,63,0.5396825396825397,0
55,92,0.598,20,33,0.606,17,22,0.773,8,28,36,34,11,4,10,16,35,59,0.5932203389830508,1
40,98,0.408,12,36,0.333,8,10,0.8,10,21,31,28,14,3,15,21,28,62,0.45161290322580644,0
49,88,0.557,22,40,0.55,13,14,0.929,10,43,53,37,10,5,25,11,27,48,0.5625,1
38,85,0.447,2,16,0.125,24,34,0.706,11,31,42,22,8,7,15,23,36,69,0.5217391304347826,0
41,86,0.477,16,40,0.4,22,26,0.846,9,37,46,25,8,4,16,26,25,46,0.5434782608695652,1
42,83,0.506,11,30,0.367,32,41,0.78,6,35,41,28,7,3,11,22,31,53,0.5849056603773585,1
47,89,0.528,10,30,0.333,22,26,0.846,8,30,38,24,6,2,9,25,37,59,0.6271186440677966,0
43,88,0.489,5,24,0.208,19,25,0.76,11,34,45,19,5,5,16,23,38,64,0.59375,0
42,99,0.424,10,37,0.27,22,28,0.786,14,31,45,24,9,10,8,21,32,62,0.5161290322580645,1
51,84,0.607,19,38,0.5,12,15,0.8,7,40,47,25,4,9,15,20,32,46,0.6956521739130435,1
42,95,0.442,16,40,0.4,15,24,0.625,9,23,32,21,8,4,7,13,26,55,0.4727272727272727,0
32,74,0.432,10,32,0.313,21,27,0.778,5,39,44,21,5,6,17,22,22,42,0.5238095238095238,0
34,94,0.362,12,33,0.364,18,23,0.783,14,37,51,21,7,2,8,18,22,61,0.36065573770491804,1
39,80,0.488,11,33,0.333,10,13,0.769,7,27,34,27,8,5,12,20,28,47,0.5957446808510638,1
38,85,0.447,5,26,0.192,17,20,0.85,14,29,43,18,5,3,16,14,33,59,0.559322033898305,0
40,87,0.46,12,33,0.364,11,16,0.688,10,31,41,29,8,4,12,19,28,54,0.5185185185185185,0
37,75,0.493,17,33,0.515,14,21,0.667,9,33,42,25,4,3,17,18,20,42,0.47619047619047616,1
39,96,0.406,6,25,0.24,13,18,0.722,10,30,40,19,10,5,14,21,33,71,0.4647887323943662,0
47,94,0.5,22,39,0.564,12,13,0.923,15,40,55,38,3,10,18,21,25,55,0.45454545454545453,1
42,88,0.477,10,31,0.323,26,37,0.703,11,25,36,26,10,3,14,26,32,57,0.5614035087719298,0
43,85,0.506,14,32,0.438,22,28,0.786,14,30,44,33,7,5,22,27,29,53,0.5471698113207547,1
39,98,0.398,12,38,0.316,18,23,0.783,15,33,48,27,13,7,8,16,27,60,0.45,1
42,97,0.433,5,28,0.179,14,20,0.7,17,40,57,29,5,10,14,15,37,69,0.5362318840579711,0
40,106,0.377,8,34,0.235,16,18,0.889,17,31,48,22,11,2,14,19,32,72,0.4444444444444444,0
40,90,0.444,10,33,0.303,23,30,0.767,11,45,56,25,12,9,20,13,30,57,0.5263157894736842,1
38,97,0.392,11,34,0.324,12,16,0.75,15,36,51,21,9,5,19,21,27,63,0.42857142857142855,0
37,78,0.474,13,30,0.433,20,28,0.714,7,42,49,16,11,7,23,15,24,48,0.5,1
40,82,0.488,11,29,0.379,20,28,0.714,4,32,36,23,8,5,9,18,29,53,0.5471698113207547,1
37,85,0.435,12,38,0.316,16,21,0.762,8,34,42,25,4,7,15,21,25,47,0.5319148936170213,0
50,84,0.595,11,29,0.379,26,33,0.788,11,35,46,26,5,6,17,16,39,55,0.7090909090909091,1
53,102,0.52,15,34,0.441,11,16,0.688,12,25,37,31,12,2,12,23,38,68,0.5588235294117647,0
41,85,0.482,15,35,0.429,23,29,0.793,10,22,32,25,14,5,17,20,26,50,0.52,0
46,82,0.561,15,28,0.536,19,25,0.76,9,25,34,34,8,7,18,22,31,54,0.5740740740740741,1
49,76,0.645,14,26,0.538,21,27,0.778,6,25,31,29,3,4,16,26,35,50,0.7,0
42,82,0.512,18,38,0.474,35,36,0.972,11,25,36,26,10,4,11,19,24,44,0.5454545454545454,1
47,90,0.522,20,41,0.488,10,15,0.667,8,27,35,32,5,5,13,18,27,49,0.5510204081632653,0
51,89,0.573,17,36,0.472,15,18,0.833,6,35,41,26,9,4,10,15,34,53,0.6415094339622641,1
48,97,0.495,12,40,0.3,5,7,0.714,11,30,41,28,12,8,10,17,36,57,0.631578947368421,1
35,73,0.479,13,32,0.406,12,13,0.923,4,30,34,29,6,2,19,12,22,41,0.5365853658536586,0
44,96,0.458,13,38,0.342,19,23,0.826,10,40,50,17,5,5,10,20,31,58,0.5344827586206896,1
41,100,0.41,16,46,0.348,19,23,0.826,15,39,54,22,4,4,13,19,25,54,0.46296296296296297,0
48,95,0.505,11,27,0.407,23,26,0.885,15,33,48,27,12,5,11,22,37,68,0.5441176470588235,1
43,94,0.457,13,38,0.342,23,27,0.852,15,25,40,24,5,6,16,23,30,56,0.5357142857142857,0
37,91,0.407,4,25,0.16,18,22,0.818,7,36,43,16,8,2,13,20,33,66,0.5,0
39,84,0.464,7,32,0.219,26,31,0.839,6,46,52,24,8,5,16,19,32,52,0.6153846153846154,1
40,87,0.46,15,36,0.417,18,22,0.818,11,25,36,29,12,4,10,16,25,51,0.49019607843137253,1
39,76,0.513,5,21,0.238,12,20,0.6,10,36,46,24,5,6,22,20,34,55,0.6181818181818182,0
37,82,0.451,8,24,0.333,18,28,0.643,11,31,42,24,2,1,14,18,29,58,0.5,0
52,89,0.584,18,38,0.474,16,21,0.762,6,31,37,26,9,9,5,21,34,51,0.6666666666666666,1
33,77,0.429,13,34,0.382,20,28,0.714,7,36,43,20,3,3,9,10,20,43,0.46511627906976744,1
35,86,0.407,13,32,0.406,12,16,0.75,13,37,50,24,4,6,9,21,22,54,0.4074074074074074,0
46,101,0.455,12,33,0.364,13,21,0.619,14,32,46,24,5,4,10,17,34,68,0.5,0
50,90,0.556,18,43,0.419,11,15,0.733,5,38,43,40,5,1,14,18,32,47,0.6808510638297872,1
52,98,0.531,18,43,0.419,19,31,0.613,14,36,50,32,11,3,16,20,34,55,0.6181818181818182,1
49,89,0.551,13,33,0.394,20,28,0.714,5,33,38,22,10,4,13,24,36,56,0.6428571428571429,0
33,69,0.478,12,34,0.353,27,32,0.844,2,38,40,21,5,3,20,23,21,35,0.6,0
39,85,0.459,10,33,0.303,22,26,0.846,5,32,37,28,9,3,11,19,29,52,0.5576923076923077,1
38,93,0.409,8,33,0.242,16,19,0.842,15,32,47,22,14,2,21,12,30,60,0.5,0
44,86,0.512,13,35,0.371,10,15,0.667,9,36,45,31,12,6,20,19,31,51,0.6078431372549019,1
39,88,0.443,8,29,0.276,14,18,0.778,11,26,37,27,9,5,10,21,31,59,0.5254237288135594,0
40,76,0.526,10,18,0.556,22,25,0.88,10,36,46,19,5,2,15,17,30,58,0.5172413793103449,1
42,80,0.525,19,39,0.487,17,19,0.895,6,31,37,25,5,5,14,15,23,41,0.5609756097560976,1
45,95,0.474,7,27,0.259,16,20,0.8,15,32,47,24,12,2,9,18,38,68,0.5588235294117647,0
47,105,0.448,12,42,0.286,15,20,0.75,11,36,47,30,4,0,12,23,35,63,0.5555555555555556,0
39,84,0.464,13,40,0.325,34,39,0.872,7,39,46,18,8,9,12,22,26,44,0.5909090909090909,1
45,88,0.511,10,28,0.357,15,19,0.789,14,31,45,19,4,4,11,14,35,60,0.5833333333333334,0
46,87,0.529,22,40,0.55,8,14,0.571,9,26,35,31,5,3,9,17,24,47,0.5106382978723404,1
44,92,0.478,8,27,0.296,21,27,0.778,16,32,48,20,8,4,17,20,36,65,0.5538461538461539,1
38,83,0.458,14,38,0.368,24,31,0.774,8,27,35,23,10,5,16,25,24,45,0.5333333333333333,0
37,82,0.451,9,33,0.273,27,36,0.75,10,26,36,23,5,0,9,21,28,49,0.5714285714285714,0
42,80,0.525,17,37,0.459,16,21,0.762,9,35,44,25,5,2,20,26,25,43,0.5813953488372093,1
40,88,0.455,11,36,0.306,22,29,0.759,13,40,53,18,5,8,18,17,29,52,0.5576923076923077,1
39,92,0.424,8,29,0.276,17,19,0.895,8,34,42,21,9,8,10,26,31,63,0.49206349206349204,0
48,81,0.593,16,35,0.457,16,19,0.842,4,34,38,30,5,6,12,22,32,46,0.6956521739130435,1
41,83,0.494,10,28,0.357,17,24,0.708,6,30,36,29,5,0,13,18,31,55,0.5636363636363636,0
44,81,0.543,14,34,0.412,17,20,0.85,6,30,36,28,6,6,14,14,30,47,0.6382978723404256,0
46,89,0.517,18,35,0.514,16,24,0.667,12,27,39,31,10,2,11,15,28,54,0.5185185185185185,1
48,92,0.522,10,30,0.333,17,18,0.944,15,30,45,24,6,3,8,18,38,62,0.6129032258064516,1
40,76,0.526,7,24,0.292,18,23,0.783,3,24,27,18,3,6,12,16,33,52,0.6346153846153846,0
50,103,0.485,8,24,0.333,20,26,0.769,17,35,52,31,7,6,9,19,42,79,0.5316455696202531,1
48,109,0.44,10,29,0.345,12,17,0.706,17,36,53,32,6,4,13,20,38,80,0.475,0
35,80,0.438,18,46,0.391,12,17,0.706,7,24,31,26,7,3,14,18,17,34,0.5,0
39,82,0.476,13,36,0.361,17,24,0.708,13,36,49,26,9,6,17,23,26,46,0.5652173913043478,1
45,93,0.484,10,31,0.323,17,23,0.739,10,26,36,26,11,0,11,17,35,62,0.5645161290322581,0
45,83,0.542,15,40,0.375,17,22,0.773,11,36,47,25,6,3,19,18,30,43,0.6976744186046512,1
37,89,0.416,2,19,0.105,23,27,0.852,15,30,45,17,6,0,15,19,35,70,0.5,0
44,78,0.564,20,33,0.606,14,19,0.737,4,31,35,35,9,7,13,23,24,45,0.5333333333333333,1
36,79,0.456,9,32,0.281,19,21,0.905,11,27,38,21,4,6,18,22,27,47,0.574468085106383,0
43,89,0.483,9,37,0.243,17,22,0.773,15,26,41,29,10,8,9,21,34,52,0.6538461538461539,1
41,93,0.441,13,34,0.382,15,21,0.714,8,30,38,25,7,3,12,20,28,59,0.4745762711864407,0
53,96,0.552,17,43,0.395,12,20,0.6,12,45,57,27,7,4,12,18,36,53,0.6792452830188679,1
35,89,0.393,11,29,0.379,23,37,0.622,16,37,53,24,1,3,14,16,24,60,0.4,0
45,95,0.474,16,41,0.39,15,19,0.789,12,38,50,24,8,9,11,25,29,54,0.5370370370370371,1
36,79,0.456,14,39,0.359,19,27,0.704,9,31,40,18,9,6,14,31,22,40,0.55,0
39,79,0.494,10,34,0.294,23,33,0.697,9,31,40,17,6,1,11,18,29,45,0.6444444444444445,1
47,99,0.475,9,30,0.3,15,22,0.682,10,40,50,20,15,3,12,21,38,69,0.5507246376811594,1
43,92,0.467,12,39,0.308,13,25,0.52,8,41,49,26,7,3,18,16,31,53,0.5849056603773585,0
46,90,0.511,20,47,0.426,16,20,0.8,6,38,44,37,9,4,15,18,26,43,0.6046511627906976,1
46,93,0.495,11,24,0.458,17,20,0.85,8,35,43,23,10,4,17,18,35,69,0.5072463768115942,0
42,99,0.424,11,29,0.379,24,30,0.8,15,35,50,23,11,6,10,16,31,70,0.44285714285714284,1
40,85,0.471,11,30,0.367,18,23,0.783,8,37,45,28,8,3,19,25,29,55,0.5272727272727272,0
40,89,0.449,9,33,0.273,17,19,0.895,16,28,44,19,9,4,14,19,31,56,0.5535714285714286,0
43,87,0.494,11,28,0.393,17,21,0.81,13,29,42,28,10,4,12,16,32,59,0.5423728813559322,1
44,94,0.468,13,30,0.433,24,30,0.8,17,28,45,26,5,0,7,21,31,64,0.484375,0
43,79,0.544,19,40,0.475,24,27,0.889,3,29,32,24,2,7,8,21,24,39,0.6153846153846154,1
48,86,0.558,16,30,0.533,15,17,0.882,5,40,45,32,7,8,14,19,32,56,0.5714285714285714,1
42,97,0.433,7,29,0.241,15,23,0.652,14,29,43,26,6,6,10,20,35,68,0.5147058823529411,0
37,93,0.398,12,44,0.273,22,26,0.846,11,33,44,24,15,6,8,16,25,49,0.5102040816326531,1
38,77,0.494,12,24,0.5,15,21,0.714,6,45,51,26,6,6,20,19,26,53,0.49056603773584906,0
34,78,0.436,14,31,0.452,18,25,0.72,9,36,45,21,7,3,15,17,20,47,0.425531914893617,1
40,83,0.482,11,40,0.275,6,12,0.5,5,34,39,32,9,6,13,20,29,43,0.6744186046511628,0
42,85,0.494,8,27,0.296,21,25,0.84,8,28,36,28,13,2,15,24,34,58,0.5862068965517241,0
43,87,0.494,16,36,0.444,20,24,0.833,10,34,44,33,7,3,18,21,27,51,0.5294117647058824,1
42,111,0.378,11,39,0.282,20,26,0.769,18,44,62,27,6,6,11,24,31,72,0.4305555555555556,0
43,105,0.41,15,44,0.341,23,27,0.852,16,50,66,18,7,8,12,21,28,61,0.45901639344262296,1
48,93,0.516,11,33,0.333,22,31,0.71,11,33,44,29,6,1,14,23,37,60,0.6166666666666667,1
44,98,0.449,7,34,0.206,28,32,0.875,13,32,45,27,6,3,9,24,37,64,0.578125,0
36,88,0.409,9,39,0.231,15,18,0.833,5,27,32,19,8,1,7,12,27,49,0.5510204081632653,0
53,92,0.576,26,54,0.481,7,10,0.7,11,46,57,28,4,4,12,13,27,38,0.7105263157894737,1
38,103,0.369,12,43,0.279,18,22,0.818,24,28,52,22,11,6,10,23,26,60,0.43333333333333335,0
41,94,0.436,7,23,0.304,23,31,0.742,24,41,65,20,6,12,18,20,34,71,0.4788732394366197,1
41,87,0.471,14,36,0.389,26,27,0.963,9,32,41,24,3,5,13,22,27,51,0.5294117647058824,1
41,87,0.471,9,37,0.243,21,28,0.75,12,32,44,28,8,7,13,22,32,50,0.64,0
38,91,0.418,11,35,0.314,27,34,0.794,9,49,58,21,7,4,17,24,27,56,0.48214285714285715,0
46,106,0.434,14,50,0.28,13,24,0.542,10,43,53,26,5,7,11,23,32,56,0.5714285714285714,1
33,87,0.379,6,38,0.158,22,29,0.759,12,34,46,12,10,4,15,21,27,49,0.5510204081632653,0
34,78,0.436,14,35,0.4,23,26,0.885,7,36,43,27,7,4,19,24,20,43,0.46511627906976744,1
52,91,0.571,19,33,0.576,9,11,0.818,6,39,45,32,6,5,12,24,33,58,0.5689655172413793,1
35,86,0.407,4,28,0.143,26,31,0.839,12,32,44,22,8,4,16,13,31,58,0.5344827586206896,0
48,90,0.533,8,27,0.296,15,19,0.789,6,28,34,25,10,3,10,13,40,63,0.6349206349206349,1
48,88,0.545,8,24,0.333,5,7,0.714,8,32,40,30,5,1,18,17,40,64,0.625,0
50,110,0.455,10,23,0.435,18,26,0.692,25,27,52,27,11,2,8,22,40,87,0.45977011494252873,0
44,83,0.53,17,47,0.362,26,30,0.867,13,36,49,29,3,11,16,17,27,36,0.75,1
39,93,0.419,7,35,0.2,13,15,0.867,16,29,45,19,6,4,15,15,32,58,0.5517241379310345,0
41,79,0.519,11,28,0.393,21,26,0.808,8,32,40,24,9,3,14,18,30,51,0.5882352941176471,1
41,87,0.471,10,23,0.435,21,22,0.955,11,33,44,22,8,5,18,23,31,64,0.484375,0
49,91,0.538,14,29,0.483,16,22,0.727,9,32,41,33,12,7,16,17,35,62,0.5645161290322581,1
42,84,0.5,5,20,0.25,17,21,0.81,12,38,50,27,6,5,17,26,37,64,0.578125,0
37,85,0.435,14,41,0.341,23,29,0.793,6,30,36,16,10,3,8,24,23,44,0.5227272727272727,1
43,85,0.506,19,38,0.5,12,19,0.632,10,32,42,25,4,4,17,23,24,47,0.5106382978723404,0
51,90,0.567,16,35,0.457,16,21,0.762,7,31,38,35,10,2,13,19,35,55,0.6363636363636364,1
42,92,0.457,6,22,0.273,22,31,0.71,13,38,51,29,8,5,13,10,36,70,0.5142857142857142,1
45,93,0.484,16,41,0.39,5,6,0.833,6,40,46,30,8,6,16,21,29,52,0.5576923076923077,0
39,95,0.411,13,36,0.361,14,20,0.7,9,40,49,15,8,4,7,22,26,59,0.4406779661016949,0
39,90,0.433,9,37,0.243,19,27,0.704,8,45,53,16,2,0,10,17,30,53,0.5660377358490566,1
39,87,0.448,13,36,0.361,13,16,0.813,9,24,33,24,8,3,11,15,26,51,0.5098039215686274,0
40,83,0.482,12,36,0.333,14,18,0.778,11,33,44,25,8,0,18,17,28,47,0.5957446808510638,1
41,95,0.432,12,32,0.375,12,14,0.857,10,43,53,28,6,6,9,22,29,63,0.4603174603174603,1
29,75,0.387,10,38,0.263,26,31,0.839,3,40,43,18,5,3,15,21,19,37,0.5135135135135135,0
40,90,0.444,9,34,0.265,23,30,0.767,8,29,37,22,16,2,14,20,31,56,0.5535714285714286,0
44,86,0.512,14,32,0.438,16,23,0.696,12,39,51,27,7,3,23,22,30,54,0.5555555555555556,1
41,90,0.456,15,39,0.385,20,27,0.741,13,30,43,21,9,7,9,25,26,51,0.5098039215686274,1
40,80,0.5,7,21,0.333,24,33,0.727,6,34,40,22,5,4,13,26,33,59,0.559322033898305,0
37,86,0.43,13,38,0.342,17,20,0.85,11,38,49,24,6,5,20,15,24,48,0.5,0
40,89,0.449,17,41,0.415,10,14,0.714,9,38,47,28,13,5,18,18,23,48,0.4791666666666667,1
45,85,0.529,12,23,0.522,25,38,0.658,13,29,42,23,11,3,17,24,33,62,0.532258064516129,1
40,87,0.46,16,44,0.364,24,28,0.857,12,29,41,21,7,7,20,27,24,43,0.5581395348837209,0
46,87,0.529,13,27,0.481,32,41,0.78,14,25,39,28,11,3,11,13,33,60,0.55,1
52,89,0.584,7,21,0.333,14,15,0.933,9,26,35,32,8,0,18,25,45,68,0.6617647058823529,0
44,95,0.463,10,37,0.27,17,23,0.739,14,38,52,28,8,5,9,18,34,58,0.5862068965517241,1
41,91,0.451,13,44,0.295,13,18,0.722,13,37,50,20,4,2,15,22,28,47,0.5957446808510638,0
43,88,0.489,17,41,0.415,21,23,0.913,11,27,38,25,5,2,7,17,26,47,0.5531914893617021,1
42,84,0.5,12,33,0.364,20,22,0.909,9,32,41,27,4,3,11,19,30,51,0.5882352941176471,0
39,81,0.481,13,28,0.464,32,41,0.78,6,33,39,22,10,3,16,21,26,53,0.49056603773584906,0
43,86,0.5,14,33,0.424,25,28,0.893,10,29,39,21,4,10,15,28,29,53,0.5471698113207547,1
44,87,0.506,14,43,0.326,19,21,0.905,7,26,33,22,3,3,9,19,30,44,0.6818181818181818,0
48,80,0.6,12,26,0.462,21,25,0.84,6,35,41,32,6,3,12,19,36,54,0.6666666666666666,1
44,91,0.484,6,20,0.3,14,17,0.824,10,33,43,26,7,7,16,18,38,71,0.5352112676056338,0
48,95,0.505,15,38,0.395,17,20,0.85,12,36,48,32,14,6,13,15,33,57,0.5789473684210527,1
42,75,0.56,11,23,0.478,21,31,0.677,10,36,46,34,10,2,17,23,31,52,0.5961538461538461,1
35,81,0.432,16,42,0.381,14,22,0.636,9,21,30,23,8,2,16,27,19,39,0.48717948717948717,0
39,85,0.459,14,40,0.35,21,27,0.778,10,29,39,22,9,1,14,18,25,45,0.5555555555555556,0
45,82,0.549,14,35,0.4,15,19,0.789,5,33,38,33,6,5,14,24,31,47,0.6595744680851063,1
45,101,0.446,8,31,0.258,17,21,0.81,13,31,44,23,9,2,7,23,37,70,0.5285714285714286,0
46,88,0.523,14,40,0.35,17,28,0.607,10,41,51,23,6,4,12,14,32,48,0.6666666666666666,1
45,94,0.479,11,32,0.344,25,33,0.758,13,31,44,30,4,3,9,20,34,62,0.5483870967741935,0
52,100,0.52,9,30,0.3,18,20,0.9,14,34,48,28,6,0,11,22,43,70,0.6142857142857143,1
44,92,0.478,16,37,0.432,30,35,0.857,9,37,46,24,8,4,13,20,28,55,0.509090909090909,1
45,94,0.479,18,40,0.45,20,26,0.769,10,36,46,30,6,3,10,30,27,54,0.5,0
45,89,0.506,10,30,0.333,21,27,0.778,9,25,34,29,4,8,16,18,35,59,0.5932203389830508,0
56,97,0.577,21,46,0.457,20,23,0.87,9,33,42,39,11,6,9,19,35,51,0.6862745098039216,1
42,91,0.462,8,23,0.348,27,30,0.9,18,34,52,25,6,2,12,18,34,68,0.5,1
45,83,0.542,12,33,0.364,11,23,0.478,8,31,39,28,8,6,15,23,33,50,0.66,0
46,88,0.523,15,37,0.405,15,16,0.938,8,38,46,33,7,5,13,20,31,51,0.6078431372549019,1
40,92,0.435,8,32,0.25,15,22,0.682,12,30,42,28,3,6,13,20,32,60,0.5333333333333333,0
44,101,0.436,11,36,0.306,7,12,0.583,11,31,42,24,11,3,11,16,33,65,0.5076923076923077,1
38,78,0.487,10,27,0.37,17,23,0.739,8,36,44,25,10,9,20,16,28,51,0.5490196078431373,0
34,71,0.479,6,25,0.24,24,31,0.774,3,34,37,19,6,5,22,23,28,46,0.6086956521739131,0
48,87,0.552,10,27,0.37,22,30,0.733,5,29,34,33,7,3,11,23,38,60,0.6333333333333333,1
35,82,0.427,11,42,0.262,23,27,0.852,11,27,38,23,5,5,15,22,24,40,0.6,0
48,85,0.565,14,26,0.538,26,34,0.765,12,36,48,26,11,3,11,23,34,59,0.576271186440678,1
30,74,0.405,7,25,0.28,30,36,0.833,8,36,44,23,4,4,12,23,23,49,0.46938775510204084,0
34,79,0.43,12,36,0.333,28,39,0.718,14,35,49,21,5,1,12,28,22,43,0.5116279069767442,1
44,92,0.478,12,30,0.4,24,30,0.8,11,35,46,20,11,5,9,19,32,62,0.5161290322580645,1
41,84,0.488,16,31,0.516,18,22,0.818,8,34,42,21,4,5,16,26,25,53,0.4716981132075472,0
40,90,0.444,8,26,0.308,16,17,0.941,6,32,38,25,7,3,18,23,32,64,0.5,0
50,89,0.562,6,22,0.273,22,25,0.88,7,42,49,27,10,6,14,12,44,67,0.6567164179104478,1
39,83,0.47,16,37,0.432,17,21,0.81,10,41,51,25,2,5,12,22,23,46,0.5,1
37,87,0.425,9,33,0.273,16,21,0.762,9,33,42,22,9,6,9,20,28,54,0.5185185185185185,0
44,91,0.484,11,32,0.344,15,21,0.714,7,29,36,21,8,3,11,10,33,59,0.559322033898305,0
56,97,0.577,26,50,0.52,3,7,0.429,11,34,45,43,6,3,16,17,30,47,0.6382978723404256,1
52,89,0.584,21,41,0.512,15,18,0.833,7,28,35,38,9,5,10,22,31,48,0.6458333333333334,1
44,88,0.5,13,32,0.406,19,24,0.792,11,28,39,27,5,4,14,15,31,56,0.5535714285714286,0
47,87,0.54,16,42,0.381,17,21,0.81,7,48,55,27,4,2,16,27,31,45,0.6888888888888889,1
37,91,0.407,9,36,0.25,25,29,0.862,1,27,28,23,5,2,9,20,28,55,0.509090909090909,0
41,88,0.466,15,39,0.385,27,31,0.871,17,32,49,26,6,4,14,25,26,49,0.5306122448979592,1
41,87,0.471,6,31,0.194,23,26,0.885,10,27,37,21,4,4,13,23,35,56,0.625,0
44,78,0.564,12,29,0.414,14,20,0.7,7,36,43,26,9,6,17,15,32,49,0.6530612244897959,1
35,82,0.427,6,28,0.214,15,19,0.789,7,30,37,20,8,5,14,18,29,54,0.5370370370370371,0
43,92,0.467,9,31,0.29,21,28,0.75,16,32,48,31,10,4,15,24,34,61,0.5573770491803278,1
38,79,0.481,9,28,0.321,27,31,0.871,5,31,36,25,11,2,17,21,29,51,0.5686274509803921,0
40,85,0.471,10,35,0.286,22,26,0.846,8,28,36,24,6,7,17,16,30,50,0.6,0
58,93,0.624,13,27,0.481,17,22,0.773,6,38,44,44,12,5,11,21,45,66,0.6818181818181818,1
49,94,0.521,17,34,0.5,18,20,0.9,7,30,37,32,12,2,13,18,32,60,0.5333333333333333,1
49,85,0.576,14,31,0.452,18,26,0.692,6,35,41,27,8,3,21,19,35,54,0.6481481481481481,0
32,87,0.368,7,35,0.2,18,27,0.667,11,38,49,24,9,3,20,16,25,52,0.4807692307692308,0
39,81,0.481,11,33,0.333,15,21,0.714,5,34,39,22,10,7,14,21,28,48,0.5833333333333334,1
38,85,0.447,12,36,0.333,19,25,0.76,10,31,41,30,4,6,12,21,26,49,0.5306122448979592,0
45,91,0.495,12,32,0.375,14,21,0.667,13,34,47,28,8,2,10,19,33,59,0.559322033898305,1
37,81,0.457,15,43,0.349,13,19,0.684,11,32,43,21,6,2,11,22,22,38,0.5789473684210527,1
37,79,0.468,6,25,0.24,18,24,0.75,9,32,41,23,4,4,11,19,31,54,0.5740740740740741,0
37,83,0.446,10,31,0.323,15,20,0.75,8,29,37,20,9,3,7,16,27,52,0.5192307692307693,0
40,76,0.526,19,35,0.543,7,10,0.7,5,39,44,25,2,5,15,19,21,41,0.5121951219512195,1
30,81,0.37,8,32,0.25,17,18,0.944,9,23,32,19,8,6,14,21,22,49,0.4489795918367347,0
43,87,0.494,6,26,0.231,21,25,0.84,13,37,50,30,8,4,13,16,37,61,0.6065573770491803,1
46,92,0.5,10,30,0.333,28,30,0.933,10,21,31,29,10,4,9,15,36,62,0.5806451612903226,1
47,86,0.547,10,22,0.455,24,28,0.857,15,29,44,25,4,7,19,21,37,64,0.578125,0
41,78,0.526,17,35,0.486,11,17,0.647,8,36,44,26,7,6,18,20,24,43,0.5581395348837209,1
38,86,0.442,12,33,0.364,16,21,0.762,9,31,40,21,10,4,11,18,26,53,0.49056603773584906,0
38,78,0.487,15,33,0.455,20,28,0.714,5,26,31,24,3,5,11,25,23,45,0.5111111111111111,0
37,79,0.468,6,19,0.316,36,39,0.923,15,33,48,21,7,3,13,22,31,60,0.5166666666666667,1
46,97,0.474,21,49,0.429,9,10,0.9,10,22,32,31,11,2,11,24,25,48,0.5208333333333334,0
43,78,0.551,8,27,0.296,31,32,0.969,12,35,47,25,6,3,21,16,35,51,0.6862745098039216,1
35,87,0.402,9,32,0.281,19,27,0.704,7,32,39,24,11,4,16,18,26,55,0.4727272727272727,0
43,88,0.489,10,28,0.357,16,21,0.762,9,42,51,21,11,7,17,19,33,60,0.55,1
56,98,0.571,23,43,0.535,8,8,1.0,8,39,47,35,6,6,11,19,33,55,0.6,1
44,105,0.419,12,34,0.353,18,21,0.857,21,29,50,27,2,5,8,12,32,71,0.4507042253521127,0
39,93,0.419,9,31,0.29,17,21,0.81,12,28,40,23,11,5,7,17,30,62,0.4838709677419355,0
44,87,0.506,15,37,0.405,15,17,0.882,11,41,52,29,4,12,17,17,29,50,0.58,1
39,86,0.453,7,30,0.233,22,29,0.759,9,26,35,24,14,10,11,19,32,56,0.5714285714285714,0
43,95,0.453,10,29,0.345,20,27,0.741,20,39,59,23,6,4,19,22,33,66,0.5,1
42,91,0.462,5,26,0.192,16,21,0.762,8,38,46,15,4,2,12,16,37,65,0.5692307692307692,0
39,91,0.429,17,44,0.386,21,25,0.84,11,38,49,26,8,1,11,20,22,47,0.46808510638297873,1
45,99,0.455,12,47,0.255,13,18,0.722,16,35,51,24,5,7,11,20,33,52,0.6346153846153846,1
42,89,0.472,7,18,0.389,15,21,0.714,11,32,43,23,2,2,12,19,35,71,0.49295774647887325,0
39,84,0.464,10,33,0.303,16,24,0.667,7,32,39,24,6,5,16,15,29,51,0.5686274509803921,0
47,97,0.485,9,27,0.333,12,19,0.632,15,32,47,24,12,6,10,16,38,70,0.5428571428571428,1
45,93,0.484,8,23,0.348,18,26,0.692,11,36,47,26,9,6,13,18,37,70,0.5285714285714286,0
44,89,0.494,25,55,0.455,14,17,0.824,5,38,43,34,7,7,15,22,19,34,0.5588235294117647,1
45,107,0.421,14,42,0.333,27,34,0.794,13,38,51,21,7,3,19,32,31,65,0.47692307692307695,0
46,107,0.43,7,37,0.189,39,49,0.796,21,41,62,29,6,5,16,29,39,70,0.5571428571428572,1
43,93,0.462,10,33,0.303,21,24,0.875,19,34,53,25,13,2,17,24,33,60,0.55,1
36,85,0.424,11,39,0.282,21,28,0.75,11,27,38,23,9,3,15,16,25,46,0.5434782608695652,0
45,90,0.5,17,39,0.436,12,16,0.75,9,40,49,28,8,4,11,13,28,51,0.5490196078431373,1
42,85,0.494,11,33,0.333,11,14,0.786,3,32,35,17,5,7,10,12,31,52,0.5961538461538461,0
41,88,0.466,15,37,0.405,10,12,0.833,7,28,35,25,7,4,18,20,26,51,0.5098039215686274,0
49,84,0.583,10,25,0.4,20,27,0.741,9,35,44,27,12,6,19,19,39,59,0.6610169491525424,1
35,84,0.417,7,30,0.233,18,24,0.75,10,37,47,23,11,4,18,21,28,54,0.5185185185185185,0
32,77,0.416,12,38,0.316,21,22,0.955,6,34,40,21,11,6,17,23,20,39,0.5128205128205128,1
48,85,0.565,10,28,0.357,12,15,0.8,12,29,41,28,9,5,14,22,38,57,0.6666666666666666,1
39,82,0.476,9,24,0.375,20,25,0.8,11,23,34,25,8,3,14,18,30,58,0.5172413793103449,0
43,81,0.531,11,32,0.344,11,16,0.688,4,31,35,23,1,5,12,17,32,49,0.6530612244897959,0
44,84,0.524,14,38,0.368,17,22,0.773,6,34,40,27,8,2,8,15,30,46,0.6521739130434783,1
47,83,0.566,12,24,0.5,32,35,0.914,10,19,29,29,9,3,11,26,35,59,0.5932203389830508,1
42,76,0.553,16,40,0.4,29,31,0.935,9,23,32,29,3,5,20,27,26,36,0.7222222222222222,0
43,88,0.489,18,43,0.419,18,19,0.947,11,28,39,34,4,0,12,19,25,45,0.5555555555555556,1
39,72,0.542,9,27,0.333,27,32,0.844,5,33,38,21,2,4,14,19,30,45,0.6666666666666666,0
47,87,0.54,6,24,0.25,22,29,0.759,9,37,46,31,6,6,17,20,41,63,0.6507936507936508,1
41,91,0.451,12,34,0.353,22,30,0.733,9,31,40,28,11,3,13,30,29,57,0.5087719298245614,0
40,94,0.426,11,37,0.297,15,17,0.882,14,35,49,25,9,5,20,17,29,57,0.5087719298245614,0
50,103,0.485,10,26,0.385,15,19,0.789,14,34,48,29,9,6,10,10,40,77,0.5194805194805194,1
33,75,0.44,6,23,0.261,29,30,0.967,8,33,41,17,4,3,12,12,27,52,0.5192307692307693,1
37,92,0.402,13,40,0.325,11,13,0.846,12,30,42,23,7,6,9,20,24,52,0.46153846153846156,0
50,99,0.505,5,23,0.217,14,17,0.824,14,37,51,35,7,5,14,20,45,76,0.5921052631578947,1
40,85,0.471,8,32,0.25,17,29,0.586,5,32,37,25,11,8,14,18,32,53,0.6037735849056604,0
36,74,0.486,5,21,0.238,12,15,0.8,6,38,44,27,7,3,23,22,31,53,0.5849056603773585,0
36,86,0.419,9,35,0.257,16,19,0.842,10,29,39,26,9,4,13,15,27,51,0.5294117647058824,1
40,89,0.449,8,25,0.32,21,26,0.808,10,42,52,19,4,4,16,12,32,64,0.5,1
40,96,0.417,12,44,0.273,11,12,0.917,7,36,43,31,11,6,16,21,28,52,0.5384615384615384,0
45,88,0.511,9,32,0.281,21,28,0.75,11,27,38,23,3,7,12,24,36,56,0.6428571428571429,0
43,95,0.453,12,36,0.333,28,38,0.737,20,32,52,18,6,4,6,24,31,59,0.5254237288135594,1
37,85,0.435,12,39,0.308,21,23,0.913,11,35,46,24,7,6,20,22,25,46,0.5434782608695652,1
37,87,0.425,11,29,0.379,18,23,0.783,12,32,44,22,12,5,18,24,26,58,0.4482758620689655,0
47,91,0.516,20,51,0.392,14,19,0.737,7,36,43,27,4,4,16,19,27,40,0.675,0
51,100,0.51,8,32,0.25,23,25,0.92,11,39,50,22,9,0,7,17,43,68,0.6323529411764706,1
43,95,0.453,14,40,0.35,13,17,0.765,17,16,33,27,8,3,8,18,29,55,0.5272727272727272,0
48,75,0.64,12,26,0.462,19,22,0.864,8,32,40,32,5,7,18,16,36,49,0.7346938775510204,1
42,84,0.5,12,34,0.353,13,21,0.619,3,31,34,24,4,5,8,22,30,50,0.6,0
39,88,0.443,21,51,0.412,20,26,0.769,15,40,55,28,5,3,11,14,18,37,0.4864864864864865,1
40,79,0.506,13,34,0.382,25,32,0.781,6,26,32,25,3,4,18,26,27,45,0.6,0
42,87,0.483,11,30,0.367,24,36,0.667,13,27,40,21,5,8,8,26,31,57,0.543859649122807,1
38,81,0.469,8,27,0.296,16,19,0.842,7,35,42,24,8,6,18,19,30,54,0.5555555555555556,1
35,86,0.407,3,21,0.143,18,19,0.947,10,34,44,17,8,3,16,21,32,65,0.49230769230769234,0
53,108,0.491,11,28,0.393,21,21,1.0,16,26,42,26,9,4,12,15,42,80,0.525,0
53,84,0.631,20,37,0.541,18,23,0.783,3,32,35,36,5,5,17,19,33,47,0.7021276595744681,1
43,85,0.506,8,21,0.381,15,20,0.75,11,24,35,27,10,1,18,21,35,64,0.546875,0
44,78,0.564,9,28,0.321,20,25,0.8,11,25,36,21,8,6,14,16,35,50,0.7,1
48,83,0.578,9,29,0.31,19,26,0.731,10,29,39,28,8,2,12,26,39,54,0.7222222222222222,1
43,84,0.512,13,39,0.333,22,29,0.759,9,24,33,21,5,1,11,21,30,45,0.6666666666666666,0
48,80,0.6,12,28,0.429,18,21,0.857,9,24,33,26,10,3,17,15,36,52,0.6923076923076923,0
52,89,0.584,20,40,0.5,11,15,0.733,11,23,34,40,10,0,16,19,32,49,0.6530612244897959,1
43,85,0.506,15,33,0.455,22,25,0.88,11,35,46,24,5,3,19,17,28,52,0.5384615384615384,1
46,91,0.505,11,34,0.324,14,20,0.7,8,24,32,30,11,7,11,21,35,57,0.6140350877192983,0
44,76,0.579,11,28,0.393,13,15,0.867,6,33,39,34,3,4,13,18,33,48,0.6875,1
39,89,0.438,12,35,0.343,18,20,0.9,9,25,34,25,9,4,9,14,27,54,0.5,0
35,78,0.449,12,29,0.414,24,33,0.727,10,29,39,18,3,3,10,19,23,49,0.46938775510204084,0
45,82,0.549,15,34,0.441,19,26,0.731,6,32,38,18,4,3,8,24,30,48,0.625,1
39,74,0.527,9,30,0.3,16,18,0.889,4,29,33,19,13,8,19,21,30,44,0.6818181818181818,1
38,90,0.422,9,33,0.273,15,18,0.833,14,29,43,20,8,3,17,17,29,57,0.5087719298245614,0
35,86,0.407,6,24,0.25,28,31,0.903,15,27,42,17,10,2,17,15,29,62,0.46774193548387094,0
46,82,0.561,15,34,0.441,16,17,0.941,7,31,38,26,11,7,16,24,31,48,0.6458333333333334,1
42,95,0.442,12,37,0.324,19,21,0.905,14,42,56,24,6,5,13,16,30,58,0.5172413793103449,0
46,97,0.474,23,47,0.489,12,13,0.923,8,34,42,27,7,9,7,15,23,50,0.46,1
45,83,0.542,15,34,0.441,19,27,0.704,8,28,36,28,2,1,11,22,30,49,0.6122448979591837,0
49,92,0.533,17,36,0.472,19,22,0.864,12,24,36,33,5,4,8,22,32,56,0.5714285714285714,1
46,99,0.465,17,50,0.34,16,20,0.8,8,36,44,28,8,1,13,26,29,49,0.5918367346938775,0
43,90,0.478,18,42,0.429,27,35,0.771,10,42,52,29,6,3,19,23,25,48,0.5208333333333334,1
37,83,0.446,14,38,0.368,21,24,0.875,13,27,40,23,8,4,17,21,23,45,0.5111111111111111,0
50,88,0.568,7,22,0.318,13,16,0.813,8,29,37,33,12,4,15,17,43,66,0.6515151515151515,1
45,79,0.57,17,33,0.515,19,22,0.864,5,39,44,28,5,2,16,17,28,46,0.6086956521739131,1
36,86,0.419,12,42,0.286,17,24,0.708,12,25,37,20,9,5,12,19,24,44,0.5454545454545454,0
43,84,0.512,13,31,0.419,14,18,0.778,9,20,29,26,6,2,19,17,30,53,0.5660377358490566,0
50,83,0.602,8,24,0.333,15,20,0.75,13,27,40,31,9,11,20,16,42,59,0.711864406779661,1
45,96,0.469,14,43,0.326,18,22,0.818,10,45,55,16,2,4,10,21,31,53,0.5849056603773585,1
40,97,0.412,5,26,0.192,16,21,0.762,8,32,40,25,6,7,5,18,35,71,0.49295774647887325,0
43,84,0.512,11,29,0.379,12,16,0.75,6,29,35,24,6,4,14,16,32,55,0.5818181818181818,0
49,92,0.533,21,45,0.467,8,10,0.8,8,35,43,30,10,5,11,18,28,47,0.5957446808510638,1
38,83,0.458,8,28,0.286,21,29,0.724,12,29,41,19,4,3,8,18,30,55,0.5454545454545454,0
41,77,0.532,17,39,0.436,17,20,0.85,5,31,36,26,3,5,11,27,24,38,0.631578947368421,1
41,107,0.383,13,38,0.342,15,20,0.75,20,38,58,24,7,6,15,24,28,69,0.4057971014492754,0
43,96,0.448,14,35,0.4,20,29,0.69,15,43,58,26,8,12,16,17,29,61,0.47540983606557374,1
39,84,0.464,14,39,0.359,17,20,0.85,6,25,31,25,8,3,12,13,25,45,0.5555555555555556,0
48,84,0.571,11,31,0.355,11,15,0.733,6,37,43,34,7,5,13,14,37,53,0.6981132075471698,1
41,84,0.488,15,35,0.429,16,21,0.762,6,32,38,23,10,6,14,21,26,49,0.5306122448979592,0
39,82,0.476,18,43,0.419,21,22,0.955,6,35,41,27,6,5,19,19,21,39,0.5384615384615384,1
39,89,0.438,7,25,0.28,17,24,0.708,13,37,50,24,5,3,15,28,32,64,0.5,0
44,83,0.53,10,37,0.27,22,36,0.611,6,37,43,32,5,8,11,23,34,46,0.7391304347826086,1
42,91,0.462,12,36,0.333,15,19,0.789,15,46,61,24,2,8,24,20,30,55,0.5454545454545454,0
43,107,0.402,14,40,0.35,17,25,0.68,17,29,46,24,13,9,4,21,29,67,0.43283582089552236,1
30,89,0.337,10,37,0.27,26,38,0.684,14,33,47,20,5,7,18,33,20,52,0.38461538461538464,0
42,87,0.483,9,34,0.265,40,47,0.851,10,39,49,21,8,4,11,21,33,53,0.6226415094339622,1
41,82,0.5,10,30,0.333,20,25,0.8,10,25,35,23,7,5,8,17,31,52,0.5961538461538461,0
39,78,0.5,13,27,0.481,27,29,0.931,8,30,38,24,7,4,12,22,26,51,0.5098039215686274,1
40,88,0.455,18,47,0.383,14,18,0.778,9,43,52,24,4,7,9,16,22,41,0.5365853658536586,1
37,97,0.381,10,32,0.313,16,21,0.762,15,36,51,19,4,2,6,17,27,65,0.4153846153846154,0
43,95,0.453,14,35,0.4,14,17,0.824,13,36,49,25,13,6,16,14,29,60,0.48333333333333334,1
39,95,0.411,8,29,0.276,20,22,0.909,16,37,53,21,8,5,18,16,31,66,0.4696969696969697,0
40,82,0.488,11,34,0.324,25,27,0.926,8,35,43,29,8,2,14,19,29,48,0.6041666666666666,1
42,89,0.472,11,31,0.355,12,16,0.75,7,31,38,30,10,2,14,24,31,58,0.5344827586206896,0
39,84,0.464,17,36,0.472,20,23,0.87,18,29,47,30,7,4,16,20,22,48,0.4583333333333333,1
43,90,0.478,6,26,0.231,17,20,0.85,13,28,41,24,10,2,11,21,37,64,0.578125,0
45,86,0.523,10,25,0.4,16,23,0.696,10,35,45,30,4,1,17,25,35,61,0.5737704918032787,0
46,82,0.561,22,42,0.524,28,36,0.778,3,33,36,27,10,5,7,18,24,40,0.6,1
51,99,0.515,18,39,0.462,22,26,0.846,20,31,51,31,7,6,15,18,33,60,0.55,1
49,94,0.521,22,49,0.449,18,22,0.818,10,27,37,33,10,5,15,23,27,45,0.6,0
40,105,0.381,14,49,0.286,17,21,0.81,17,31,48,24,10,3,10,23,26,56,0.4642857142857143,0
42,86,0.488,16,30,0.533,24,34,0.706,10,48,58,30,8,3,16,20,26,56,0.4642857142857143,1
37,81,0.457,17,34,0.5,15,19,0.789,6,39,45,22,5,7,21,25,20,47,0.425531914893617,0
39,95,0.411,12,31,0.387,18,23,0.783,12,34,46,27,7,6,14,19,27,64,0.421875,1
34,87,0.391,7,32,0.219,30,36,0.833,13,36,49,22,5,7,11,27,27,55,0.4909090909090909,0
34,84,0.405,13,36,0.361,29,36,0.806,7,36,43,25,3,10,12,26,21,48,0.4375,1
43,93,0.462,16,38,0.421,14,17,0.824,9,24,33,26,12,3,13,23,27,55,0.4909090909090909,0
47,85,0.553,14,34,0.412,25,31,0.806,12,37,49,27,9,4,18,16,33,51,0.6470588235294118,1
39,84,0.464,13,30,0.433,19,25,0.76,6,37,43,23,6,2,13,19,26,54,0.48148148148148145,0
43,92,0.467,9,31,0.29,20,25,0.8,11,37,48,17,10,5,12,20,34,61,0.5573770491803278,1
45,112,0.402,8,37,0.216,21,27,0.778,20,34,54,23,8,3,11,23,37,75,0.49333333333333335,0
42,100,0.42,13,48,0.271,23,27,0.852,17,41,58,26,8,10,22,29,29,52,0.5576923076923077,1
40,88,0.455,13,35,0.371,26,29,0.897,10,25,35,20,9,6,11,23,27,53,0.5094339622641509,0
50,85,0.588,15,28,0.536,21,23,0.913,5,37,42,28,7,8,14,21,35,57,0.6140350877192983,1
30,81,0.37,12,44,0.273,15,19,0.789,5,26,31,21,6,3,14,25,18,37,0.4864864864864865,0
50,88,0.568,12,26,0.462,19,28,0.679,12,45,57,25,6,4,11,15,38,62,0.6129032258064516,1
36,92,0.391,11,35,0.314,18,22,0.818,13,31,44,23,12,3,7,18,25,57,0.43859649122807015,0
37,78,0.474,26,54,0.481,16,18,0.889,7,40,47,27,3,3,19,20,11,24,0.4583333333333333,1
65,111,0.586,18,41,0.439,28,35,0.8,12,31,43,33,18,3,15,28,47,70,0.6714285714285714,1
59,98,0.602,26,45,0.578,31,36,0.861,7,35,42,39,8,3,25,27,33,53,0.6226415094339622,0
36,92,0.391,9,40,0.225,18,25,0.72,9,36,45,21,5,5,10,17,27,52,0.5192307692307693,0
47,98,0.48,19,46,0.413,15,19,0.789,10,47,57,27,6,1,12,18,28,52,0.5384615384615384,1
43,92,0.467,10,28,0.357,25,28,0.893,11,41,52,25,10,4,11,17,33,64,0.515625,1
46,93,0.495,11,33,0.333,10,16,0.625,7,38,45,25,6,11,16,20,35,60,0.5833333333333334,0
41,95,0.432,15,38,0.395,18,24,0.75,14,33,47,27,5,2,9,21,26,57,0.45614035087719296,0
42,90,0.467,14,38,0.368,26,32,0.813,15,39,54,23,5,5,11,22,28,52,0.5384615384615384,1
45,92,0.489,12,29,0.414,13,16,0.813,12,31,43,21,9,2,12,17,33,63,0.5238095238095238,1
39,79,0.494,19,44,0.432,12,12,1.0,3,31,34,25,6,6,19,20,20,35,0.5714285714285714,0
32,80,0.4,11,36,0.306,28,34,0.824,7,35,42,24,7,3,18,25,21,44,0.4772727272727273,0
38,88,0.432,10,31,0.323,22,27,0.815,11,37,48,20,10,2,15,22,28,57,0.49122807017543857,1
33,88,0.375,7,26,0.269,22,34,0.647,10,36,46,22,9,5,8,18,26,62,0.41935483870967744,1
38,94,0.404,6,24,0.25,9,14,0.643,17,45,62,26,4,5,16,27,32,70,0.45714285714285713,0
36,89,0.404,11,37,0.297,11,14,0.786,11,37,48,22,4,4,15,13,25,52,0.4807692307692308,0
45,95,0.474,15,44,0.341,7,8,0.875,11,39,50,25,10,3,12,13,30,51,0.5882352941176471,1
40,102,0.392,8,38,0.211,18,21,0.857,13,26,39,25,11,0,7,15,32,64,0.5,0
45,88,0.511,19,48,0.396,19,23,0.826,11,43,54,24,1,7,19,22,26,40,0.65,1
48,99,0.485,15,40,0.375,10,14,0.714,10,35,45,35,9,8,10,24,33,59,0.559322033898305,1
35,90,0.389,6,29,0.207,32,38,0.842,15,40,55,16,4,8,14,19,29,61,0.47540983606557374,0
43,86,0.5,16,36,0.444,8,12,0.667,9,35,44,20,6,4,13,22,27,50,0.54,1
35,78,0.449,9,27,0.333,28,35,0.8,8,34,42,19,8,3,10,13,26,51,0.5098039215686274,0
38,97,0.392,9,34,0.265,17,21,0.81,9,32,41,21,5,6,10,21,29,63,0.4603174603174603,0
43,92,0.467,10,28,0.357,22,28,0.786,15,41,56,29,5,11,16,16,33,64,0.515625,1
43,87,0.494,14,39,0.359,27,29,0.931,6,31,37,20,12,6,10,21,29,48,0.6041666666666666,0
45,90,0.5,16,30,0.533,23,28,0.821,13,33,46,20,7,2,16,18,29,60,0.48333333333333334,1
32,76,0.421,6,28,0.214,12,23,0.522,12,30,42,22,5,1,16,18,26,48,0.5416666666666666,0
40,79,0.506,8,30,0.267,14,17,0.824,8,31,39,21,7,3,11,19,32,49,0.6530612244897959,1
36,93,0.387,9,25,0.36,12,15,0.8,13,30,43,19,4,4,14,16,27,68,0.39705882352941174,0
44,84,0.524,18,36,0.5,12,14,0.857,8,37,45,31,7,5,14,17,26,48,0.5416666666666666,1
42,97,0.433,6,34,0.176,21,28,0.75,17,39,56,25,9,4,11,17,36,63,0.5714285714285714,1
39,93,0.419,20,49,0.408,10,14,0.714,11,37,48,21,5,5,17,24,19,44,0.4318181818181818,0
44,90,0.489,11,34,0.324,25,30,0.833,6,32,38,24,11,5,13,25,33,56,0.5892857142857143,0
49,96,0.51,13,39,0.333,23,31,0.742,11,39,50,35,10,3,16,23,36,57,0.631578947368421,1
38,90,0.422,17,45,0.378,11,21,0.524,10,33,43,26,11,8,16,18,21,45,0.4666666666666667,0
39,91,0.429,15,42,0.357,16,22,0.727,16,40,56,23,11,5,18,19,24,49,0.4897959183673469,1
40,95,0.421,8,24,0.333,13,22,0.591,19,36,55,21,4,5,12,22,32,71,0.4507042253521127,0
38,87,0.437,13,45,0.289,15,21,0.714,11,34,45,15,4,7,12,20,25,42,0.5952380952380952,1
45,85,0.529,18,43,0.419,16,24,0.667,13,35,48,32,7,1,20,21,27,42,0.6428571428571429,1
41,86,0.477,16,40,0.4,17,23,0.739,9,28,37,24,10,0,14,19,25,46,0.5434782608695652,0
45,100,0.45,7,26,0.269,17,25,0.68,18,30,48,24,7,2,14,26,38,74,0.5135135135135135,0
42,77,0.545,20,39,0.513,27,35,0.771,6,31,37,20,7,7,14,21,22,38,0.5789473684210527,1
42,92,0.457,3,26,0.115,19,27,0.704,10,29,39,18,12,3,9,18,39,66,0.5909090909090909,0
43,83,0.518,13,26,0.5,18,22,0.818,7,39,46,24,8,3,17,22,30,57,0.5263157894736842,1
36,79,0.456,9,34,0.265,20,26,0.769,11,32,43,21,9,1,17,20,27,45,0.6,1
34,76,0.447,6,27,0.222,19,23,0.826,9,29,38,23,9,2,17,26,28,49,0.5714285714285714,0
37,84,0.44,9,42,0.214,11,14,0.786,7,28,35,21,5,8,12,22,28,42,0.6666666666666666,0
37,78,0.474,12,31,0.387,23,34,0.676,7,37,44,20,6,3,15,11,25,47,0.5319148936170213,1
35,81,0.432,15,37,0.405,16,22,0.727,12,25,37,21,10,3,13,20,20,44,0.45454545454545453,1
32,73,0.438,10,27,0.37,25,28,0.893,9,30,39,20,7,3,20,24,22,46,0.4782608695652174,0
48,97,0.495,6,21,0.286,17,20,0.85,16,32,48,19,6,5,9,15,42,76,0.5526315789473685,1
43,93,0.462,13,35,0.371,17,19,0.895,13,29,42,21,4,7,9,17,30,58,0.5172413793103449,0
50,102,0.49,14,37,0.378,4,12,0.333,11,44,55,32,10,3,17,21,36,65,0.5538461538461539,1
36,83,0.434,12,36,0.333,20,25,0.8,3,35,38,25,12,6,18,19,24,47,0.5106382978723404,0
41,78,0.526,11,28,0.393,31,40,0.775,5,36,41,25,3,8,9,19,30,50,0.6,1
46,91,0.505,12,37,0.324,18,28,0.643,9,29,38,28,5,3,7,29,34,54,0.6296296296296297,0
37,86,0.43,12,39,0.308,19,22,0.864,9,24,33,26,8,4,13,17,25,47,0.5319148936170213,0
49,91,0.538,12,30,0.4,13,16,0.813,12,34,46,34,5,2,18,19,37,61,0.6065573770491803,1
53,92,0.576,16,37,0.432,11,16,0.688,11,32,43,40,8,5,11,10,37,55,0.6727272727272727,1
48,97,0.495,9,31,0.29,7,10,0.7,10,30,40,33,5,6,13,16,39,66,0.5909090909090909,0
43,90,0.478,9,26,0.346,13,22,0.591,10,36,46,22,14,8,19,20,34,64,0.53125,1
35,83,0.422,11,28,0.393,20,23,0.87,9,35,44,24,11,3,25,17,24,55,0.43636363636363634,0
38,86,0.442,13,34,0.382,20,23,0.87,14,42,56,22,5,10,26,19,25,52,0.4807692307692308,0
51,112,0.455,6,31,0.194,13,17,0.765,14,33,47,25,13,6,7,17,45,81,0.5555555555555556,1
43,82,0.524,15,42,0.357,22,30,0.733,8,43,51,34,3,4,20,21,28,40,0.7,1
43,98,0.439,11,35,0.314,20,24,0.833,12,30,42,28,9,1,10,23,32,63,0.5079365079365079,0
37,71,0.521,10,25,0.4,14,17,0.824,6,29,35,28,6,7,20,18,27,46,0.5869565217391305,0
38,94,0.404,15,42,0.357,13,19,0.684,19,28,47,26,11,6,12,17,23,52,0.4423076923076923,1
39,91,0.429,8,26,0.308,16,25,0.64,9,36,45,23,9,5,14,22,31,65,0.47692307692307695,1
30,85,0.353,10,34,0.294,24,36,0.667,14,38,52,15,8,9,20,15,20,51,0.39215686274509803,0
45,92,0.489,10,32,0.313,13,21,0.619,10,28,38,21,8,3,7,18,35,60,0.5833333333333334,0
39,78,0.5,16,32,0.5,23,28,0.821,7,36,43,27,5,4,13,18,23,46,0.5,1
42,89,0.472,9,25,0.36,12,15,0.8,5,43,48,30,8,9,13,22,33,64,0.515625,1
32,88,0.364,9,33,0.273,18,28,0.643,12,36,48,20,3,7,14,17,23,55,0.41818181818181815,0
41,85,0.482,12,27,0.444,23,31,0.742,10,30,40,27,9,4,15,22,29,58,0.5,1
39,78,0.5,14,35,0.4,23,28,0.821,7,33,40,23,8,2,17,23,25,43,0.5813953488372093,0
40,83,0.482,17,41,0.415,16,19,0.842,8,36,44,27,6,9,8,21,23,42,0.5476190476190477,1
36,90,0.4,11,34,0.324,16,25,0.64,17,32,49,17,4,5,13,18,25,56,0.44642857142857145,0
41,83,0.494,15,39,0.385,22,22,1.0,9,32,41,25,6,5,9,20,26,44,0.5909090909090909,1
34,78,0.436,7,29,0.241,21,23,0.913,5,28,33,18,3,2,13,17,27,49,0.5510204081632653,0
43,94,0.457,9,33,0.273,22,29,0.759,12,38,50,22,3,5,13,18,34,61,0.5573770491803278,0
49,94,0.521,26,56,0.464,15,19,0.789,8,38,46,29,4,1,8,23,23,38,0.6052631578947368,1
42,90,0.467,15,39,0.385,19,20,0.95,5,26,31,26,6,5,14,21,27,51,0.5294117647058824,0
54,89,0.607,20,35,0.571,14,21,0.667,7,39,46,28,5,3,16,21,34,54,0.6296296296296297,1
38,80,0.475,16,35,0.457,31,39,0.795,10,31,41,22,8,8,13,19,22,45,0.4888888888888889,1
44,91,0.484,11,40,0.275,18,24,0.75,12,30,42,29,8,4,13,27,33,51,0.6470588235294118,0
46,89,0.517,9,25,0.36,20,23,0.87,11,30,41,23,9,4,6,20,37,64,0.578125,1
36,81,0.444,11,38,0.289,27,29,0.931,12,29,41,18,5,8,14,18,25,43,0.5813953488372093,0
45,78,0.577,12,27,0.444,24,29,0.828,5,32,37,28,9,1,14,24,33,51,0.6470588235294118,0
45,82,0.549,25,48,0.521,18,27,0.667,5,26,31,26,8,1,13,22,20,34,0.5882352941176471,1
32,89,0.36,9,43,0.209,18,21,0.857,9,38,47,19,5,5,16,24,23,46,0.5,0
39,93,0.419,14,46,0.304,23,27,0.852,15,45,60,25,9,6,12,20,25,47,0.5319148936170213,1
41,90,0.456,8,23,0.348,9,11,0.818,6,34,40,23,11,8,14,18,33,67,0.4925373134328358,0
45,98,0.459,10,32,0.313,10,13,0.769,13,37,50,31,5,6,17,14,35,66,0.5303030303030303,1
41,92,0.446,9,33,0.273,17,17,1.0,13,30,43,28,8,7,14,21,32,59,0.5423728813559322,0
43,84,0.512,14,30,0.467,19,24,0.792,9,34,43,30,5,4,15,12,29,54,0.5370370370370371,1
41,87,0.471,13,39,0.333,16,20,0.8,9,25,34,22,11,7,18,15,28,48,0.5833333333333334,0
52,91,0.571,12,26,0.462,13,16,0.813,10,33,43,30,10,5,17,19,40,65,0.6153846153846154,1
40,95,0.421,14,44,0.318,21,26,0.808,13,34,47,25,9,6,13,20,26,51,0.5098039215686274,1
41,84,0.488,9,29,0.31,14,20,0.7,9,39,48,26,8,8,19,19,32,55,0.5818181818181818,0
42,84,0.5,20,47,0.426,21,25,0.84,13,28,41,29,6,7,11,20,22,37,0.5945945945945946,1
39,83,0.47,7,23,0.304,19,25,0.76,9,25,34,24,7,1,9,15,32,60,0.5333333333333333,0
46,86,0.535,10,26,0.385,15,19,0.789,13,29,42,21,9,4,20,24,36,60,0.6,1
38,78,0.487,9,24,0.375,21,25,0.84,8,26,34,25,11,4,21,20,29,54,0.5370370370370371,0
31,84,0.369,11,32,0.344,24,31,0.774,10,30,40,24,6,6,11,24,20,52,0.38461538461538464,0
40,87,0.46,8,31,0.258,25,31,0.806,13,40,53,28,6,5,10,21,32,56,0.5714285714285714,1
34,77,0.442,10,29,0.345,21,27,0.778,7,22,29,20,9,4,13,22,24,48,0.5,0
40,78,0.513,10,31,0.323,18,20,0.9,9,34,43,28,7,4,18,22,30,47,0.6382978723404256,1
42,89,0.472,14,34,0.412,12,16,0.75,10,36,46,29,10,6,14,21,28,55,0.509090909090909,1
36,87,0.414,10,31,0.323,20,24,0.833,11,30,41,23,8,2,15,19,26,56,0.4642857142857143,0
47,81,0.58,17,41,0.415,11,17,0.647,6,28,34,23,8,4,12,23,30,40,0.75,1
39,81,0.481,12,25,0.48,30,32,0.938,11,28,39,23,7,2,12,17,27,56,0.48214285714285715,0
38,78,0.487,9,29,0.31,18,23,0.783,10,38,48,24,5,14,26,18,29,49,0.5918367346938775,0
52,104,0.5,17,43,0.395,9,14,0.643,11,29,40,31,12,5,7,22,35,61,0.5737704918032787,1
47,87,0.54,14,41,0.341,19,27,0.704,6,26,32,31,7,3,7,24,33,46,0.717391304347826,0
46,87,0.529,10,33,0.303,26,26,1.0,9,36,45,26,3,2,11,22,36,54,0.6666666666666666,1
33,81,0.407,6,24,0.25,18,25,0.72,12,37,49,19,5,7,24,15,27,57,0.47368421052631576,0
45,91,0.495,14,34,0.412,10,18,0.556,8,31,39,29,14,8,12,18,31,57,0.543859649122807,1
37,79,0.468,9,30,0.3,26,30,0.867,10,27,37,22,12,1,16,23,28,49,0.5714285714285714,0
42,83,0.506,13,35,0.371,20,23,0.87,12,31,43,31,5,3,20,19,29,48,0.6041666666666666,1
42,84,0.5,18,37,0.486,31,37,0.838,9,23,32,24,5,1,6,21,24,47,0.5106382978723404,1
44,83,0.53,17,34,0.5,25,28,0.893,11,32,43,30,3,3,13,23,27,49,0.5510204081632653,0
48,80,0.6,20,39,0.513,22,31,0.71,6,34,40,31,4,6,12,21,28,41,0.6829268292682927,1
49,89,0.551,14,27,0.519,22,30,0.733,11,28,39,25,5,1,6,21,35,62,0.5645161290322581,0
49,87,0.563,8,23,0.348,16,22,0.727,14,31,45,26,9,5,16,24,41,64,0.640625,1
38,86,0.442,15,37,0.405,19,20,0.95,13,29,42,24,9,3,15,20,23,49,0.46938775510204084,0
47,90,0.522,12,30,0.4,10,14,0.714,10,24,34,30,14,4,14,21,35,60,0.5833333333333334,1
38,75,0.507,14,24,0.583,19,22,0.864,9,34,43,26,9,5,24,16,24,51,0.47058823529411764,0
47,95,0.495,15,41,0.366,22,32,0.688,11,43,54,18,7,4,20,27,32,54,0.5925925925925926,1
43,109,0.394,21,59,0.356,22,25,0.88,17,37,54,27,8,5,16,28,22,50,0.44,0
33,88,0.375,8,30,0.267,12,15,0.8,5,44,49,17,2,3,10,19,25,58,0.43103448275862066,0
36,92,0.391,12,43,0.279,18,22,0.818,8,44,52,21,5,9,8,12,24,49,0.4897959183673469,1
48,94,0.511,16,44,0.364,13,16,0.813,13,22,35,27,5,6,9,18,32,50,0.64,1
45,74,0.608,10,22,0.455,22,25,0.88,4,29,33,18,6,3,15,20,35,52,0.6730769230769231,0
49,89,0.551,12,34,0.353,20,25,0.8,9,32,41,27,5,2,9,28,37,55,0.6727272727272727,1
38,77,0.494,15,38,0.395,35,38,0.921,5,26,31,15,5,0,10,22,23,39,0.5897435897435898,0
43,93,0.462,11,34,0.324,13,21,0.619,13,22,35,23,5,4,15,20,32,59,0.5423728813559322,0
52,85,0.612,13,24,0.542,25,29,0.862,6,38,44,29,10,3,12,20,39,61,0.639344262295082,1
50,92,0.543,18,34,0.529,11,15,0.733,2,24,26,32,13,3,8,23,32,58,0.5517241379310345,0
45,85,0.529,12,29,0.414,33,35,0.943,13,40,53,25,6,2,17,17,33,56,0.5892857142857143,1
36,91,0.396,18,52,0.346,15,18,0.833,7,35,42,27,2,6,13,21,18,39,0.46153846153846156,0
42,95,0.442,11,33,0.333,18,22,0.818,10,36,46,29,3,3,9,17,31,62,0.5,1
43,88,0.489,11,37,0.297,22,27,0.815,12,27,39,30,5,8,16,25,32,51,0.6274509803921569,0
44,87,0.506,14,37,0.378,27,33,0.818,11,31,42,24,9,4,12,20,30,50,0.6,1
39,83,0.47,16,47,0.34,28,32,0.875,9,37,46,27,9,5,17,22,23,36,0.6388888888888888,1
42,84,0.5,11,31,0.355,24,31,0.774,6,32,38,29,11,2,11,25,31,53,0.5849056603773585,0
39,83,0.47,22,49,0.449,17,22,0.773,7,38,45,30,5,6,12,15,17,34,0.5,1
46,108,0.426,8,31,0.258,11,12,0.917,20,36,56,21,8,2,9,19,38,77,0.4935064935064935,0
42,101,0.416,16,48,0.333,14,21,0.667,15,37,52,25,5,5,14,21,26,53,0.49056603773584906,0
43,96,0.448,12,34,0.353,20,25,0.8,16,42,58,27,4,7,15,20,31,62,0.5,1
43,86,0.5,10,27,0.37,17,20,0.85,11,30,41,29,6,4,15,20,33,59,0.559322033898305,0
43,86,0.5,13,33,0.394,19,23,0.826,12,29,41,30,9,2,14,12,30,53,0.5660377358490566,1
38,78,0.487,15,33,0.455,19,25,0.76,5,33,38,28,7,6,11,17,23,45,0.5111111111111111,1
40,86,0.465,10,32,0.313,14,20,0.7,16,36,52,30,9,6,16,21,30,54,0.5555555555555556,0
48,82,0.585,16,34,0.471,35,38,0.921,5,31,36,37,6,5,12,26,32,48,0.6666666666666666,1
53,90,0.589,15,37,0.405,22,31,0.71,5,25,30,28,8,4,9,24,38,53,0.7169811320754716,0
51,92,0.554,9,29,0.31,17,23,0.739,12,25,37,28,5,0,11,25,42,63,0.6666666666666666,0
41,77,0.532,16,29,0.552,32,37,0.865,8,24,32,27,6,4,11,17,25,48,0.5208333333333334,1
43,80,0.538,11,29,0.379,11,14,0.786,7,33,40,29,6,4,16,19,32,51,0.6274509803921569,0
47,83,0.566,16,38,0.421,13,20,0.65,6,27,33,39,7,3,11,12,31,45,0.6888888888888889,1
41,92,0.446,15,44,0.341,19,25,0.76,6,41,47,23,10,4,16,23,26,48,0.5416666666666666,0
42,89,0.472,19,45,0.422,17,22,0.773,3,40,43,24,10,6,17,20,23,44,0.5227272727272727,1
47,81,0.58,12,25,0.48,13,17,0.765,9,28,37,27,9,5,15,20,35,56,0.625,1
43,84,0.512,13,30,0.433,18,22,0.818,10,20,30,29,6,3,12,16,30,54,0.5555555555555556,0
40,81,0.494,15,40,0.375,23,29,0.793,5,31,36,23,12,7,12,21,25,41,0.6097560975609756,1
36,83,0.434,7,26,0.269,17,24,0.708,15,33,48,14,6,1,19,22,29,57,0.5087719298245614,0
36,93,0.387,9,37,0.243,22,29,0.759,6,39,45,18,6,6,7,25,27,56,0.48214285714285715,0
41,90,0.456,7,28,0.25,23,29,0.793,7,50,57,27,4,2,15,18,34,62,0.5483870967741935,1
40,81,0.494,15,25,0.6,22,23,0.957,8,46,54,21,8,6,16,17,25,56,0.44642857142857145,1
34,86,0.395,11,36,0.306,15,21,0.714,6,28,34,19,9,7,11,16,23,50,0.46,0
42,85,0.494,12,32,0.375,16,21,0.762,10,32,42,27,2,5,12,20,30,53,0.5660377358490566,1
38,89,0.427,11,40,0.275,18,24,0.75,10,29,39,18,3,4,8,18,27,49,0.5510204081632653,0
47,89,0.528,20,51,0.392,14,16,0.875,8,25,33,36,8,3,21,21,27,38,0.7105263157894737,0
50,94,0.532,17,37,0.459,20,24,0.833,13,31,44,28,10,2,18,17,33,57,0.5789473684210527,1
46,78,0.59,10,28,0.357,32,34,0.941,3,35,38,28,5,5,17,18,36,50,0.72,1
50,100,0.5,9,30,0.3,14,19,0.737,10,28,38,24,7,0,13,22,41,70,0.5857142857142857,0
30,82,0.366,11,39,0.282,22,27,0.815,6,41,47,18,5,2,16,19,19,43,0.4418604651162791,0
42,88,0.477,18,49,0.367,13,20,0.65,5,40,45,26,9,2,11,20,24,39,0.6153846153846154,1
46,89,0.517,8,24,0.333,17,18,0.944,9,41,50,26,9,2,9,16,38,65,0.5846153846153846,1
37,88,0.42,15,40,0.375,7,15,0.467,11,33,44,26,5,2,11,16,22,48,0.4583333333333333,0
37,96,0.385,13,32,0.406,13,14,0.929,15,26,41,21,12,2,12,23,24,64,0.375,0
39,71,0.549,6,20,0.3,24,31,0.774,9,35,44,23,9,4,17,18,33,51,0.6470588235294118,1
39,80,0.488,9,28,0.321,17,19,0.895,7,25,32,26,13,3,17,23,30,52,0.5769230769230769,1
35,70,0.5,8,29,0.276,22,29,0.759,10,27,37,22,7,4,24,19,27,41,0.6585365853658537,0
38,88,0.432,16,46,0.348,14,19,0.737,5,29,34,24,7,0,9,18,22,42,0.5238095238095238,0
42,83,0.506,13,27,0.481,16,18,0.889,9,40,49,32,4,6,15,19,29,56,0.5178571428571429,1
33,88,0.375,15,43,0.349,20,21,0.952,7,30,37,23,9,2,16,13,18,45,0.4,0
49,94,0.521,20,43,0.465,14,16,0.875,14,40,54,31,10,7,15,17,29,51,0.5686274509803921,1
45,85,0.529,12,29,0.414,20,26,0.769,8,28,36,26,11,5,11,17,33,56,0.5892857142857143,1
47,83,0.566,12,29,0.414,14,17,0.824,6,33,39,34,9,1,19,16,35,54,0.6481481481481481,0
43,86,0.5,8,24,0.333,19,32,0.594,13,31,44,24,11,9,13,18,35,62,0.5645161290322581,1
40,89,0.449,7,21,0.333,16,20,0.8,17,31,48,20,5,4,19,22,33,68,0.4852941176470588,0
49,107,0.458,6,17,0.353,21,29,0.724,20,38,58,18,6,6,17,22,43,90,0.4777777777777778,0
48,100,0.48,18,45,0.4,20,21,0.952,8,34,42,34,12,15,12,21,30,55,0.5454545454545454,1
36,82,0.439,15,45,0.333,23,24,0.958,8,24,32,25,9,3,17,17,21,37,0.5675675675675675,0
50,93,0.538,18,40,0.45,13,18,0.722,9,33,42,36,6,3,14,18,32,53,0.6037735849056604,1
41,104,0.394,14,36,0.389,17,17,1.0,15,32,47,20,10,4,14,12,27,68,0.39705882352941174,0
44,104,0.423,19,50,0.38,11,14,0.786,20,41,61,33,8,12,16,14,25,54,0.46296296296296297,1
49,88,0.557,13,34,0.382,20,21,0.952,11,31,42,27,7,8,18,26,36,54,0.6666666666666666,1
44,94,0.468,16,34,0.471,20,31,0.645,12,24,36,21,9,4,10,16,28,60,0.4666666666666667,0
42,101,0.416,13,50,0.26,20,31,0.645,23,35,58,27,8,1,14,25,29,51,0.5686274509803921,0
44,84,0.524,10,32,0.313,24,32,0.75,6,36,42,28,10,3,12,21,34,52,0.6538461538461539,1
46,92,0.5,10,28,0.357,10,13,0.769,10,27,37,29,14,3,13,16,36,64,0.5625,0
45,80,0.563,13,30,0.433,19,19,1.0,5,30,35,28,8,8,21,10,32,50,0.64,1
40,86,0.465,18,43,0.419,17,21,0.81,8,26,34,25,5,6,11,20,22,43,0.5116279069767442,0
42,82,0.512,14,29,0.483,21,23,0.913,11,35,46,22,7,4,16,20,28,53,0.5283018867924528,1
42,91,0.462,16,34,0.471,24,33,0.727,12,36,48,20,7,5,15,26,26,57,0.45614035087719296,1
48,98,0.49,9,30,0.3,18,29,0.621,12,35,47,29,10,6,14,21,39,68,0.5735294117647058,0
42,80,0.525,15,36,0.417,20,30,0.667,5,31,36,24,6,3,9,17,27,44,0.6136363636363636,0
43,83,0.518,11,30,0.367,23,29,0.793,12,30,42,25,7,4,10,24,32,53,0.6037735849056604,1
44,90,0.489,13,35,0.371,19,20,0.95,8,25,33,32,14,4,14,14,31,55,0.5636363636363636,0
51,94,0.543,13,33,0.394,13,17,0.765,13,37,50,31,10,0,19,20,38,61,0.6229508196721312,1
42,95,0.442,15,31,0.484,15,19,0.789,13,33,46,25,9,4,14,17,27,64,0.421875,1
43,88,0.489,7,27,0.259,14,18,0.778,7,36,43,27,8,6,15,17,36,61,0.5901639344262295,0
52,95,0.547,20,42,0.476,10,12,0.833,5,35,40,35,6,6,9,21,32,53,0.6037735849056604,1
50,100,0.5,10,34,0.294,15,16,0.938,13,35,48,24,4,4,10,17,40,66,0.6060606060606061,0
46,103,0.447,9,32,0.281,18,20,0.9,20,40,60,22,4,4,11,17,37,71,0.5211267605633803,1
40,98,0.408,17,40,0.425,14,15,0.933,11,32,43,24,5,14,7,15,23,58,0.39655172413793105,0
43,93,0.462,9,35,0.257,26,34,0.765,18,40,58,24,7,6,14,20,34,58,0.5862068965517241,1
43,94,0.457,11,34,0.324,18,27,0.667,12,30,42,25,7,7,12,24,32,60,0.5333333333333333,0
43,100,0.43,21,51,0.412,9,11,0.818,7,41,48,28,9,7,17,14,22,49,0.4489795918367347,0
46,112,0.411,23,55,0.418,10,11,0.909,18,47,65,33,12,4,15,15,23,57,0.40350877192982454,1
44,86,0.512,15,32,0.469,16,22,0.727,13,31,44,25,7,9,14,17,29,54,0.5370370370370371,1
41,85,0.482,16,34,0.471,13,17,0.765,6,27,33,28,10,3,16,19,25,51,0.49019607843137253,0
32,90,0.356,7,31,0.226,24,27,0.889,20,34,54,21,5,3,10,17,25,59,0.423728813559322,0
42,87,0.483,10,30,0.333,12,16,0.75,7,32,39,22,3,4,10,20,32,57,0.5614035087719298,1
39,85,0.459,15,43,0.349,15,23,0.652,10,33,43,25,4,3,11,17,24,42,0.5714285714285714,0
41,86,0.477,10,38,0.263,20,24,0.833,11,34,45,25,7,5,11,16,31,48,0.6458333333333334,1
37,80,0.463,9,28,0.321,27,32,0.844,4,34,38,17,11,2,12,17,28,52,0.5384615384615384,1
34,81,0.42,12,34,0.353,16,19,0.842,8,35,43,23,3,4,22,25,22,47,0.46808510638297873,0
42,94,0.447,11,37,0.297,19,20,0.95,5,30,35,19,8,2,17,17,31,57,0.543859649122807,0
48,99,0.485,13,37,0.351,17,20,0.85,15,39,54,34,10,10,19,20,35,62,0.5645161290322581,1
41,85,0.482,15,35,0.429,31,37,0.838,8,31,39,19,10,2,15,19,26,50,0.52,1
44,89,0.494,13,44,0.295,18,22,0.818,7,33,40,30,11,3,14,26,31,45,0.6888888888888889,0
41,87,0.471,7,27,0.259,25,34,0.735,11,29,40,18,8,3,10,22,34,60,0.5666666666666667,1
41,80,0.513,10,21,0.476,16,22,0.727,7,36,43,25,8,5,19,26,31,59,0.5254237288135594,0
42,84,0.5,17,44,0.386,21,24,0.875,4,24,28,32,11,2,10,21,25,40,0.625,1
45,90,0.5,12,31,0.387,18,24,0.75,15,34,49,27,4,8,15,19,33,59,0.559322033898305,0
42,88,0.477,11,37,0.297,17,21,0.81,12,34,46,18,8,3,11,18,31,51,0.6078431372549019,1
43,89,0.483,12,36,0.333,10,17,0.588,10,27,37,24,6,2,11,17,31,53,0.5849056603773585,0
43,88,0.489,10,33,0.303,14,20,0.7,10,36,46,26,10,2,19,21,33,55,0.6,0
43,86,0.5,19,40,0.475,22,29,0.759,8,35,43,35,11,7,15,19,24,46,0.5217391304347826,1
34,84,0.405,6,26,0.231,19,23,0.826,6,29,35,19,4,5,10,20,28,58,0.4827586206896552,0
41,80,0.513,11,29,0.379,19,23,0.826,9,33,42,29,6,10,9,19,30,51,0.5882352941176471,1
36,95,0.379,10,39,0.256,20,23,0.87,12,43,55,26,8,3,9,19,26,56,0.4642857142857143,1
33,88,0.375,10,36,0.278,14,19,0.737,10,40,50,24,3,7,19,18,23,52,0.4423076923076923,0
54,92,0.587,12,28,0.429,16,23,0.696,5,32,37,39,12,10,13,22,42,64,0.65625,1
44,97,0.454,4,22,0.182,23,28,0.821,18,33,51,17,6,4,16,19,40,75,0.5333333333333333,0
38,83,0.458,12,37,0.324,16,19,0.842,7,40,47,23,9,3,16,17,26,46,0.5652173913043478,1
35,90,0.389,12,46,0.261,6,8,0.75,8,33,41,23,3,3,13,16,23,44,0.5227272727272727,0
36,86,0.419,10,34,0.294,15,24,0.625,13,29,42,23,7,5,16,15,26,52,0.5,0
48,100,0.48,14,36,0.389,7,10,0.7,19,33,52,28,10,5,15,21,34,64,0.53125,1
46,95,0.484,4,21,0.19,16,22,0.727,17,30,47,25,8,4,14,23,42,74,0.5675675675675675,0
45,83,0.542,19,39,0.487,14,24,0.583,9,32,41,28,8,6,16,21,26,44,0.5909090909090909,1
39,87,0.448,12,42,0.286,19,21,0.905,10,28,38,19,7,5,14,22,27,45,0.6,0
40,90,0.444,11,35,0.314,20,27,0.741,15,33,48,27,9,2,11,21,29,55,0.5272727272727272,1
43,90,0.478,16,38,0.421,13,18,0.722,16,32,48,31,7,4,18,25,27,52,0.5192307692307693,0
37,79,0.468,14,34,0.412,31,36,0.861,9,28,37,20,12,4,13,13,23,45,0.5111111111111111,1
50,86,0.581,15,33,0.455,18,22,0.818,5,38,43,29,2,4,13,18,35,53,0.660377358490566,1
46,104,0.442,21,50,0.42,11,15,0.733,15,30,45,31,4,2,9,21,25,54,0.46296296296296297,0
45,88,0.511,14,30,0.467,16,19,0.842,8,22,30,29,8,6,9,19,31,58,0.5344827586206896,1
43,76,0.566,6,23,0.261,12,15,0.8,6,34,40,28,3,8,22,18,37,53,0.6981132075471698,0
40,82,0.488,18,39,0.462,25,28,0.893,15,37,52,24,8,2,18,16,22,43,0.5116279069767442,1
42,98,0.429,11,43,0.256,13,20,0.65,15,26,41,23,9,3,12,24,31,55,0.5636363636363636,0
35,82,0.427,12,41,0.293,25,34,0.735,11,35,46,25,3,5,17,20,23,41,0.5609756097560976,0
45,99,0.455,11,33,0.333,20,23,0.87,14,37,51,22,9,0,11,25,34,66,0.5151515151515151,1
40,85,0.471,12,39,0.308,24,37,0.649,13,33,46,24,8,6,13,15,28,46,0.6086956521739131,1
41,95,0.432,8,23,0.348,14,16,0.875,8,33,41,23,7,3,11,26,33,72,0.4583333333333333,0
42,81,0.519,15,35,0.429,24,34,0.706,9,43,52,23,8,8,13,13,27,46,0.5869565217391305,1
38,99,0.384,17,45,0.378,14,18,0.778,11,27,38,22,8,3,12,19,21,54,0.3888888888888889,0
44,97,0.454,10,29,0.345,16,21,0.762,13,29,42,24,7,2,9,16,34,68,0.5,0
48,85,0.565,22,41,0.537,14,18,0.778,7,40,47,39,6,7,15,17,26,44,0.5909090909090909,1
42,76,0.553,6,25,0.24,20,25,0.8,4,28,32,29,9,4,14,17,36,51,0.7058823529411765,0
49,93,0.527,12,30,0.4,15,17,0.882,14,30,44,25,10,2,11,18,37,63,0.5873015873015873,1
38,99,0.384,10,34,0.294,11,12,0.917,19,25,44,18,8,3,11,19,28,65,0.4307692307692308,0
44,85,0.518,7,32,0.219,22,22,1.0,10,38,48,24,9,9,15,12,37,53,0.6981132075471698,1
38,78,0.487,18,42,0.429,23,29,0.793,5,40,45,26,6,3,20,19,20,36,0.5555555555555556,1
38,97,0.392,16,42,0.381,22,25,0.88,13,35,48,28,13,4,15,24,22,55,0.4,0
39,75,0.52,17,36,0.472,23,27,0.852,13,33,46,24,8,6,20,21,22,39,0.5641025641025641,1
40,85,0.471,14,41,0.341,15,22,0.682,12,21,33,20,6,2,12,18,26,44,0.5909090909090909,0
34,90,0.378,11,44,0.25,31,37,0.838,11,25,36,21,7,3,10,17,23,46,0.5,0
47,89,0.528,8,29,0.276,12,19,0.632,16,35,51,22,5,3,18,29,39,60,0.65,1
49,88,0.557,17,36,0.472,11,15,0.733,7,29,36,28,5,1,16,25,32,52,0.6153846153846154,0
46,96,0.479,16,34,0.471,26,32,0.813,16,28,44,30,11,1,8,18,30,62,0.4838709677419355,1
46,91,0.505,18,46,0.391,9,14,0.643,12,27,39,29,6,1,16,20,28,45,0.6222222222222222,0
49,82,0.598,13,29,0.448,27,33,0.818,8,33,41,33,8,5,13,16,36,53,0.6792452830188679,1
34,84,0.405,12,40,0.3,24,30,0.8,8,36,44,20,7,5,11,22,22,44,0.5,1
37,84,0.44,12,36,0.333,16,22,0.727,8,38,46,27,3,2,13,23,25,48,0.5208333333333334,0
44,86,0.512,17,33,0.515,32,37,0.865,10,42,52,23,4,4,19,25,27,53,0.5094339622641509,1
49,107,0.458,15,34,0.441,15,26,0.577,16,31,47,26,7,4,10,30,34,73,0.4657534246575342,0
32,82,0.39,13,41,0.317,24,32,0.75,13,44,57,22,2,5,12,17,19,41,0.4634146341463415,1
33,80,0.413,14,39,0.359,16,23,0.696,3,38,41,20,8,4,7,22,19,41,0.4634146341463415,0
47,89,0.528,8,24,0.333,17,25,0.68,13,34,47,29,9,7,10,15,39,65,0.6,1
39,85,0.459,12,27,0.444,10,18,0.556,13,24,37,24,8,3,17,20,27,58,0.46551724137931033,0
54,97,0.557,22,46,0.478,9,15,0.6,8,34,42,36,5,3,10,20,32,51,0.6274509803921569,1
47,89,0.528,11,32,0.344,18,26,0.692,9,35,44,26,5,4,12,16,36,57,0.631578947368421,0
43,86,0.5,8,28,0.286,19,23,0.826,11,36,47,25,7,3,19,20,35,58,0.603448275862069,0
43,90,0.478,13,35,0.371,17,17,1.0,7,28,35,26,7,5,14,22,30,55,0.5454545454545454,1
40,94,0.426,13,31,0.419,18,20,0.9,11,28,39,18,5,4,13,17,27,63,0.42857142857142855,0
47,97,0.485,14,32,0.438,20,28,0.714,19,40,59,29,10,6,10,20,33,65,0.5076923076923077,1
47,98,0.48,11,40,0.275,14,20,0.7,16,38,54,28,6,9,17,20,36,58,0.6206896551724138,0
47,100,0.47,16,41,0.39,17,25,0.68,13,32,45,27,7,8,11,15,31,59,0.5254237288135594,1
46,100,0.46,18,42,0.429,21,31,0.677,14,36,50,33,6,8,16,24,28,58,0.4827586206896552,0
51,94,0.543,11,24,0.458,26,30,0.867,6,41,47,23,9,6,12,21,40,70,0.5714285714285714,1
46,92,0.5,10,32,0.313,19,25,0.76,14,48,62,24,9,9,15,19,36,60,0.6,1
29,86,0.337,5,35,0.143,19,26,0.731,7,28,35,20,10,6,14,16,24,51,0.47058823529411764,0
35,76,0.461,8,23,0.348,16,20,0.8,6,32,38,22,5,6,17,19,27,53,0.5094339622641509,0
48,87,0.552,4,19,0.211,17,22,0.773,9,32,41,31,9,7,11,19,44,68,0.6470588235294118,1
39,82,0.476,12,28,0.429,22,25,0.88,8,27,35,22,8,5,9,17,27,54,0.5,0
43,88,0.489,11,32,0.344,17,24,0.708,15,37,52,20,9,3,13,19,32,56,0.5714285714285714,1
40,79,0.506,16,34,0.471,15,19,0.789,7,28,35,27,8,4,15,26,24,45,0.5333333333333333,1
43,84,0.512,5,20,0.25,19,31,0.613,13,29,42,23,8,3,12,18,38,64,0.59375,0
41,87,0.471,15,42,0.357,29,35,0.829,18,34,52,29,12,2,18,19,26,45,0.5777777777777777,1
38,79,0.481,14,38,0.368,22,31,0.71,8,29,37,20,12,4,19,26,24,41,0.5853658536585366,0
49,101,0.485,14,38,0.368,14,21,0.667,15,37,52,27,13,9,17,24,35,63,0.5555555555555556,1
39,98,0.398,20,52,0.385,22,29,0.759,16,38,54,31,11,4,20,19,19,46,0.41304347826086957,0
35,82,0.427,10,37,0.27,19,24,0.792,14,25,39,23,4,2,14,10,25,45,0.5555555555555556,0
45,80,0.563,17,34,0.5,6,6,1.0,5,27,32,34,8,5,14,18,28,46,0.6086956521739131,1
54,88,0.614,15,35,0.429,18,22,0.818,6,24,30,31,11,6,8,17,39,53,0.7358490566037735,1
45,87,0.517,12,31,0.387,19,20,0.95,12,29,41,28,5,5,17,17,33,56,0.5892857142857143,0
42,84,0.5,10,31,0.323,19,25,0.76,9,36,45,23,14,5,18,22,32,53,0.6037735849056604,1
42,90,0.467,6,22,0.273,18,24,0.75,13,30,43,23,9,3,15,24,36,68,0.5294117647058824,0
39,91,0.429,13,35,0.371,28,34,0.824,15,27,42,27,3,8,13,21,26,56,0.4642857142857143,0
52,95,0.547,18,38,0.474,11,17,0.647,11,28,39,35,5,5,7,24,34,57,0.5964912280701754,1
43,84,0.512,12,33,0.364,12,15,0.8,6,27,33,30,3,2,13,21,31,51,0.6078431372549019,0
41,83,0.494,9,32,0.281,25,28,0.893,15,28,43,23,9,4,12,16,32,51,0.6274509803921569,1
39,85,0.459,5,23,0.217,24,28,0.857,9,33,42,27,5,2,15,23,34,62,0.5483870967741935,0
48,90,0.533,9,27,0.333,17,21,0.81,9,36,45,23,11,3,15,25,39,63,0.6190476190476191,1
42,88,0.477,22,51,0.431,11,16,0.688,5,35,40,30,2,2,8,17,20,37,0.5405405405405406,0
42,97,0.433,17,41,0.415,17,22,0.773,17,39,56,29,3,5,7,14,25,56,0.44642857142857145,1
48,86,0.558,22,37,0.595,14,23,0.609,7,37,44,34,7,7,8,22,26,49,0.5306122448979592,1
41,91,0.451,13,36,0.361,23,27,0.852,12,34,46,27,6,5,10,18,28,55,0.509090909090909,0
42,80,0.525,12,23,0.522,12,13,0.923,6,34,40,31,5,3,17,17,30,57,0.5263157894736842,1
38,82,0.463,12,35,0.343,14,16,0.875,9,24,33,26,10,3,12,16,26,47,0.5531914893617021,0
38,79,0.481,13,39,0.333,23,25,0.92,8,34,42,33,4,4,10,17,25,40,0.625,1
38,82,0.463,10,32,0.313,14,17,0.824,9,30,39,26,4,2,13,20,28,50,0.56,0
42,85,0.494,13,31,0.419,20,24,0.833,10,29,39,28,7,4,10,23,29,54,0.5370370370370371,1
31,76,0.408,9,33,0.273,36,38,0.947,8,28,36,15,4,2,13,22,22,43,0.5116279069767442,0
41,102,0.402,10,38,0.263,13,17,0.765,13,31,44,24,8,3,8,28,31,64,0.484375,0
36,78,0.462,13,32,0.406,26,32,0.813,9,43,52,25,2,9,15,19,23,46,0.5,1
44,99,0.444,14,34,0.412,9,12,0.75,9,32,41,25,6,4,7,15,30,65,0.46153846153846156,0
43,82,0.524,16,45,0.356,16,21,0.762,7,38,45,35,3,8,12,13,27,37,0.7297297297297297,1
44,92,0.478,15,36,0.417,17,24,0.708,9,31,40,31,7,9,14,31,29,56,0.5178571428571429,0
42,84,0.5,11,28,0.393,29,36,0.806,6,38,44,20,8,3,16,20,31,56,0.5535714285714286,1
43,94,0.457,12,28,0.429,19,23,0.826,18,31,49,26,11,3,10,18,31,66,0.4696969696969697,1
37,82,0.451,6,29,0.207,22,24,0.917,11,29,40,24,7,9,15,14,31,53,0.5849056603773585,0
48,101,0.475,5,22,0.227,17,20,0.85,20,31,51,21,4,4,12,13,43,79,0.5443037974683544,0
51,94,0.543,14,28,0.5,10,16,0.625,10,31,41,26,9,5,12,18,37,66,0.5606060606060606,1
37,82,0.451,9,26,0.346,26,34,0.765,13,35,48,27,5,6,22,26,28,56,0.5,0
41,90,0.456,10,31,0.323,23,32,0.719,10,27,37,26,12,6,11,22,31,59,0.5254237288135594,1
44,88,0.5,17,48,0.354,16,19,0.842,16,32,48,31,12,6,20,14,27,40,0.675,1
39,93,0.419,10,36,0.278,20,24,0.833,13,28,41,14,14,2,18,14,29,57,0.5087719298245614,0
39,84,0.464,11,36,0.306,19,20,0.95,8,29,37,22,5,4,12,19,28,48,0.5833333333333334,0
41,89,0.461,10,35,0.286,20,26,0.769,17,33,50,21,5,3,11,18,31,54,0.5740740740740741,1
51,83,0.614,14,24,0.583,24,32,0.75,7,27,34,34,9,4,15,24,37,59,0.6271186440677966,1
48,85,0.565,14,28,0.5,24,28,0.857,7,27,34,26,7,3,17,22,34,57,0.5964912280701754,0
39,94,0.415,7,33,0.212,24,29,0.828,4,38,42,20,12,7,11,18,32,61,0.5245901639344263,1
38,90,0.422,10,36,0.278,19,22,0.864,9,45,54,28,8,8,21,25,28,54,0.5185185185185185,0
41,97,0.423,19,52,0.365,19,25,0.76,8,35,43,28,5,3,6,20,22,45,0.4888888888888889,0
46,88,0.523,16,36,0.444,20,23,0.87,6,42,48,33,3,8,12,23,30,52,0.5769230769230769,1
37,91,0.407,13,40,0.325,20,24,0.833,9,26,35,20,8,2,10,26,24,51,0.47058823529411764,0
44,95,0.463,14,38,0.368,27,36,0.75,21,40,61,26,5,6,11,20,30,57,0.5263157894736842,1
42,83,0.506,14,29,0.483,17,21,0.81,8,26,34,23,6,3,14,20,28,54,0.5185185185185185,1
41,92,0.446,9,33,0.273,18,23,0.783,19,30,49,25,6,5,17,19,32,59,0.5423728813559322,0
39,93,0.419,10,37,0.27,13,14,0.929,12,35,47,19,2,4,12,21,29,56,0.5178571428571429,1
41,86,0.477,6,31,0.194,12,21,0.571,12,34,46,21,9,2,14,21,35,55,0.6363636363636364,0
30,87,0.345,13,41,0.317,11,19,0.579,10,27,37,22,8,3,16,19,17,46,0.3695652173913043,0
45,81,0.556,10,24,0.417,19,23,0.826,5,44,49,31,8,2,16,19,35,57,0.6140350877192983,1
42,83,0.506,10,32,0.313,18,23,0.783,4,29,33,30,7,4,14,23,32,51,0.6274509803921569,0
43,80,0.538,12,27,0.444,24,25,0.96,7,35,42,27,7,5,16,21,31,53,0.5849056603773585,1
49,92,0.533,18,44,0.409,16,23,0.696,11,32,43,33,9,3,6,15,31,48,0.6458333333333334,1
39,81,0.481,17,44,0.386,14,21,0.667,10,32,42,25,3,4,14,19,22,37,0.5945945945945946,0
39,82,0.476,16,37,0.432,22,26,0.846,11,33,44,30,9,4,18,22,23,45,0.5111111111111111,1
34,83,0.41,6,25,0.24,17,22,0.773,15,27,42,18,7,4,19,16,28,58,0.4827586206896552,0
50,90,0.556,12,39,0.308,15,18,0.833,11,33,44,33,7,5,13,20,38,51,0.7450980392156863,1
44,89,0.494,17,40,0.425,20,28,0.714,8,23,31,27,7,2,10,17,27,49,0.5510204081632653,0
42,90,0.467,12,31,0.387,15,20,0.75,12,27,39,23,7,6,17,31,30,59,0.5084745762711864,0
39,70,0.557,8,17,0.471,36,46,0.783,5,31,36,27,7,2,15,20,31,53,0.5849056603773585,1
48,93,0.516,12,33,0.364,17,23,0.739,20,28,48,27,6,3,16,25,36,60,0.6,0
45,87,0.517,12,36,0.333,28,33,0.848,12,24,36,27,8,4,11,21,33,51,0.6470588235294118,1
42,82,0.512,16,40,0.4,20,25,0.8,9,33,42,29,7,5,17,25,26,42,0.6190476190476191,0
45,79,0.57,16,28,0.571,21,26,0.808,2,27,29,28,9,1,10,18,29,51,0.5686274509803921,1
36,93,0.387,9,39,0.231,13,20,0.65,8,38,46,26,7,6,19,21,27,54,0.5,0
51,98,0.52,15,43,0.349,13,24,0.542,10,44,54,24,10,4,15,14,36,55,0.6545454545454545,1
45,85,0.529,12,26,0.462,22,25,0.88,9,32,41,28,6,6,17,25,33,59,0.559322033898305,0
45,92,0.489,11,26,0.423,24,29,0.828,11,31,42,27,7,3,11,20,34,66,0.5151515151515151,1
43,77,0.558,11,21,0.524,21,25,0.84,8,31,39,27,4,5,18,29,32,56,0.5714285714285714,1
39,89,0.438,7,34,0.206,29,39,0.744,13,27,40,21,11,7,10,22,32,55,0.5818181818181818,0
45,93,0.484,13,41,0.317,24,30,0.8,7,36,43,28,9,5,9,24,32,52,0.6153846153846154,1
39,82,0.476,11,35,0.314,26,36,0.722,7,40,47,24,4,5,17,21,28,47,0.5957446808510638,0
42,83,0.506,15,32,0.469,19,21,0.905,11,30,41,28,7,2,10,18,27,51,0.5294117647058824,1
44,87,0.506,4,26,0.154,12,16,0.75,10,27,37,20,4,4,7,15,40,61,0.6557377049180327,0
42,89,0.472,12,32,0.375,20,26,0.769,13,27,40,24,7,7,10,21,30,57,0.5263157894736842,1
39,81,0.481,12,34,0.353,24,27,0.889,9,33,42,24,7,7,16,21,27,47,0.574468085106383,0
41,93,0.441,13,39,0.333,10,11,0.909,13,27,40,24,6,3,14,20,28,54,0.5185185185185185,0
47,84,0.56,18,37,0.486,15,20,0.75,8,34,42,34,9,5,15,9,29,47,0.6170212765957447,1
38,83,0.458,9,37,0.243,11,16,0.688,4,34,38,24,8,4,17,17,29,46,0.6304347826086957,0
45,98,0.459,11,34,0.324,14,15,0.933,11,41,52,26,11,0,11,14,34,64,0.53125,1
37,88,0.42,12,40,0.3,20,26,0.769,13,31,44,26,8,8,13,15,25,48,0.5208333333333334,0
40,87,0.46,13,32,0.406,18,21,0.857,8,35,43,25,8,7,16,19,27,55,0.4909090909090909,1
39,84,0.464,4,26,0.154,13,22,0.591,6,38,44,24,9,4,17,16,35,58,0.603448275862069,0
44,93,0.473,18,42,0.429,14,19,0.737,9,40,49,28,11,6,15,15,26,51,0.5098039215686274,1
43,89,0.483,11,28,0.393,20,27,0.741,6,37,43,32,7,4,8,17,32,61,0.5245901639344263,1
41,84,0.488,9,36,0.25,18,24,0.75,7,38,45,25,3,4,11,19,32,48,0.6666666666666666,0
38,78,0.487,8,29,0.276,28,34,0.824,4,34,38,23,8,1,10,20,30,49,0.6122448979591837,0
42,88,0.477,18,50,0.36,18,24,0.75,10,39,49,27,3,0,11,21,24,38,0.631578947368421,1
40,92,0.435,14,36,0.389,17,19,0.895,12,33,45,21,6,5,10,19,26,56,0.4642857142857143,0
42,91,0.462,12,34,0.353,20,28,0.714,16,37,53,20,9,4,11,14,30,57,0.5263157894736842,1
47,87,0.54,7,23,0.304,13,21,0.619,10,28,38,25,7,3,16,14,40,64,0.625,0
57,93,0.613,25,42,0.595,12,14,0.857,5,30,35,36,12,7,11,19,32,51,0.6274509803921569,1
48,84,0.571,17,28,0.607,11,14,0.786,11,36,47,33,6,8,17,19,31,56,0.5535714285714286,1
37,86,0.43,6,31,0.194,16,18,0.889,8,23,31,23,10,5,14,14,31,55,0.5636363636363636,0
48,89,0.539,9,29,0.31,22,29,0.759,12,31,43,33,2,7,12,25,39,60,0.65,0
47,89,0.528,13,39,0.333,28,32,0.875,5,28,33,29,6,3,4,23,34,50,0.68,1
34,73,0.466,6,25,0.24,23,30,0.767,8,31,39,23,8,4,22,18,28,48,0.5833333333333334,0
41,92,0.446,13,37,0.351,23,29,0.793,15,31,46,25,12,9,11,24,28,55,0.509090909090909,1
55,99,0.556,22,50,0.44,12,16,0.75,9,41,50,42,6,11,13,20,33,49,0.673469387755102,1
40,104,0.385,11,40,0.275,25,34,0.735,20,31,51,28,6,5,11,15,29,64,0.453125,0
51,101,0.505,13,38,0.342,9,15,0.6,11,30,41,35,4,4,5,21,38,63,0.6031746031746031,0
51,85,0.6,15,30,0.5,19,26,0.731,6,37,43,29,3,8,10,16,36,55,0.6545454545454545,1
52,96,0.542,14,37,0.378,12,12,1.0,10,22,32,33,7,7,17,18,38,59,0.6440677966101694,0
53,96,0.552,15,30,0.5,22,25,0.88,15,27,42,33,10,8,13,14,38,66,0.5757575757575758,1
39,88,0.443,9,36,0.25,19,21,0.905,4,36,40,26,7,2,10,19,30,52,0.5769230769230769,0
47,89,0.528,15,36,0.417,20,28,0.714,7,41,48,28,4,3,12,18,32,53,0.6037735849056604,1
51,96,0.531,21,34,0.618,8,9,0.889,12,33,45,36,11,3,16,21,30,62,0.4838709677419355,1
39,75,0.52,15,33,0.455,17,21,0.81,2,29,31,29,9,6,20,14,24,42,0.5714285714285714,0
44,89,0.494,18,40,0.45,23,25,0.92,17,28,45,30,6,6,8,18,26,49,0.5306122448979592,1
38,80,0.475,12,30,0.4,12,14,0.857,8,24,32,22,5,4,14,19,26,50,0.52,0
34,78,0.436,13,31,0.419,24,27,0.889,8,28,36,21,3,7,13,16,21,47,0.44680851063829785,0
47,93,0.505,15,32,0.469,16,19,0.842,13,32,45,35,4,9,8,22,32,61,0.5245901639344263,1
47,91,0.516,9,28,0.321,10,16,0.625,11,34,45,30,3,7,17,14,38,63,0.6031746031746031,0
44,95,0.463,16,43,0.372,17,21,0.81,14,28,42,30,11,1,9,13,28,52,0.5384615384615384,1
48,89,0.539,13,33,0.394,14,19,0.737,6,33,39,28,8,7,11,22,35,56,0.625,1
45,98,0.459,7,31,0.226,22,26,0.846,14,34,48,27,4,5,10,15,38,67,0.5671641791044776,0
36,97,0.371,8,36,0.222,13,18,0.722,3,35,38,22,7,0,10,16,28,61,0.45901639344262296,0
52,91,0.571,18,44,0.409,15,21,0.714,9,52,61,29,4,11,15,18,34,47,0.723404255319149,1
32,84,0.381,19,49,0.388,21,22,0.955,3,34,37,18,8,7,8,24,13,35,0.37142857142857144,0
39,88,0.443,12,29,0.414,20,24,0.833,14,44,58,27,6,2,14,18,27,59,0.4576271186440678,1
35,80,0.438,6,25,0.24,15,18,0.833,12,24,36,20,6,1,19,22,29,55,0.5272727272727272,0
39,83,0.47,9,30,0.3,21,24,0.875,13,28,41,20,5,7,11,16,30,53,0.5660377358490566,1
34,80,0.425,17,40,0.425,14,25,0.56,9,40,49,25,10,2,17,20,17,40,0.425,1
34,82,0.415,15,40,0.375,13,17,0.765,6,31,37,25,9,2,16,19,19,42,0.4523809523809524,0
47,87,0.54,14,31,0.452,10,13,0.769,8,34,42,32,8,2,9,23,33,56,0.5892857142857143,1
38,75,0.507,13,36,0.361,19,28,0.679,8,30,38,24,5,4,18,18,25,39,0.6410256410256411,0
37,91,0.407,8,35,0.229,24,28,0.857,15,29,44,17,7,8,15,20,29,56,0.5178571428571429,0
45,85,0.529,7,22,0.318,22,28,0.786,9,38,47,30,7,3,11,21,38,63,0.6031746031746031,1
41,94,0.436,12,35,0.343,24,28,0.857,13,29,42,23,13,2,11,19,29,59,0.4915254237288136,1
39,82,0.476,14,32,0.438,20,27,0.741,8,29,37,18,5,7,18,22,25,50,0.5,0
38,86,0.442,16,36,0.444,12,20,0.6,12,33,45,25,6,2,18,12,22,50,0.44,0
45,98,0.459,11,31,0.355,13,16,0.813,18,35,53,22,13,6,13,19,34,67,0.5074626865671642,1
43,89,0.483,8,30,0.267,17,22,0.773,11,29,40,18,10,3,11,20,35,59,0.5932203389830508,0
43,85,0.506,11,32,0.344,19,22,0.864,10,32,42,34,8,4,12,16,32,53,0.6037735849056604,1
45,95,0.474,14,45,0.311,22,26,0.846,15,35,50,28,5,4,9,23,31,50,0.62,1
41,92,0.446,7,24,0.292,28,36,0.778,14,33,47,22,5,0,10,20,34,68,0.5,0
47,83,0.566,18,37,0.486,15,17,0.882,4,29,33,29,7,8,13,23,29,46,0.6304347826086957,1
39,93,0.419,8,28,0.286,18,23,0.783,14,29,43,20,6,3,14,19,31,65,0.47692307692307695,0
44,82,0.537,9,23,0.391,15,21,0.714,8,26,34,26,9,3,15,11,35,59,0.5932203389830508,0
48,81,0.593,20,40,0.5,8,16,0.5,6,31,37,41,10,4,18,17,28,41,0.6829268292682927,1
42,87,0.483,7,26,0.269,24,29,0.828,13,27,40,24,6,4,14,18,35,61,0.5737704918032787,0
50,86,0.581,17,39,0.436,20,28,0.714,7,32,39,35,11,8,11,20,33,47,0.7021276595744681,1
49,86,0.57,12,28,0.429,14,17,0.824,8,45,53,31,5,6,17,16,37,58,0.6379310344827587,1
35,90,0.389,7,33,0.212,13,15,0.867,6,23,29,15,6,2,12,16,28,57,0.49122807017543857,0
44,86,0.512,9,24,0.375,22,34,0.647,11,29,40,33,6,3,6,27,35,62,0.5645161290322581,1
39,84,0.464,5,27,0.185,32,40,0.8,12,30,42,16,4,4,10,23,34,57,0.5964912280701754,0
43,101,0.426,11,36,0.306,20,22,0.909,18,31,49,31,7,7,7,20,32,65,0.49230769230769234,1
38,86,0.442,9,36,0.25,18,27,0.667,10,37,47,25,2,7,13,19,29,50,0.58,0
47,93,0.505,9,25,0.36,15,22,0.682,10,30,40,20,5,6,8,24,38,68,0.5588235294117647,0
41,89,0.461,12,27,0.444,26,33,0.788,14,37,51,25,5,3,15,16,29,62,0.46774193548387094,1
42,90,0.467,12,27,0.444,13,14,0.929,11,30,41,30,6,4,19,18,30,63,0.47619047619047616,0
43,82,0.524,18,40,0.45,16,22,0.727,11,30,41,32,11,4,19,18,25,42,0.5952380952380952,1
41,100,0.41,14,49,0.286,12,15,0.8,8,39,47,24,9,8,16,15,27,51,0.5294117647058824,0
42,88,0.477,12,34,0.353,17,23,0.739,7,42,49,26,11,6,17,17,30,54,0.5555555555555556,1
52,94,0.553,14,35,0.4,19,30,0.633,15,37,52,34,6,7,18,24,38,59,0.6440677966101694,1
50,96,0.521,11,30,0.367,23,29,0.793,7,32,39,25,11,3,11,21,39,66,0.5909090909090909,0
32,80,0.4,10,33,0.303,18,19,0.947,12,31,43,18,6,3,16,10,22,47,0.46808510638297873,0
45,93,0.484,8,36,0.222,8,9,0.889,15,32,47,32,8,7,9,13,37,57,0.6491228070175439,1
45,93,0.484,11,44,0.25,10,11,0.909,7,31,38,29,5,8,12,14,34,49,0.6938775510204082,0
54,99,0.545,13,37,0.351,9,13,0.692,6,37,43,33,7,3,11,13,41,62,0.6612903225806451,1
46,98,0.469,9,30,0.3,13,21,0.619,20,32,52,21,9,2,10,18,37,68,0.5441176470588235,0
44,82,0.537,17,35,0.486,18,27,0.667,8,33,41,33,4,9,12,18,27,47,0.574468085106383,1
45,86,0.523,7,20,0.35,24,30,0.8,13,32,45,22,10,3,16,14,38,66,0.5757575757575758,1
45,88,0.511,9,33,0.273,11,13,0.846,6,26,32,31,10,4,14,22,36,55,0.6545454545454545,0
58,93,0.624,10,25,0.4,23,30,0.767,14,38,52,28,5,5,19,18,48,68,0.7058823529411765,1
53,101,0.525,14,30,0.467,16,22,0.727,10,19,29,36,9,4,8,25,39,71,0.5492957746478874,0
48,78,0.615,22,37,0.595,23,31,0.742,3,29,32,28,8,4,16,21,26,41,0.6341463414634146,1
49,95,0.516,11,32,0.344,23,28,0.821,14,31,45,26,8,4,13,20,38,63,0.6031746031746031,0
35,79,0.443,13,39,0.333,9,14,0.643,6,29,35,20,5,0,11,18,22,40,0.55,0
38,76,0.5,13,31,0.419,12,23,0.522,9,38,47,22,8,3,16,14,25,45,0.5555555555555556,1
40,80,0.5,16,33,0.485,10,14,0.714,10,32,42,27,1,3,18,22,24,47,0.5106382978723404,0
39,87,0.448,10,29,0.345,19,25,0.76,10,28,38,19,7,3,10,18,29,58,0.5,1
38,83,0.458,18,46,0.391,14,18,0.778,8,32,40,24,3,3,14,22,20,37,0.5405405405405406,0
37,80,0.463,17,36,0.472,25,30,0.833,11,32,43,26,9,4,11,19,20,44,0.45454545454545453,1
40,90,0.444,12,35,0.343,8,12,0.667,16,38,54,24,4,4,21,24,28,55,0.509090909090909,0
40,96,0.417,6,20,0.3,21,27,0.778,15,33,48,23,11,8,8,16,34,76,0.4473684210526316,1
42,92,0.457,18,48,0.375,18,24,0.75,10,49,59,30,9,4,10,11,24,44,0.5454545454545454,1
30,93,0.323,9,39,0.231,11,12,0.917,8,37,45,18,5,6,14,15,21,54,0.3888888888888889,0
49,90,0.544,12,31,0.387,18,20,0.9,8,37,45,28,5,6,16,17,37,59,0.6271186440677966,1
45,95,0.474,10,35,0.286,17,21,0.81,9,30,39,31,10,4,15,16,35,60,0.5833333333333334,0
38,80,0.475,13,27,0.481,18,22,0.818,8,38,46,22,6,1,12,24,25,53,0.4716981132075472,1
32,80,0.4,4,28,0.143,20,32,0.625,11,29,40,21,4,5,10,21,28,52,0.5384615384615384,0
51,91,0.56,22,43,0.512,16,20,0.8,7,40,47,28,8,5,9,18,29,48,0.6041666666666666,1
38,101,0.376,14,43,0.326,9,13,0.692,15,30,45,22,4,1,13,16,24,58,0.41379310344827586,0
46,96,0.479,9,29,0.31,13,14,0.929,13,39,52,23,3,7,18,17,37,67,0.5522388059701493,0
42,96,0.438,17,51,0.333,21,22,0.955,10,32,42,27,8,4,12,14,25,45,0.5555555555555556,1
39,91,0.429,8,37,0.216,21,23,0.913,16,30,46,23,6,3,11,14,31,54,0.5740740740740741,0
49,88,0.557,15,33,0.455,11,13,0.846,9,32,41,33,9,3,13,17,34,55,0.6181818181818182,1
45,88,0.511,13,31,0.419,18,22,0.818,9,33,42,25,12,4,7,13,32,57,0.5614035087719298,1
35,77,0.455,14,37,0.378,7,10,0.7,4,32,36,27,3,5,22,21,21,40,0.525,0
49,93,0.527,17,36,0.472,15,24,0.625,16,32,48,24,6,5,10,12,32,57,0.5614035087719298,1
44,86,0.512,17,37,0.459,11,13,0.846,3,30,33,33,2,9,10,21,27,49,0.5510204081632653,0
42,91,0.462,15,38,0.395,16,23,0.696,14,32,46,27,8,4,15,20,27,53,0.5094339622641509,0
47,93,0.505,21,49,0.429,15,21,0.714,14,31,45,37,5,4,15,18,26,44,0.5909090909090909,1
43,89,0.483,11,35,0.314,18,27,0.667,13,27,40,24,7,7,12,28,32,54,0.5925925925925926,0
38,83,0.458,11,31,0.355,34,45,0.756,14,32,46,18,9,5,12,24,27,52,0.5192307692307693,1
42,88,0.477,4,30,0.133,29,34,0.853,11,34,45,21,10,3,11,24,38,58,0.6551724137931034,0
45,98,0.459,12,41,0.293,19,28,0.679,20,36,56,30,5,4,16,21,33,57,0.5789473684210527,1
34,90,0.378,11,35,0.314,15,18,0.833,12,38,50,26,5,8,18,14,23,55,0.41818181818181815,0
43,96,0.448,9,33,0.273,13,17,0.765,12,39,51,25,11,7,15,16,34,63,0.5396825396825397,1
45,90,0.5,9,22,0.409,24,30,0.8,15,38,53,28,10,5,16,17,36,68,0.5294117647058824,1
41,95,0.432,13,39,0.333,16,19,0.842,12,27,39,25,10,4,16,22,28,56,0.5,0
42,84,0.5,8,26,0.308,18,23,0.783,14,20,34,26,6,3,13,19,34,58,0.5862068965517241,0
41,73,0.562,12,31,0.387,23,25,0.92,9,28,37,28,7,6,18,20,29,42,0.6904761904761905,1
38,95,0.4,6,26,0.231,11,20,0.55,15,36,51,19,11,5,11,16,32,69,0.463768115942029,0
37,88,0.42,10,27,0.37,16,21,0.762,13,38,51,28,8,7,16,16,27,61,0.4426229508196721,1
54,88,0.614,19,39,0.487,11,15,0.733,8,33,41,38,11,7,13,21,35,49,0.7142857142857143,1
40,85,0.471,19,38,0.5,15,23,0.652,9,24,33,29,9,6,20,15,21,47,0.44680851063829785,0
44,88,0.5,8,24,0.333,20,26,0.769,6,42,48,26,2,14,11,16,36,64,0.5625,1
41,105,0.39,17,50,0.34,10,12,0.833,15,36,51,24,5,5,13,24,24,55,0.43636363636363634,0
47,77,0.61,14,34,0.412,14,16,0.875,1,30,31,32,3,2,14,23,33,43,0.7674418604651163,0
45,86,0.523,13,37,0.351,26,29,0.897,10,26,36,27,6,0,11,16,32,49,0.6530612244897959,1
42,85,0.494,11,29,0.379,19,23,0.826,11,26,37,25,5,4,13,29,31,56,0.5535714285714286,0
42,86,0.488,7,17,0.412,31,35,0.886,14,26,40,21,6,5,7,15,35,69,0.5072463768115942,1
49,95,0.516,10,38,0.263,22,32,0.688,10,37,47,24,4,3,14,15,39,57,0.6842105263157895,0
51,108,0.472,12,35,0.343,18,22,0.818,16,37,53,28,10,3,11,22,39,73,0.5342465753424658,1
40,91,0.44,8,32,0.25,22,30,0.733,11,41,52,24,5,1,11,23,32,59,0.5423728813559322,0
38,86,0.442,9,32,0.281,26,34,0.765,7,33,40,25,6,2,9,26,29,54,0.5370370370370371,1
39,84,0.464,19,43,0.442,10,12,0.833,8,39,47,29,1,3,18,22,20,41,0.4878048780487805,0
50,94,0.532,9,31,0.29,19,22,0.864,4,32,36,29,9,6,3,13,41,63,0.6507936507936508,1
56,104,0.538,8,28,0.286,8,8,1.0,15,30,45,38,8,6,8,14,48,76,0.631578947368421,1
42,85,0.494,15,31,0.484,9,13,0.692,10,27,37,26,3,4,18,11,27,54,0.5,0
36,83,0.434,9,24,0.375,24,29,0.828,11,33,44,21,5,6,17,26,27,59,0.4576271186440678,0
44,90,0.489,9,24,0.375,18,26,0.692,13,30,43,23,7,7,13,22,35,66,0.5303030303030303,1
42,105,0.4,9,42,0.214,17,17,1.0,22,35,57,26,9,4,15,22,33,63,0.5238095238095238,0
44,100,0.44,9,33,0.273,15,18,0.833,17,30,47,24,11,7,13,17,35,67,0.5223880597014925,1
52,93,0.559,9,30,0.3,21,28,0.75,11,40,51,36,4,8,6,9,43,63,0.6825396825396826,1
44,102,0.431,13,34,0.382,8,10,0.8,16,28,44,23,4,4,10,18,31,68,0.45588235294117646,0
40,87,0.46,12,36,0.333,12,13,0.923,11,25,36,19,3,2,11,17,28,51,0.5490196078431373,0
46,80,0.575,10,28,0.357,15,21,0.714,7,35,42,28,8,5,12,17,36,52,0.6923076923076923,1
43,93,0.462,9,30,0.3,12,20,0.6,11,31,42,29,12,3,10,26,34,63,0.5396825396825397,1
38,79,0.481,11,26,0.423,18,23,0.783,7,40,47,29,3,5,18,17,27,53,0.5094339622641509,0
39,79,0.494,16,37,0.432,15,18,0.833,5,33,38,26,9,5,19,18,23,42,0.5476190476190477,0
46,88,0.523,13,32,0.406,13,18,0.722,7,32,39,31,12,4,12,17,33,56,0.5892857142857143,1
46,81,0.568,13,34,0.382,23,28,0.821,5,33,38,31,4,6,13,30,33,47,0.7021276595744681,1
36,88,0.409,11,32,0.344,35,41,0.854,13,28,41,21,7,0,8,23,25,56,0.44642857142857145,0
32,78,0.41,9,33,0.273,29,36,0.806,9,29,38,22,4,1,16,29,23,45,0.5111111111111111,0
43,75,0.573,17,33,0.515,25,40,0.625,7,34,41,30,11,6,16,26,26,42,0.6190476190476191,1
52,98,0.531,13,34,0.382,25,29,0.862,14,38,52,31,8,3,18,25,39,64,0.609375,1
49,103,0.476,11,44,0.25,25,32,0.781,13,30,43,24,9,5,15,23,38,59,0.6440677966101694,0
41,85,0.482,8,24,0.333,17,22,0.773,7,37,44,21,7,6,12,13,33,61,0.5409836065573771,1
39,90,0.433,13,35,0.371,11,14,0.786,7,33,40,21,6,8,10,18,26,55,0.4727272727272727,0
48,86,0.558,10,28,0.357,17,19,0.895,7,41,48,26,5,7,17,18,38,58,0.6551724137931034,1
41,89,0.461,7,31,0.226,16,20,0.8,6,26,32,16,8,6,8,18,34,58,0.5862068965517241,0
42,88,0.477,15,33,0.455,21,28,0.75,10,31,41,27,13,7,7,18,27,55,0.4909090909090909,1
36,77,0.468,12,31,0.387,16,19,0.842,6,36,42,27,3,4,18,22,24,46,0.5217391304347826,0
41,80,0.513,13,36,0.361,23,26,0.885,5,28,33,26,12,2,8,18,28,44,0.6363636363636364,1
36,73,0.493,11,28,0.393,22,27,0.815,6,29,35,21,5,2,14,22,25,45,0.5555555555555556,0
44,93,0.473,11,32,0.344,26,35,0.743,13,25,38,23,4,1,10,22,33,61,0.5409836065573771,0
47,95,0.495,20,47,0.426,22,30,0.733,19,35,54,25,6,6,14,22,27,48,0.5625,1
41,87,0.471,11,36,0.306,10,18,0.556,13,34,47,26,9,13,20,18,30,51,0.5882352941176471,0
47,102,0.461,12,31,0.387,18,24,0.75,20,35,55,23,12,3,13,16,35,71,0.49295774647887325,1
42,97,0.433,14,42,0.333,11,17,0.647,13,36,49,23,7,7,10,18,28,55,0.509090909090909,0
42,87,0.483,18,48,0.375,17,22,0.773,8,41,49,30,5,5,12,10,24,39,0.6153846153846154,1
46,91,0.505,17,42,0.405,12,15,0.8,11,32,43,35,8,4,12,22,29,49,0.5918367346938775,1
37,84,0.44,7,20,0.35,22,27,0.815,9,28,37,20,6,4,14,14,30,64,0.46875,0
42,84,0.5,15,31,0.484,18,20,0.9,5,25,30,23,3,7,9,16,27,53,0.5094339622641509,1
45,89,0.506,10,23,0.435,13,17,0.765,13,34,47,25,6,1,13,22,35,66,0.5303030303030303,0
38,91,0.418,15,45,0.333,10,16,0.625,13,30,43,28,4,4,8,17,23,46,0.5,0
39,78,0.5,11,29,0.379,14,16,0.875,6,31,37,21,3,7,12,21,28,49,0.5714285714285714,1
35,90,0.389,13,40,0.325,11,14,0.786,9,29,38,25,7,5,12,16,22,50,0.44,0
43,89,0.483,10,33,0.303,19,26,0.731,15,42,57,25,7,7,14,12,33,56,0.5892857142857143,1
48,96,0.5,12,34,0.353,27,35,0.771,11,33,44,27,6,7,12,21,36,62,0.5806451612903226,1
47,90,0.522,15,33,0.455,24,31,0.774,6,35,41,29,4,3,14,28,32,57,0.5614035087719298,0
50,92,0.543,23,42,0.548,17,29,0.586,12,44,56,33,6,7,18,19,27,50,0.54,1
50,99,0.505,13,27,0.481,15,21,0.714,9,33,42,30,7,4,9,21,37,72,0.5138888888888888,0
45,94,0.479,6,28,0.214,20,26,0.769,12,27,39,23,10,9,14,26,39,66,0.5909090909090909,0
43,84,0.512,13,30,0.433,35,40,0.875,12,36,48,30,10,5,17,23,30,54,0.5555555555555556,1
37,90,0.411,6,33,0.182,13,17,0.765,13,37,50,20,10,7,12,19,31,57,0.543859649122807,0
38,89,0.427,11,38,0.289,10,18,0.556,11,37,48,20,5,7,15,14,27,51,0.5294117647058824,1
46,106,0.434,12,37,0.324,15,19,0.789,22,35,57,31,7,1,9,19,34,69,0.4927536231884058,0
44,89,0.494,20,44,0.455,15,18,0.833,7,32,39,24,4,7,10,18,24,45,0.5333333333333333,1
45,86,0.523,17,43,0.395,16,23,0.696,11,27,38,36,6,7,13,12,28,43,0.6511627906976745,1
41,84,0.488,13,28,0.464,13,14,0.929,9,25,34,27,5,3,14,18,28,56,0.5,0
52,100,0.52,18,46,0.391,16,25,0.64,20,32,52,34,13,8,18,21,34,54,0.6296296296296297,1
45,87,0.517,15,30,0.5,24,30,0.8,10,27,37,33,6,5,17,17,30,57,0.5263157894736842,0
45,89,0.506,12,29,0.414,16,24,0.667,10,34,44,27,4,3,14,17,33,60,0.55,0
43,82,0.524,16,36,0.444,23,27,0.852,5,33,38,23,9,4,13,18,27,46,0.5869565217391305,1
36,83,0.434,11,33,0.333,9,11,0.818,5,33,38,28,10,3,15,11,25,50,0.5,0
39,92,0.424,18,46,0.391,9,11,0.818,13,40,53,26,7,3,13,13,21,46,0.45652173913043476,1
50,104,0.481,12,36,0.333,19,25,0.76,15,34,49,33,10,6,14,25,38,68,0.5588235294117647,0
44,88,0.5,21,39,0.538,29,39,0.744,8,36,44,35,9,8,16,22,23,49,0.46938775510204084,1
46,88,0.523,18,38,0.474,8,9,0.889,9,33,42,31,13,7,17,21,28,50,0.56,1
33,83,0.398,13,39,0.333,15,19,0.789,9,30,39,21,8,8,22,11,20,44,0.45454545454545453,0
49,88,0.557,18,39,0.462,13,15,0.867,10,32,42,39,3,0,11,13,31,49,0.6326530612244898,1
39,76,0.513,10,36,0.278,13,15,0.867,3,29,32,23,7,4,17,18,29,40,0.725,0
44,83,0.53,8,23,0.348,19,23,0.826,9,29,38,24,7,2,13,19,36,60,0.6,0
41,79,0.519,17,36,0.472,20,25,0.8,7,26,33,26,4,6,10,16,24,43,0.5581395348837209,1
51,96,0.531,10,28,0.357,15,18,0.833,8,28,36,34,7,14,16,22,41,68,0.6029411764705882,0
47,106,0.443,10,35,0.286,25,28,0.893,18,29,47,29,9,4,15,12,37,71,0.5211267605633803,1
39,97,0.402,15,45,0.333,21,26,0.808,17,33,50,29,12,2,13,17,24,52,0.46153846153846156,1
41,83,0.494,5,31,0.161,11,16,0.688,7,38,45,24,5,2,19,23,36,52,0.6923076923076923,0
51,102,0.5,11,22,0.5,23,29,0.793,13,39,52,33,10,2,20,22,40,80,0.5,1
51,92,0.554,10,33,0.303,19,28,0.679,4,34,38,32,11,7,21,19,41,59,0.6949152542372882,0
40,93,0.43,9,31,0.29,13,17,0.765,12,23,35,21,12,2,8,17,31,62,0.5,0
45,81,0.556,15,44,0.341,16,21,0.762,13,40,53,37,4,7,21,14,30,37,0.8108108108108109,1
31,87,0.356,7,38,0.184,15,17,0.882,15,42,57,17,6,6,21,19,24,49,0.4897959183673469,0
35,89,0.393,9,42,0.214,22,25,0.88,10,35,45,27,14,3,10,12,26,47,0.5531914893617021,1
42,89,0.472,7,21,0.333,21,28,0.75,14,34,48,21,11,9,19,23,35,68,0.5147058823529411,1
38,88,0.432,13,41,0.317,20,27,0.741,7,34,41,22,10,9,17,21,25,47,0.5319148936170213,0
46,88,0.523,11,31,0.355,12,18,0.667,8,42,50,24,6,4,12,15,35,57,0.6140350877192983,1
42,93,0.452,18,55,0.327,10,13,0.769,7,36,43,23,7,3,10,15,24,38,0.631578947368421,0
44,90,0.489,13,31,0.419,21,26,0.808,10,32,42,24,12,6,13,24,31,59,0.5254237288135594,1
41,83,0.494,11,31,0.355,22,28,0.786,9,33,42,29,7,3,19,22,30,52,0.5769230769230769,0
43,104,0.413,9,36,0.25,12,14,0.857,13,34,47,23,7,10,9,12,34,68,0.5,0
45,92,0.489,18,36,0.5,13,17,0.765,10,44,54,25,6,6,16,12,27,56,0.48214285714285715,1
53,93,0.57,20,42,0.476,11,15,0.733,11,33,44,39,9,6,12,20,33,51,0.6470588235294118,1
42,92,0.457,21,49,0.429,9,11,0.818,11,27,38,30,5,3,19,15,21,43,0.4883720930232558,0
38,88,0.432,14,43,0.326,15,20,0.75,7,30,37,19,5,2,10,17,24,45,0.5333333333333333,0
42,79,0.532,10,28,0.357,19,20,0.95,4,39,43,27,4,7,12,17,32,51,0.6274509803921569,1
41,78,0.526,16,36,0.444,21,24,0.875,10,37,47,36,6,7,24,22,25,42,0.5952380952380952,1
38,98,0.388,11,39,0.282,10,18,0.556,18,22,40,24,10,3,12,16,27,59,0.4576271186440678,0
43,98,0.439,15,47,0.319,7,12,0.583,14,33,47,26,7,4,16,29,28,51,0.5490196078431373,0
39,84,0.464,7,33,0.212,29,37,0.784,12,38,50,23,4,3,17,18,32,51,0.6274509803921569,1
47,89,0.528,14,32,0.438,17,23,0.739,7,27,34,32,8,4,10,20,33,57,0.5789473684210527,0
49,93,0.527,12,35,0.343,26,30,0.867,13,38,51,30,7,5,12,17,37,58,0.6379310344827587,1
56,101,0.554,24,43,0.558,15,21,0.714,11,34,45,42,8,8,7,18,32,58,0.5517241379310345,1
50,95,0.526,13,29,0.448,18,24,0.75,10,35,45,34,5,4,13,16,37,66,0.5606060606060606,0
41,90,0.456,15,46,0.326,17,24,0.708,5,36,41,32,7,9,14,20,26,44,0.5909090909090909,0
44,100,0.44,11,35,0.314,19,23,0.826,17,42,59,30,9,2,16,18,33,65,0.5076923076923077,1
44,97,0.454,11,39,0.282,15,19,0.789,16,34,50,27,11,5,9,12,33,58,0.5689655172413793,0
42,89,0.472,25,54,0.463,11,14,0.786,12,35,47,33,5,3,15,13,17,35,0.4857142857142857,1
53,101,0.525,14,32,0.438,14,19,0.737,13,37,50,31,10,5,13,23,39,69,0.5652173913043478,1
35,83,0.422,12,32,0.375,23,28,0.821,10,32,42,22,6,6,19,22,23,51,0.45098039215686275,0
31,85,0.365,9,33,0.273,10,13,0.769,15,44,59,20,1,3,25,16,22,52,0.4230769230769231,0
40,95,0.421,6,30,0.2,17,22,0.773,11,37,48,21,15,7,4,16,34,65,0.5230769230769231,1
37,81,0.457,6,32,0.188,26,30,0.867,10,39,49,23,8,5,19,14,31,49,0.6326530612244898,1
35,89,0.393,10,37,0.27,15,16,0.938,11,33,44,27,9,5,16,24,25,52,0.4807692307692308,0
51,104,0.49,15,38,0.395,21,30,0.7,13,56,69,31,2,3,12,13,36,66,0.5454545454545454,1
46,108,0.426,17,53,0.321,8,16,0.5,8,38,46,28,4,3,4,21,29,55,0.5272727272727272,0
37,85,0.435,11,43,0.256,10,15,0.667,10,24,34,24,7,6,15,18,26,42,0.6190476190476191,0
42,84,0.5,7,28,0.25,18,25,0.72,15,36,51,25,11,2,20,15,35,56,0.625,1
51,101,0.505,10,35,0.286,5,6,0.833,7,38,45,31,4,4,11,16,41,66,0.6212121212121212,0
47,97,0.485,18,45,0.4,16,21,0.762,10,39,49,28,4,7,11,9,29,52,0.5576923076923077,1
38,90,0.422,17,47,0.362,17,24,0.708,13,30,43,29,13,1,14,17,21,43,0.4883720930232558,0
45,83,0.542,18,44,0.409,15,20,0.75,7,37,44,30,10,3,18,20,27,39,0.6923076923076923,1
40,90,0.444,3,21,0.143,25,29,0.862,11,38,49,18,13,3,15,24,37,69,0.5362318840579711,0
39,82,0.476,13,36,0.361,22,31,0.71,8,34,42,25,7,8,17,22,26,46,0.5652173913043478,1
46,89,0.517,19,34,0.559,30,38,0.789,8,36,44,33,8,9,15,24,27,55,0.4909090909090909,1
52,108,0.481,15,40,0.375,17,22,0.773,19,34,53,29,8,8,15,24,37,68,0.5441176470588235,0
40,92,0.435,7,37,0.189,13,18,0.722,11,32,43,25,8,4,12,16,33,55,0.6,0
45,90,0.5,12,36,0.333,13,16,0.813,8,41,49,30,5,2,16,17,33,54,0.6111111111111112,1
49,100,0.49,5,23,0.217,16,24,0.667,14,39,53,22,3,5,10,18,44,77,0.5714285714285714,1
42,99,0.424,14,37,0.378,16,22,0.727,12,35,47,29,4,3,7,21,28,62,0.45161290322580644,0
58,96,0.604,27,49,0.551,14,16,0.875,9,49,58,47,13,6,16,18,31,47,0.6595744680851063,1
38,95,0.4,9,35,0.257,16,24,0.667,6,24,30,25,5,3,14,9,29,60,0.48333333333333334,0
38,82,0.463,12,34,0.353,17,21,0.81,7,31,38,28,5,2,14,13,26,48,0.5416666666666666,0
48,95,0.505,11,33,0.333,14,16,0.875,7,38,45,29,8,2,9,19,37,62,0.5967741935483871,1
44,90,0.489,6,21,0.286,20,28,0.714,13,38,51,24,8,6,15,15,38,69,0.5507246376811594,1
41,97,0.423,14,45,0.311,13,21,0.619,14,37,51,28,11,5,13,21,27,52,0.5192307692307693,0
36,83,0.434,16,41,0.39,14,15,0.933,4,33,37,30,13,11,20,26,20,42,0.47619047619047616,0
38,92,0.413,10,31,0.323,22,24,0.917,12,36,48,27,8,7,20,15,28,61,0.45901639344262296,1
45,96,0.469,10,41,0.244,16,27,0.593,22,41,63,26,5,8,12,21,35,55,0.6363636363636364,1
39,91,0.429,11,34,0.324,16,20,0.8,6,33,39,24,7,4,8,19,28,57,0.49122807017543857,0
42,92,0.457,11,37,0.297,28,32,0.875,13,25,38,25,7,5,7,19,31,55,0.5636363636363636,1
42,87,0.483,9,28,0.321,25,30,0.833,14,34,48,27,5,4,11,23,33,59,0.559322033898305,0
42,86,0.488,7,26,0.269,18,22,0.818,8,28,36,20,9,10,10,22,35,60,0.5833333333333334,1
38,87,0.437,11,31,0.355,18,36,0.5,16,34,50,23,5,5,14,18,27,56,0.48214285714285715,0
36,82,0.439,8,28,0.286,11,15,0.733,5,32,37,24,5,3,11,25,28,54,0.5185185185185185,0
32,78,0.41,10,30,0.333,28,32,0.875,10,41,51,19,7,2,13,20,22,48,0.4583333333333333,1
32,89,0.36,13,40,0.325,18,20,0.9,12,30,42,19,9,6,17,20,19,49,0.3877551020408163,0
43,83,0.518,13,32,0.406,21,26,0.808,9,38,47,29,11,8,16,15,30,51,0.5882352941176471,1
38,98,0.388,5,29,0.172,18,22,0.818,14,31,45,23,13,4,11,17,33,69,0.4782608695652174,0
42,88,0.477,13,33,0.394,15,18,0.833,12,46,58,25,6,7,17,15,29,55,0.5272727272727272,1
37,88,0.42,8,29,0.276,19,22,0.864,17,34,51,18,11,1,16,20,29,59,0.4915254237288136,1
36,83,0.434,10,31,0.323,15,21,0.714,11,27,38,20,9,2,14,17,26,52,0.5,0
39,70,0.557,13,29,0.448,10,15,0.667,5,30,35,23,3,5,20,15,26,41,0.6341463414634146,0
42,89,0.472,21,43,0.488,16,16,1.0,14,24,38,32,14,3,9,17,21,46,0.45652173913043476,1
43,90,0.478,16,50,0.32,21,27,0.778,9,32,41,31,7,7,15,25,27,40,0.675,0
44,98,0.449,12,32,0.375,26,32,0.813,17,33,50,18,10,3,13,23,32,66,0.48484848484848486,1
30,81,0.37,11,36,0.306,9,16,0.563,5,33,38,18,6,6,12,16,19,45,0.4222222222222222,0
41,90,0.456,16,39,0.41,11,17,0.647,11,43,54,24,6,4,11,20,25,51,0.49019607843137253,1
49,92,0.533,16,37,0.432,14,16,0.875,10,35,45,25,7,11,16,18,33,55,0.6,1
42,89,0.472,13,36,0.361,15,16,0.938,6,28,34,24,6,2,12,19,29,53,0.5471698113207547,0
50,84,0.595,15,25,0.6,15,21,0.714,4,32,36,32,6,1,16,24,35,59,0.5932203389830508,1
45,91,0.495,11,45,0.244,16,22,0.727,8,30,38,29,3,4,13,22,34,46,0.7391304347826086,0
41,93,0.441,10,31,0.323,23,29,0.793,15,34,49,23,6,4,14,21,31,62,0.5,1
39,82,0.476,6,19,0.316,26,33,0.788,6,36,42,27,8,9,10,25,33,63,0.5238095238095238,0
30,80,0.375,13,42,0.31,11,17,0.647,5,28,33,24,10,1,9,20,17,38,0.4473684210526316,0
36,80,0.45,11,35,0.314,13,16,0.813,13,43,56,21,8,7,19,22,25,45,0.5555555555555556,1
39,82,0.476,13,40,0.325,15,18,0.833,9,32,41,18,6,2,22,26,26,42,0.6190476190476191,0
42,92,0.457,9,38,0.237,21,29,0.724,12,29,41,22,11,5,14,25,33,54,0.6111111111111112,1
43,101,0.426,16,48,0.333,4,8,0.5,19,30,49,21,10,4,16,11,27,53,0.5094339622641509,0
48,86,0.558,15,33,0.455,8,10,0.8,5,39,44,28,10,12,16,8,33,53,0.6226415094339622,1
29,79,0.367,7,29,0.241,25,30,0.833,13,23,36,16,14,5,18,18,22,50,0.44,0
38,77,0.494,14,33,0.424,17,21,0.81,11,32,43,26,10,7,18,22,24,44,0.5454545454545454,1
35,80,0.438,11,30,0.367,28,31,0.903,12,20,32,17,7,4,15,20,24,50,0.48,0
50,85,0.588,10,24,0.417,13,14,0.929,7,28,35,30,6,6,11,22,40,61,0.6557377049180327,1
40,79,0.506,14,31,0.452,19,23,0.826,9,26,35,24,4,5,13,25,26,48,0.5416666666666666,0
46,85,0.541,10,22,0.455,20,25,0.8,9,27,36,26,6,1,10,25,36,63,0.5714285714285714,1
35,85,0.412,7,26,0.269,16,21,0.762,11,36,47,21,5,7,13,19,28,59,0.4745762711864407,0
38,89,0.427,11,36,0.306,16,21,0.762,11,38,49,24,4,6,10,20,27,53,0.5094339622641509,1
45,84,0.536,16,36,0.444,16,23,0.696,7,34,41,26,10,2,17,9,29,48,0.6041666666666666,0
53,99,0.535,25,49,0.51,7,8,0.875,9,36,45,35,9,4,11,16,28,50,0.56,1
40,82,0.488,13,31,0.419,9,13,0.692,11,35,46,15,5,3,15,17,27,51,0.5294117647058824,1
34,79,0.43,10,30,0.333,19,22,0.864,8,26,34,22,5,3,10,13,24,49,0.4897959183673469,0
35,92,0.38,11,47,0.234,16,23,0.696,13,40,53,21,6,3,15,22,24,45,0.5333333333333333,0
40,100,0.4,16,50,0.32,18,23,0.783,18,41,59,31,12,5,12,19,24,50,0.48,1
42,88,0.477,10,27,0.37,35,46,0.761,15,30,45,20,12,4,13,18,32,61,0.5245901639344263,1
45,83,0.542,15,35,0.429,19,25,0.76,6,34,40,26,9,7,18,31,30,48,0.625,0
45,92,0.489,21,48,0.438,11,16,0.688,6,23,29,31,11,0,12,17,24,44,0.5454545454545454,0
51,91,0.56,15,34,0.441,13,16,0.813,11,37,48,24,5,6,19,15,36,57,0.631578947368421,1
48,84,0.571,13,32,0.406,11,13,0.846,5,35,40,32,8,4,15,26,35,52,0.6730769230769231,1
36,79,0.456,10,27,0.37,29,35,0.829,6,26,32,24,8,2,13,21,26,52,0.5,0
31,80,0.388,7,33,0.212,10,17,0.588,13,29,42,16,7,4,21,18,24,47,0.5106382978723404,0
39,83,0.47,10,33,0.303,11,18,0.611,11,34,45,21,14,5,14,17,29,50,0.58,1
36,91,0.396,9,24,0.375,15,16,0.938,15,39,54,19,7,3,10,19,27,67,0.40298507462686567,1
33,80,0.413,9,37,0.243,13,19,0.684,5,33,38,20,3,6,10,14,24,43,0.5581395348837209,0
41,84,0.488,9,22,0.409,21,27,0.778,14,35,49,25,10,8,18,14,32,62,0.5161290322580645,1
40,92,0.435,12,37,0.324,8,10,0.8,9,24,33,19,7,5,13,22,28,55,0.509090909090909,0
35,93,0.376,13,39,0.333,18,20,0.9,18,32,50,23,7,2,18,22,22,54,0.4074074074074074,0
41,90,0.456,7,28,0.25,22,27,0.815,11,37,48,19,11,8,16,18,34,62,0.5483870967741935,1
38,85,0.447,15,39,0.385,8,12,0.667,8,29,37,22,7,3,18,15,23,46,0.5,0
45,84,0.536,16,33,0.485,15,17,0.882,8,36,44,22,13,4,14,18,29,51,0.5686274509803921,1
46,89,0.517,16,40,0.4,21,25,0.84,9,40,49,25,4,5,16,23,30,49,0.6122448979591837,1
43,98,0.439,14,37,0.378,21,24,0.875,11,31,42,25,8,4,12,24,29,61,0.47540983606557374,0
48,102,0.471,14,35,0.4,15,18,0.833,12,32,44,25,5,3,10,21,34,67,0.5074626865671642,0
45,90,0.5,14,34,0.412,22,24,0.917,8,36,44,31,8,6,12,19,31,56,0.5535714285714286,1
42,95,0.442,12,35,0.343,12,18,0.667,10,37,47,21,6,5,12,23,30,60,0.5,0
42,93,0.452,13,34,0.382,17,22,0.773,14,37,51,23,6,7,12,19,29,59,0.4915254237288136,1
36,77,0.468,6,23,0.261,15,19,0.789,7,26,33,24,3,5,13,23,30,54,0.5555555555555556,0
38,84,0.452,8,29,0.276,18,28,0.643,17,30,47,15,5,7,14,15,30,55,0.5454545454545454,1
42,106,0.396,9,42,0.214,18,21,0.857,16,33,49,26,7,7,13,26,33,64,0.515625,0
41,94,0.436,10,36,0.278,25,31,0.806,13,39,52,22,5,11,15,17,31,58,0.5344827586206896,1
42,97,0.433,13,40,0.325,17,20,0.85,16,30,46,28,10,6,14,20,29,57,0.5087719298245614,0
43,87,0.494,13,32,0.406,20,25,0.8,9,38,47,21,9,5,16,20,30,55,0.5454545454545454,1
45,96,0.469,19,41,0.463,10,10,1.0,6,28,34,26,5,4,9,16,26,55,0.4727272727272727,1
49,92,0.533,12,38,0.316,7,13,0.538,9,34,43,31,1,9,9,20,37,54,0.6851851851851852,0
41,81,0.506,8,33,0.242,19,25,0.76,8,32,40,24,9,4,14,27,33,48,0.6875,0
34,85,0.4,12,34,0.353,32,36,0.889,16,31,47,22,10,3,12,21,22,51,0.43137254901960786,1
43,95,0.453,13,36,0.361,31,37,0.838,17,29,46,23,4,1,10,21,30,59,0.5084745762711864,0
51,94,0.543,13,26,0.5,21,24,0.875,11,32,43,31,7,4,9,27,38,68,0.5588235294117647,1
37,85,0.435,9,29,0.31,23,29,0.793,17,31,48,21,6,5,14,17,28,56,0.5,1
35,75,0.467,13,33,0.394,12,15,0.8,4,26,30,24,5,2,13,22,22,42,0.5238095238095238,0
37,92,0.402,10,39,0.256,15,20,0.75,14,40,54,28,8,3,13,17,27,53,0.5094339622641509,0
44,99,0.444,14,40,0.35,14,17,0.824,14,38,52,24,6,2,11,19,30,59,0.5084745762711864,1
50,110,0.455,17,45,0.378,11,17,0.647,9,36,45,25,6,5,11,31,33,65,0.5076923076923077,1
42,91,0.462,14,33,0.424,28,45,0.622,10,46,56,20,4,1,16,21,28,58,0.4827586206896552,0
50,96,0.521,11,38,0.289,12,19,0.632,11,32,43,33,11,7,15,24,39,58,0.6724137931034483,1
42,90,0.467,10,34,0.294,22,26,0.846,12,32,44,22,9,3,19,18,32,56,0.5714285714285714,0
47,94,0.5,18,42,0.429,16,17,0.941,11,36,47,24,7,10,7,16,29,52,0.5576923076923077,1
44,94,0.468,15,35,0.429,17,22,0.773,12,33,45,28,5,7,10,15,29,59,0.4915254237288136,0
40,99,0.404,17,45,0.378,21,25,0.84,18,35,53,25,10,8,20,26,23,54,0.42592592592592593,1
32,86,0.372,10,32,0.313,25,35,0.714,11,31,42,20,14,6,18,23,22,54,0.4074074074074074,0
29,96,0.302,12,38,0.316,15,20,0.75,14,31,45,19,10,2,14,17,17,58,0.29310344827586204,0
49,91,0.538,15,44,0.341,12,15,0.8,9,43,52,33,6,15,16,16,34,47,0.723404255319149,1
43,84,0.512,7,23,0.304,14,17,0.824,8,30,38,20,4,5,16,19,36,61,0.5901639344262295,0
48,101,0.475,16,37,0.432,13,15,0.867,16,33,49,22,14,1,10,19,32,64,0.5,1
36,85,0.424,13,39,0.333,23,29,0.793,10,29,39,26,8,5,9,14,23,46,0.5,1
41,86,0.477,7,34,0.206,12,20,0.6,12,36,48,20,6,4,13,21,34,52,0.6538461538461539,0
43,100,0.43,15,46,0.326,19,30,0.633,18,37,55,25,4,6,7,23,28,54,0.5185185185185185,1
36,96,0.375,12,47,0.255,16,27,0.593,14,35,49,21,3,5,8,23,24,49,0.4897959183673469,0
45,89,0.506,17,38,0.447,12,12,1.0,8,20,28,17,10,4,8,20,28,51,0.5490196078431373,1
44,75,0.587,10,26,0.385,17,18,0.944,8,30,38,26,3,4,16,10,34,49,0.6938775510204082,0
38,95,0.4,6,31,0.194,5,5,1.0,11,28,39,23,2,4,10,25,32,64,0.5,0
36,76,0.474,7,27,0.259,18,21,0.857,5,36,41,19,5,6,13,16,29,49,0.5918367346938775,1
43,92,0.467,6,25,0.24,25,29,0.862,13,40,53,24,4,10,8,12,37,67,0.5522388059701493,1
43,106,0.406,21,53,0.396,5,6,0.833,14,35,49,30,5,3,8,24,22,53,0.41509433962264153,0
38,85,0.447,17,49,0.347,12,17,0.706,8,26,34,24,1,2,7,24,21,36,0.5833333333333334,0
37,82,0.451,16,40,0.4,21,30,0.7,11,39,50,23,4,2,11,20,21,42,0.5,1
31,79,0.392,6,30,0.2,19,23,0.826,6,35,41,13,2,8,13,17,25,49,0.5102040816326531,0
43,92,0.467,20,51,0.392,15,16,0.938,8,38,46,26,6,8,7,17,23,41,0.5609756097560976,1
40,94,0.426,10,34,0.294,10,17,0.588,9,31,40,27,9,3,9,15,30,60,0.5,0
48,95,0.505,21,42,0.5,10,16,0.625,13,42,55,38,2,3,16,23,27,53,0.5094339622641509,1
38,86,0.442,16,45,0.356,22,23,0.957,9,36,45,25,9,7,12,23,22,41,0.5365853658536586,1
31,78,0.397,16,37,0.432,24,27,0.889,9,33,42,21,7,8,14,20,15,41,0.36585365853658536,0
43,97,0.443,10,30,0.333,18,21,0.857,16,35,51,27,6,5,13,21,33,67,0.4925373134328358,0
48,95,0.505,9,28,0.321,16,18,0.889,7,34,41,24,5,6,9,24,39,67,0.582089552238806,1
36,91,0.396,13,44,0.295,12,17,0.706,14,28,42,26,5,6,19,22,23,47,0.48936170212765956,0
42,80,0.525,15,31,0.484,28,37,0.757,6,38,44,27,10,6,13,21,27,49,0.5510204081632653,1
31,91,0.341,8,40,0.2,16,22,0.727,14,34,48,15,4,3,13,22,23,51,0.45098039215686275,0
35,90,0.389,7,32,0.219,28,31,0.903,13,37,50,17,3,5,14,25,28,58,0.4827586206896552,1
41,87,0.471,17,44,0.386,16,22,0.727,13,31,44,25,3,12,10,21,24,43,0.5581395348837209,0
42,91,0.462,13,34,0.382,19,22,0.864,12,32,44,19,9,3,9,23,29,57,0.5087719298245614,1
50,89,0.562,7,22,0.318,17,23,0.739,10,22,32,28,6,2,9,19,43,67,0.6417910447761194,0
46,81,0.568,13,29,0.448,24,29,0.828,12,25,37,28,6,4,13,24,33,52,0.6346153846153846,1
40,86,0.465,12,41,0.293,9,12,0.75,9,31,40,29,9,2,16,22,28,45,0.6222222222222222,0
39,86,0.453,6,25,0.24,20,20,1.0,8,34,42,21,8,1,14,15,33,61,0.5409836065573771,1
37,76,0.487,9,28,0.321,18,24,0.75,8,27,35,21,5,4,17,23,28,48,0.5833333333333334,0
40,85,0.471,13,39,0.333,16,22,0.727,13,31,44,28,7,4,13,21,27,46,0.5869565217391305,1
40,79,0.506,12,30,0.4,23,27,0.852,9,40,49,20,4,5,13,24,28,49,0.5714285714285714,1
33,83,0.398,12,38,0.316,25,34,0.735,9,27,36,21,4,1,8,16,21,45,0.4666666666666667,0
38,88,0.432,9,27,0.333,17,24,0.708,8,34,42,22,6,7,10,22,29,61,0.47540983606557374,0
42,85,0.494,13,27,0.481,21,28,0.75,10,40,50,32,6,6,10,17,29,58,0.5,1
42,87,0.483,10,27,0.37,12,15,0.8,7,31,38,24,6,4,14,17,32,60,0.5333333333333333,0
47,92,0.511,13,35,0.371,14,15,0.933,9,39,48,29,8,5,16,18,34,57,0.5964912280701754,1
37,88,0.42,13,43,0.302,16,19,0.842,11,23,34,27,11,4,12,30,24,45,0.5333333333333333,0
35,71,0.493,13,34,0.382,29,40,0.725,14,36,50,23,6,4,19,19,22,37,0.5945945945945946,1
33,78,0.423,15,35,0.429,14,16,0.875,6,44,50,22,7,6,18,14,18,43,0.4186046511627907,1
30,83,0.361,8,34,0.235,18,19,0.947,6,32,38,18,14,7,12,13,22,49,0.4489795918367347,0
44,82,0.537,8,22,0.364,29,31,0.935,7,34,41,24,10,3,11,22,36,60,0.6,1
38,79,0.481,11,28,0.393,13,20,0.65,2,27,29,20,3,5,14,22,27,51,0.5294117647058824,0
39,103,0.379,13,48,0.271,10,14,0.714,20,33,53,25,3,2,11,30,26,55,0.4727272727272727,0
39,75,0.52,13,26,0.5,31,42,0.738,6,40,46,25,6,6,7,17,26,49,0.5306122448979592,1
27,71,0.38,10,35,0.286,28,32,0.875,8,33,41,13,2,9,12,22,17,36,0.4722222222222222,0
33,82,0.402,7,27,0.259,23,25,0.92,7,33,40,25,8,2,7,22,26,55,0.4727272727272727,1
31,83,0.373,8,37,0.216,18,19,0.947,7,30,37,15,4,7,14,14,23,46,0.5,0
41,87,0.471,15,33,0.455,15,18,0.833,7,36,43,18,7,7,8,13,26,54,0.48148148148148145,1
46,84,0.548,11,24,0.458,23,26,0.885,5,25,30,30,6,4,7,21,35,60,0.5833333333333334,0
50,91,0.549,15,32,0.469,17,22,0.773,15,32,47,29,5,7,11,21,35,59,0.5932203389830508,1
46,85,0.541,16,31,0.516,15,19,0.789,7,28,35,20,12,3,15,22,30,54,0.5555555555555556,1
42,81,0.519,10,29,0.345,22,29,0.759,9,25,34,22,6,3,15,18,32,52,0.6153846153846154,0
36,82,0.439,8,30,0.267,23,26,0.885,4,36,40,26,10,7,12,19,28,52,0.5384615384615384,0
39,89,0.438,14,38,0.368,16,18,0.889,11,38,49,27,8,2,17,18,25,51,0.49019607843137253,1
42,92,0.457,9,26,0.346,18,19,0.947,11,34,45,23,9,5,11,17,33,66,0.5,1
37,79,0.468,10,35,0.286,21,24,0.875,6,29,35,22,2,9,15,20,27,44,0.6136363636363636,0
44,88,0.5,17,41,0.415,14,19,0.737,5,34,39,30,7,1,6,19,27,47,0.574468085106383,1
38,84,0.452,10,32,0.313,22,29,0.759,11,34,45,27,3,2,12,18,28,52,0.5384615384615384,0
39,98,0.398,11,42,0.262,13,17,0.765,21,36,57,25,3,3,15,24,28,56,0.5,0
46,81,0.568,19,35,0.543,17,21,0.81,1,34,35,25,7,4,10,16,27,46,0.5869565217391305,1
41,85,0.482,12,33,0.364,19,22,0.864,11,29,40,25,3,9,11,20,29,52,0.5576923076923077,1
40,86,0.465,8,20,0.4,23,26,0.885,8,30,38,20,5,4,6,19,32,66,0.48484848484848486,0
43,84,0.512,18,45,0.4,12,18,0.667,7,32,39,28,8,8,10,24,25,39,0.6410256410256411,1
34,78,0.436,8,32,0.25,23,28,0.821,12,32,44,18,5,2,16,18,26,46,0.5652173913043478,0
40,78,0.513,9,23,0.391,8,10,0.8,10,26,36,20,6,2,16,13,31,55,0.5636363636363636,0
40,79,0.506,16,39,0.41,14,19,0.737,12,25,37,23,13,4,10,9,24,40,0.6,1
34,78,0.436,7,35,0.2,29,34,0.853,12,35,47,18,4,8,12,22,27,43,0.627906976744186,1
33,93,0.355,14,30,0.467,23,29,0.793,17,30,47,22,5,4,5,24,19,63,0.30158730158730157,0
42,86,0.488,14,28,0.5,5,6,0.833,7,35,42,26,7,2,14,15,28,58,0.4827586206896552,1
32,82,0.39,9,42,0.214,11,13,0.846,10,30,40,18,6,4,15,13,23,40,0.575,0
39,96,0.406,13,39,0.333,2,2,1.0,11,32,43,26,5,4,8,15,26,57,0.45614035087719296,0
40,79,0.506,8,27,0.296,16,20,0.8,6,39,45,29,4,4,10,8,32,52,0.6153846153846154,1
38,78,0.487,17,35,0.486,18,20,0.9,8,23,31,28,5,4,11,22,21,43,0.4883720930232558,1
39,75,0.52,11,28,0.393,19,22,0.864,9,29,38,23,7,2,14,21,28,47,0.5957446808510638,0
41,80,0.513,5,18,0.278,22,27,0.815,13,45,58,28,3,5,14,18,36,62,0.5806451612903226,1
34,92,0.37,11,35,0.314,15,19,0.789,10,23,33,20,7,3,4,22,23,57,0.40350877192982454,0
39,79,0.494,14,28,0.5,16,21,0.762,5,29,34,26,11,7,8,18,25,51,0.49019607843137253,1
35,78,0.449,8,25,0.32,17,20,0.85,8,29,37,23,2,3,15,19,27,53,0.5094339622641509,0
33,96,0.344,9,35,0.257,14,16,0.875,11,33,44,18,9,7,8,21,24,61,0.39344262295081966,0
38,84,0.452,5,28,0.179,13,23,0.565,11,46,57,21,6,7,15,13,33,56,0.5892857142857143,1
41,90,0.456,10,29,0.345,15,20,0.75,13,31,44,23,5,4,12,18,31,61,0.5081967213114754,0
48,91,0.527,14,34,0.412,9,12,0.75,9,33,42,29,9,6,12,15,34,57,0.5964912280701754,1
42,95,0.442,11,33,0.333,13,17,0.765,17,43,60,23,5,7,19,22,31,62,0.5,1
36,101,0.356,10,43,0.233,22,28,0.786,18,31,49,19,11,6,11,23,26,58,0.4482758620689655,0
44,94,0.468,17,43,0.395,9,10,0.9,9,29,38,25,10,6,10,23,27,51,0.5294117647058824,1
42,84,0.5,9,27,0.333,20,26,0.769,13,37,50,30,6,6,18,16,33,57,0.5789473684210527,0
45,82,0.549,19,39,0.487,15,18,0.833,5,38,43,30,6,4,16,19,26,43,0.6046511627906976,1
39,94,0.415,12,42,0.286,14,18,0.778,13,29,42,26,10,3,13,16,27,52,0.5192307692307693,0
39,93,0.419,5,29,0.172,27,33,0.818,12,30,42,24,12,1,12,19,34,64,0.53125,0
43,86,0.5,11,37,0.297,19,26,0.731,12,39,51,34,5,3,19,21,32,49,0.6530612244897959,1
44,96,0.458,9,24,0.375,23,29,0.793,11,34,45,28,6,9,14,11,35,72,0.4861111111111111,0
56,107,0.523,20,43,0.465,11,12,0.917,10,41,51,38,10,8,12,23,36,64,0.5625,1
44,93,0.473,10,32,0.313,13,17,0.765,15,25,40,20,10,4,18,20,34,61,0.5573770491803278,0
47,90,0.522,16,34,0.471,13,16,0.813,14,31,45,36,11,7,18,20,31,56,0.5535714285714286,1
40,85,0.471,14,32,0.438,17,22,0.773,11,41,52,22,8,5,21,21,26,53,0.49056603773584906,1
38,91,0.418,12,43,0.279,16,20,0.8,8,29,37,23,8,7,13,19,26,48,0.5416666666666666,0
41,92,0.446,11,32,0.344,9,15,0.6,17,39,56,28,3,13,17,23,30,60,0.5,0
37,92,0.402,8,22,0.364,21,26,0.808,16,32,48,22,11,3,7,18,29,70,0.4142857142857143,1
37,77,0.481,12,39,0.308,22,26,0.846,7,39,46,18,6,11,13,22,25,38,0.6578947368421053,1
36,97,0.371,18,41,0.439,14,26,0.538,17,30,47,24,9,0,11,22,18,56,0.32142857142857145,0
32,79,0.405,12,34,0.353,10,16,0.625,7,24,31,19,6,3,19,24,20,45,0.4444444444444444,0
42,87,0.483,9,34,0.265,23,26,0.885,17,40,57,19,8,6,16,20,33,53,0.6226415094339622,1
47,99,0.475,15,47,0.319,17,23,0.739,13,35,48,24,6,3,12,20,32,52,0.6153846153846154,1
46,89,0.517,11,35,0.314,16,22,0.727,9,36,45,33,8,5,19,23,35,54,0.6481481481481481,0
34,100,0.34,8,31,0.258,18,22,0.818,16,46,62,20,8,9,14,14,26,69,0.37681159420289856,0
36,90,0.4,14,35,0.4,11,16,0.688,8,39,47,27,9,11,14,18,22,55,0.4,1
47,102,0.461,19,51,0.373,17,20,0.85,15,30,45,29,6,8,12,25,28,51,0.5490196078431373,1
41,91,0.451,9,28,0.321,23,31,0.742,16,38,54,22,6,2,14,20,32,63,0.5079365079365079,0
34,81,0.42,9,31,0.29,18,23,0.783,10,39,49,16,7,3,24,21,25,50,0.5,0
36,84,0.429,5,29,0.172,23,29,0.793,8,34,42,24,14,7,16,23,31,55,0.5636363636363636,1
41,80,0.513,16,35,0.457,19,28,0.679,4,35,39,25,8,4,15,28,25,45,0.5555555555555556,0
41,81,0.506,11,30,0.367,25,36,0.694,8,35,43,20,9,4,14,23,30,51,0.5882352941176471,1
43,90,0.478,20,44,0.455,20,28,0.714,12,33,45,30,9,6,16,21,23,46,0.5,1
42,87,0.483,12,32,0.375,24,30,0.8,9,35,44,28,7,6,14,20,30,55,0.5454545454545454,0
38,89,0.427,16,33,0.485,19,23,0.826,11,34,45,24,8,6,12,16,22,56,0.39285714285714285,0
45,95,0.474,16,39,0.41,13,19,0.684,16,39,55,20,7,6,15,19,29,56,0.5178571428571429,1
39,84,0.464,9,36,0.25,16,25,0.64,8,45,53,25,5,2,23,29,30,48,0.625,0
37,99,0.374,8,39,0.205,22,28,0.786,15,37,52,18,10,5,17,22,29,60,0.48333333333333334,1
40,88,0.455,10,30,0.333,21,25,0.84,12,41,53,28,7,6,24,29,30,58,0.5172413793103449,1
33,88,0.375,7,28,0.25,26,34,0.765,11,30,41,20,13,7,18,23,26,60,0.43333333333333335,0
40,87,0.46,13,26,0.5,15,19,0.789,6,41,47,22,8,10,18,17,27,61,0.4426229508196721,1
38,92,0.413,12,45,0.267,17,23,0.739,8,40,48,20,10,8,14,16,26,47,0.5531914893617021,0
45,92,0.489,21,43,0.488,9,10,0.9,10,37,47,30,5,4,16,28,24,49,0.4897959183673469,0
44,91,0.484,15,36,0.417,22,28,0.786,8,32,40,20,5,2,9,15,29,55,0.5272727272727272,1
41,88,0.466,14,37,0.378,12,18,0.667,6,34,40,27,11,10,19,18,27,51,0.5294117647058824,1
37,85,0.435,10,33,0.303,20,24,0.833,13,35,48,22,13,7,21,23,27,52,0.5192307692307693,0
36,79,0.456,9,28,0.321,21,32,0.656,10,35,45,22,10,5,14,16,27,51,0.5294117647058824,1
35,88,0.398,9,32,0.281,18,21,0.857,15,32,47,15,6,1,16,24,26,56,0.4642857142857143,0
48,87,0.552,14,32,0.438,12,14,0.857,7,32,39,32,14,3,19,24,34,55,0.6181818181818182,1
41,94,0.436,12,40,0.3,20,29,0.69,10,31,41,24,10,3,14,16,29,54,0.5370370370370371,0
52,100,0.52,8,32,0.25,10,20,0.5,11,32,43,30,7,2,18,26,44,68,0.6470588235294118,0
46,94,0.489,13,42,0.31,21,28,0.75,12,31,43,32,11,4,18,17,33,52,0.6346153846153846,1
41,77,0.532,14,35,0.4,22,28,0.786,6,30,36,17,8,6,16,22,27,42,0.6428571428571429,0
42,96,0.438,16,41,0.39,20,22,0.909,17,28,45,27,7,4,14,24,26,55,0.4727272727272727,1
48,98,0.49,15,38,0.395,14,17,0.824,11,37,48,36,3,4,8,20,33,60,0.55,1
43,99,0.434,12,31,0.387,15,24,0.625,18,33,51,29,2,6,7,16,31,68,0.45588235294117646,0
39,93,0.419,11,28,0.393,13,16,0.813,13,20,33,16,10,5,8,20,28,65,0.4307692307692308,0
45,86,0.523,12,28,0.429,16,20,0.8,15,38,53,29,4,4,17,18,33,58,0.5689655172413793,1
35,87,0.402,12,38,0.316,8,14,0.571,9,33,42,24,6,1,15,12,23,49,0.46938775510204084,0
44,86,0.512,12,34,0.353,6,8,0.75,7,40,47,30,9,3,16,17,32,52,0.6153846153846154,1
33,90,0.367,7,37,0.189,14,18,0.778,16,43,59,19,7,3,19,17,26,53,0.49056603773584906,0
40,87,0.46,9,33,0.273,7,16,0.438,4,39,43,20,8,5,13,22,31,54,0.5740740740740741,1
40,91,0.44,12,37,0.324,12,14,0.857,15,30,45,26,6,5,19,20,28,54,0.5185185185185185,0
45,85,0.529,10,37,0.27,26,28,0.929,7,32,39,31,10,7,11,19,35,48,0.7291666666666666,1
43,86,0.5,10,28,0.357,18,21,0.857,9,33,42,25,8,7,11,18,33,58,0.5689655172413793,1
38,87,0.437,17,32,0.531,14,19,0.737,13,28,41,28,5,5,13,19,21,55,0.38181818181818183,0
39,91,0.429,19,47,0.404,9,9,1.0,6,39,45,27,7,8,18,21,20,44,0.45454545454545453,0
40,93,0.43,16,46,0.348,17,22,0.773,11,34,45,24,9,5,12,15,24,47,0.5106382978723404,1
35,81,0.432,18,45,0.4,18,23,0.783,8,41,49,27,6,6,14,18,17,36,0.4722222222222222,1
34,90,0.378,9,33,0.273,18,19,0.947,10,32,42,22,7,4,7,20,25,57,0.43859649122807015,0
30,80,0.375,11,33,0.333,12,16,0.75,6,31,37,21,9,6,25,23,19,47,0.40425531914893614,0
47,91,0.516,16,42,0.381,13,21,0.619,9,39,48,23,15,5,16,16,31,49,0.6326530612244898,1
47,93,0.505,15,37,0.405,18,22,0.818,13,33,46,32,15,2,17,17,32,56,0.5714285714285714,1
39,86,0.453,16,44,0.364,16,20,0.8,12,27,39,22,10,3,23,22,23,42,0.5476190476190477,0
53,88,0.602,11,27,0.407,11,13,0.846,10,38,48,34,8,5,13,21,42,61,0.6885245901639344,1
37,90,0.411,6,32,0.188,15,18,0.833,7,22,29,22,8,4,10,14,31,58,0.5344827586206896,0
36,94,0.383,7,31,0.226,19,22,0.864,14,28,42,19,10,9,16,26,29,63,0.4603174603174603,0
40,82,0.488,11,28,0.393,35,40,0.875,11,40,51,28,10,17,16,20,29,54,0.5370370370370371,1
43,98,0.439,15,45,0.333,26,34,0.765,8,45,53,27,4,4,12,22,28,53,0.5283018867924528,0
49,104,0.471,17,48,0.354,17,24,0.708,6,41,47,30,6,7,10,28,32,56,0.5714285714285714,1
44,90,0.489,16,33,0.485,9,15,0.6,10,28,38,24,5,5,14,17,28,57,0.49122807017543857,0
48,86,0.558,14,30,0.467,17,18,0.944,4,32,36,28,6,7,11,12,34,56,0.6071428571428571,1
49,87,0.563,12,33,0.364,23,32,0.719,10,36,46,25,4,8,14,19,37,54,0.6851851851851852,1
47,96,0.49,8,31,0.258,19,20,0.95,8,31,39,33,8,5,10,23,39,65,0.6,0
42,98,0.429,11,37,0.297,7,15,0.467,17,34,51,30,6,2,13,21,31,61,0.5081967213114754,0
47,84,0.56,9,28,0.321,7,17,0.412,7,36,43,32,4,8,13,14,38,56,0.6785714285714286,1
40,87,0.46,6,17,0.353,26,31,0.839,10,34,44,19,8,6,13,17,34,70,0.4857142857142857,1
36,88,0.409,12,46,0.261,21,25,0.84,11,36,47,26,7,5,17,24,24,42,0.5714285714285714,0
38,95,0.4,14,35,0.4,13,18,0.722,12,32,44,28,10,3,11,22,24,60,0.4,0
42,79,0.532,8,27,0.296,14,18,0.778,3,37,40,28,7,10,16,17,34,52,0.6538461538461539,1
42,84,0.5,23,47,0.489,18,24,0.75,6,42,48,24,4,7,15,17,19,37,0.5135135135135135,1
42,92,0.457,14,37,0.378,12,20,0.6,10,34,44,22,9,4,12,22,28,55,0.509090909090909,0
41,86,0.477,13,34,0.382,19,20,0.95,7,33,40,27,7,2,15,20,28,52,0.5384615384615384,0
44,87,0.506,12,37,0.324,22,30,0.733,9,34,43,24,8,5,15,23,32,50,0.64,1
51,98,0.52,15,41,0.366,13,20,0.65,21,43,64,28,6,7,15,21,36,57,0.631578947368421,1
38,93,0.409,10,39,0.256,16,26,0.615,14,25,39,23,8,3,11,18,28,54,0.5185185185185185,0
39,91,0.429,15,28,0.536,19,24,0.792,13,28,41,31,6,5,17,25,24,63,0.38095238095238093,0
44,83,0.53,13,29,0.448,23,28,0.821,6,38,44,21,9,10,15,19,31,54,0.5740740740740741,1
38,85,0.447,11,35,0.314,12,15,0.8,13,38,51,20,6,7,16,19,27,50,0.54,1
38,94,0.404,4,29,0.138,11,15,0.733,14,33,47,19,10,4,12,17,34,65,0.5230769230769231,0
51,102,0.5,19,53,0.358,5,7,0.714,15,36,51,31,11,6,18,21,32,49,0.6530612244897959,1
39,87,0.448,11,36,0.306,18,26,0.692,11,29,40,26,12,4,15,13,28,51,0.5490196078431373,0
38,86,0.442,13,34,0.382,20,25,0.8,12,36,48,18,9,1,14,17,25,52,0.4807692307692308,1
36,92,0.391,10,38,0.263,9,12,0.75,14,32,46,19,6,6,15,19,26,54,0.48148148148148145,0
38,81,0.469,7,30,0.233,19,33,0.576,7,33,40,23,9,3,16,24,31,51,0.6078431372549019,0
44,89,0.494,14,31,0.452,16,23,0.696,9,35,44,29,10,4,16,26,30,58,0.5172413793103449,1
43,92,0.467,14,37,0.378,15,20,0.75,8,29,37,25,10,9,12,17,29,55,0.5272727272727272,1
42,83,0.506,18,39,0.462,12,15,0.8,6,37,43,29,8,7,19,18,24,44,0.5454545454545454,0
51,101,0.505,10,40,0.25,9,14,0.643,6,29,35,32,14,3,11,25,41,61,0.6721311475409836,0
46,92,0.5,9,32,0.281,29,32,0.906,14,43,57,26,8,3,21,16,37,60,0.6166666666666667,1
46,101,0.455,5,37,0.135,7,12,0.583,8,23,31,26,6,6,9,20,41,64,0.640625,0
54,95,0.568,20,35,0.571,27,28,0.964,11,46,57,27,5,2,13,19,34,60,0.5666666666666667,1
42,89,0.472,11,33,0.333,10,11,0.909,12,31,43,19,10,3,13,23,31,56,0.5535714285714286,0
37,81,0.457,20,48,0.417,20,28,0.714,13,32,45,23,7,2,15,11,17,33,0.5151515151515151,1
38,81,0.469,7,20,0.35,27,33,0.818,7,37,44,23,10,7,17,15,31,61,0.5081967213114754,1
40,90,0.444,11,29,0.379,10,11,0.909,6,32,38,24,12,4,18,31,29,61,0.47540983606557374,0
36,88,0.409,11,35,0.314,18,23,0.783,14,34,48,24,8,4,15,17,25,53,0.4716981132075472,0
39,81,0.481,11,31,0.355,13,15,0.867,7,29,36,32,5,6,18,17,28,50,0.56,1
45,90,0.5,11,27,0.407,18,25,0.72,15,29,44,21,9,8,16,19,34,63,0.5396825396825397,0
44,84,0.524,21,37,0.568,19,23,0.826,7,31,38,35,10,2,17,22,23,47,0.48936170212765956,1
47,99,0.475,14,34,0.412,17,27,0.63,12,34,46,22,12,1,13,31,33,65,0.5076923076923077,0
46,90,0.511,11,32,0.344,27,36,0.75,9,42,51,28,10,9,14,24,35,58,0.603448275862069,1
37,82,0.451,16,36,0.444,19,26,0.731,7,40,47,27,11,4,18,18,21,46,0.45652173913043476,1
39,91,0.429,13,38,0.342,14,18,0.778,11,35,46,22,10,5,18,20,26,53,0.49056603773584906,0
38,96,0.396,6,33,0.182,7,10,0.7,12,31,43,23,6,10,16,22,32,63,0.5079365079365079,0
38,83,0.458,8,21,0.381,26,27,0.963,8,39,47,20,9,5,14,15,30,62,0.4838709677419355,1
32,74,0.432,12,32,0.375,19,20,0.95,6,40,46,22,7,5,18,27,20,42,0.47619047619047616,1
32,92,0.348,5,30,0.167,20,30,0.667,16,34,50,18,10,3,14,16,27,62,0.43548387096774194,0
40,102,0.392,13,42,0.31,17,29,0.586,22,36,58,23,8,5,11,20,27,60,0.45,1
38,88,0.432,7,34,0.206,23,25,0.92,6,43,49,23,6,5,15,24,31,54,0.5740740740740741,0
35,76,0.461,13,34,0.382,28,38,0.737,7,22,29,19,9,2,12,17,22,42,0.5238095238095238,0
51,91,0.56,15,38,0.395,13,14,0.929,15,35,50,35,7,6,18,25,36,53,0.6792452830188679,1
35,96,0.365,14,54,0.259,25,32,0.781,14,28,42,25,12,7,16,22,21,42,0.5,0
47,87,0.54,22,43,0.512,17,24,0.708,10,40,50,35,7,3,21,22,25,44,0.5681818181818182,1
41,94,0.436,13,38,0.342,21,26,0.808,19,29,48,30,4,5,16,31,28,56,0.5,0
39,80,0.488,14,32,0.438,33,35,0.943,7,29,36,27,5,7,12,18,25,48,0.5208333333333334,1
38,79,0.481,10,28,0.357,13,19,0.684,9,32,41,30,4,3,19,20,28,51,0.5490196078431373,0
42,92,0.457,9,25,0.36,21,25,0.84,15,31,46,21,12,3,14,19,33,67,0.4925373134328358,1
51,98,0.52,18,37,0.486,12,13,0.923,9,32,41,37,7,5,8,21,33,61,0.5409836065573771,1
43,80,0.538,16,32,0.5,19,26,0.731,5,29,34,26,5,4,14,15,27,48,0.5625,0
39,85,0.459,10,29,0.345,27,36,0.75,10,33,43,27,17,9,17,25,29,56,0.5178571428571429,1
41,89,0.461,12,33,0.364,19,26,0.731,13,35,48,27,9,7,20,27,29,56,0.5178571428571429,0
44,96,0.458,18,45,0.4,3,5,0.6,8,31,39,32,4,4,11,12,26,51,0.5098039215686274,1
43,89,0.483,11,28,0.393,10,14,0.714,9,33,42,21,4,4,10,13,32,61,0.5245901639344263,0
41,86,0.477,17,42,0.405,15,17,0.882,10,24,34,27,12,6,15,19,24,44,0.5454545454545454,0
49,93,0.527,13,30,0.433,14,19,0.737,19,32,51,33,11,6,20,17,36,63,0.5714285714285714,1
44,84,0.524,8,28,0.286,20,25,0.8,5,30,35,27,10,9,13,20,36,56,0.6428571428571429,0
45,86,0.523,15,31,0.484,16,24,0.667,7,33,40,28,7,5,19,18,30,55,0.5454545454545454,1
46,81,0.568,13,28,0.464,9,17,0.529,4,26,30,33,7,4,20,18,33,53,0.6226415094339622,0
48,80,0.6,13,27,0.481,12,14,0.857,7,30,37,35,9,1,21,18,35,53,0.660377358490566,1
38,96,0.396,10,39,0.256,19,25,0.76,16,40,56,18,6,1,11,22,28,57,0.49122807017543857,0
35,82,0.427,20,39,0.513,20,28,0.714,7,34,41,24,6,11,14,16,15,43,0.3488372093023256,1
49,92,0.533,18,40,0.45,25,30,0.833,13,25,38,36,9,2,15,25,31,52,0.5961538461538461,1
50,83,0.602,15,29,0.517,24,30,0.8,7,25,32,26,3,1,19,20,35,54,0.6481481481481481,0
47,96,0.49,10,35,0.286,9,13,0.692,7,41,48,29,8,10,17,25,37,61,0.6065573770491803,0
39,96,0.406,9,32,0.281,28,36,0.778,15,35,50,19,12,7,14,15,30,64,0.46875,1
43,90,0.478,15,45,0.333,23,27,0.852,10,40,50,22,4,6,11,17,28,45,0.6222222222222222,1
43,100,0.43,17,52,0.327,11,17,0.647,10,32,42,22,4,5,6,21,26,48,0.5416666666666666,0
39,86,0.453,7,26,0.269,16,23,0.696,9,28,37,28,7,3,11,19,32,60,0.5333333333333333,0
42,81,0.519,16,36,0.444,23,30,0.767,10,39,49,31,10,4,12,18,26,45,0.5777777777777777,1
32,84,0.381,11,41,0.268,14,19,0.737,8,35,43,20,5,6,11,19,21,43,0.4883720930232558,0
40,87,0.46,13,36,0.361,14,20,0.7,10,43,53,28,4,3,11,18,27,51,0.5294117647058824,1
47,88,0.534,8,20,0.4,23,23,1.0,12,29,41,23,5,10,13,20,39,68,0.5735294117647058,1
45,93,0.484,22,45,0.489,12,16,0.75,11,25,36,31,7,5,15,18,23,48,0.4791666666666667,0
35,91,0.385,12,43,0.279,13,17,0.765,17,22,39,20,3,7,18,20,23,48,0.4791666666666667,0
45,81,0.556,9,24,0.375,24,31,0.774,9,34,43,25,10,11,11,23,36,57,0.631578947368421,1
45,93,0.484,14,41,0.341,19,24,0.792,19,33,52,28,4,6,13,16,31,52,0.5961538461538461,1
40,84,0.476,8,31,0.258,17,21,0.81,9,26,35,24,9,7,11,15,32,53,0.6037735849056604,0
37,84,0.44,8,30,0.267,19,21,0.905,10,30,40,17,6,10,17,21,29,54,0.5370370370370371,0
46,101,0.455,12,33,0.364,16,19,0.842,19,32,51,29,6,9,16,18,34,68,0.5,1
32,89,0.36,9,35,0.257,27,33,0.818,15,27,42,22,11,12,11,11,23,54,0.42592592592592593,0
43,90,0.478,11,30,0.367,15,18,0.833,15,36,51,24,5,6,18,24,32,60,0.5333333333333333,1
34,94,0.362,16,41,0.39,20,30,0.667,17,27,44,26,10,4,13,18,18,53,0.33962264150943394,0
41,83,0.494,11,37,0.297,22,28,0.786,13,41,54,26,8,2,18,21,30,46,0.6521739130434783,1
49,99,0.495,8,30,0.267,12,21,0.571,10,33,43,30,5,2,9,25,41,69,0.5942028985507246,0
43,91,0.473,14,42,0.333,24,32,0.75,9,38,47,31,3,6,11,19,29,49,0.5918367346938775,1
43,86,0.5,8,21,0.381,26,29,0.897,14,29,43,29,8,10,18,13,35,65,0.5384615384615384,1
43,87,0.494,8,23,0.348,12,14,0.857,10,23,33,25,7,6,16,23,35,64,0.546875,0
45,89,0.506,13,32,0.406,9,13,0.692,10,39,49,27,6,7,17,18,32,57,0.5614035087719298,1
37,95,0.389,14,45,0.311,12,15,0.8,16,31,47,23,11,5,14,21,23,50,0.46,0
44,97,0.454,19,48,0.396,16,26,0.615,13,34,47,29,12,6,15,15,25,49,0.5102040816326531,1
48,96,0.5,10,32,0.313,10,13,0.769,9,37,46,30,7,7,17,21,38,64,0.59375,0
46,96,0.479,16,48,0.333,21,24,0.875,12,36,48,26,6,2,10,13,30,48,0.625,1
49,101,0.485,16,45,0.356,11,13,0.846,11,35,46,22,2,4,8,16,33,56,0.5892857142857143,0
41,86,0.477,16,43,0.372,15,17,0.882,17,35,52,32,1,7,23,20,25,43,0.5813953488372093,0
48,93,0.516,18,34,0.529,16,19,0.842,10,26,36,26,12,3,8,18,30,59,0.5084745762711864,1
45,90,0.5,13,30,0.433,13,15,0.867,8,30,38,24,6,2,13,18,32,60,0.5333333333333333,0
51,95,0.537,15,39,0.385,17,23,0.739,11,34,45,37,6,5,10,16,36,56,0.6428571428571429,1
46,97,0.474,12,41,0.293,16,21,0.762,17,27,44,26,8,4,11,14,34,56,0.6071428571428571,1
38,80,0.475,13,30,0.433,20,21,0.952,7,32,39,23,8,2,16,20,25,50,0.5,0
36,81,0.444,14,40,0.35,11,20,0.55,12,22,34,22,5,2,15,22,22,41,0.5365853658536586,0
43,75,0.573,15,31,0.484,21,27,0.778,5,34,39,28,8,4,11,19,28,44,0.6363636363636364,1
40,94,0.426,8,26,0.308,23,30,0.767,12,24,36,26,7,5,11,15,32,68,0.47058823529411764,0
55,95,0.579,20,38,0.526,22,23,0.957,9,40,49,38,7,4,15,24,35,57,0.6140350877192983,1
44,81,0.543,8,26,0.308,11,14,0.786,5,33,38,28,6,5,17,17,36,55,0.6545454545454545,0
41,88,0.466,12,37,0.324,14,16,0.875,11,33,44,30,11,4,18,14,29,51,0.5686274509803921,1
36,92,0.391,11,39,0.282,26,34,0.765,11,34,45,20,13,2,18,26,25,53,0.4716981132075472,0
44,85,0.518,13,37,0.351,13,25,0.52,6,39,45,26,7,5,24,26,31,48,0.6458333333333334,1
36,73,0.493,11,32,0.344,14,16,0.875,7,24,31,21,8,3,22,15,25,41,0.6097560975609756,0
41,88,0.466,12,31,0.387,17,18,0.944,18,30,48,28,13,1,20,13,29,57,0.5087719298245614,1
38,102,0.373,14,42,0.333,27,32,0.844,25,34,59,27,8,3,15,16,24,60,0.4,0
45,94,0.479,14,35,0.4,22,23,0.957,11,38,49,27,7,7,13,22,31,59,0.5254237288135594,1
41,82,0.5,15,40,0.375,20,28,0.714,5,26,31,21,9,6,15,20,26,42,0.6190476190476191,1
40,85,0.471,8,27,0.296,14,18,0.778,6,32,38,27,6,4,21,24,32,58,0.5517241379310345,0
49,96,0.51,14,34,0.412,16,20,0.8,10,28,38,31,6,10,19,26,35,62,0.5645161290322581,0
51,91,0.56,12,31,0.387,32,36,0.889,10,35,45,37,12,7,16,15,39,60,0.65,1
36,91,0.396,8,36,0.222,13,13,1.0,11,40,51,22,10,8,16,15,28,55,0.509090909090909,0
37,92,0.402,15,41,0.366,11,13,0.846,14,35,49,22,10,10,14,14,22,51,0.43137254901960786,1
38,90,0.422,19,48,0.396,21,25,0.84,13,41,54,32,7,10,22,20,19,42,0.4523809523809524,1
42,96,0.438,14,33,0.424,17,23,0.739,9,30,39,30,12,7,14,22,28,63,0.4444444444444444,0
47,97,0.485,18,43,0.419,20,25,0.8,13,27,40,26,10,6,11,26,29,54,0.5370370370370371,1
41,79,0.519,8,25,0.32,26,35,0.743,11,36,47,17,8,5,22,22,33,54,0.6111111111111112,0
49,99,0.495,11,36,0.306,18,27,0.667,15,35,50,27,10,4,12,25,38,63,0.6031746031746031,1
40,84,0.476,17,41,0.415,19,31,0.613,6,32,38,25,4,6,16,21,23,43,0.5348837209302325,0
37,86,0.43,11,35,0.314,20,26,0.769,11,38,49,21,5,0,9,20,26,51,0.5098039215686274,0
41,92,0.446,11,35,0.314,15,22,0.682,10,35,45,24,7,4,6,20,30,57,0.5263157894736842,1
36,85,0.424,7,25,0.28,15,24,0.625,5,29,34,20,7,6,9,18,29,60,0.48333333333333334,0
51,93,0.548,14,33,0.424,12,19,0.632,14,43,57,26,4,4,13,23,37,60,0.6166666666666667,1
45,96,0.469,11,27,0.407,17,18,0.944,16,31,47,26,3,5,22,17,34,69,0.4927536231884058,0
52,101,0.515,13,41,0.317,17,20,0.85,14,32,46,26,14,7,12,15,39,60,0.65,1
35,77,0.455,11,28,0.393,27,32,0.844,9,35,44,22,9,8,19,24,24,49,0.4897959183673469,1
35,90,0.389,11,37,0.297,21,28,0.75,13,25,38,20,10,4,14,27,24,53,0.4528301886792453,0
48,98,0.49,7,29,0.241,15,16,0.938,11,42,53,28,2,5,19,24,41,69,0.5942028985507246,0
41,90,0.456,11,37,0.297,27,32,0.844,5,31,36,19,8,7,10,18,30,53,0.5660377358490566,1
36,93,0.387,8,28,0.286,21,22,0.955,11,29,40,23,6,1,17,23,28,65,0.4307692307692308,0
45,82,0.549,15,37,0.405,17,24,0.708,8,40,48,30,9,7,18,23,30,45,0.6666666666666666,1
44,90,0.489,9,34,0.265,8,13,0.615,11,35,46,31,2,7,13,22,35,56,0.625,0
46,100,0.46,19,42,0.452,15,22,0.682,13,34,47,28,7,0,4,14,27,58,0.46551724137931033,1
42,83,0.506,9,29,0.31,27,37,0.73,11,30,41,26,9,5,20,24,33,54,0.6111111111111112,0
44,86,0.512,12,28,0.429,28,30,0.933,12,29,41,23,10,8,14,27,32,58,0.5517241379310345,1
36,91,0.396,15,47,0.319,16,19,0.842,9,34,43,28,8,6,13,13,21,44,0.4772727272727273,0
42,95,0.442,9,34,0.265,13,15,0.867,12,44,56,20,7,7,14,16,33,61,0.5409836065573771,1
44,87,0.506,8,22,0.364,22,29,0.759,7,29,36,26,10,5,18,29,36,65,0.5538461538461539,0
41,89,0.461,11,37,0.297,28,38,0.737,15,35,50,32,11,6,21,24,30,52,0.5769230769230769,1
46,87,0.529,9,27,0.333,23,26,0.885,5,36,41,23,6,5,14,19,37,60,0.6166666666666667,0
44,92,0.478,20,48,0.417,18,20,0.9,9,31,40,27,6,6,13,25,24,44,0.5454545454545454,1
41,85,0.482,15,39,0.385,23,30,0.767,8,28,36,22,13,7,18,25,26,46,0.5652173913043478,1
42,90,0.467,10,27,0.37,25,35,0.714,18,29,47,19,12,6,19,24,32,63,0.5079365079365079,0
38,85,0.447,15,37,0.405,16,18,0.889,9,37,46,26,0,3,12,25,23,48,0.4791666666666667,0
41,94,0.436,19,52,0.365,20,28,0.714,17,35,52,29,5,3,8,13,22,42,0.5238095238095238,1
43,88,0.489,8,27,0.296,32,36,0.889,19,28,47,21,7,2,14,27,35,61,0.5737704918032787,0
51,98,0.52,19,42,0.452,23,26,0.885,15,26,41,30,7,1,9,23,32,56,0.5714285714285714,1
35,83,0.422,9,28,0.321,35,41,0.854,11,35,46,23,13,5,9,23,26,55,0.4727272727272727,1
40,86,0.465,8,28,0.286,18,22,0.818,11,37,48,28,3,5,17,26,32,58,0.5517241379310345,0
34,75,0.453,8,25,0.32,25,34,0.735,8,41,49,12,6,6,18,26,26,50,0.52,0
36,88,0.409,10,35,0.286,22,28,0.786,9,33,42,20,9,5,9,22,26,53,0.49056603773584906,1
41,76,0.539,18,37,0.486,27,29,0.931,8,30,38,28,10,12,21,17,23,39,0.5897435897435898,1
46,101,0.455,19,48,0.396,10,13,0.769,14,23,37,23,5,5,11,23,27,53,0.5094339622641509,0
42,84,0.5,12,27,0.444,26,34,0.765,9,34,43,27,9,7,11,20,30,57,0.5263157894736842,1
42,94,0.447,15,37,0.405,20,27,0.741,17,35,52,22,9,1,13,24,27,57,0.47368421052631576,0
39,87,0.448,7,30,0.233,13,16,0.813,5,33,38,22,9,5,16,15,32,57,0.5614035087719298,0
38,91,0.418,13,47,0.277,16,21,0.762,16,36,52,28,10,9,18,22,25,44,0.5681818181818182,1
43,87,0.494,10,27,0.37,21,27,0.778,13,38,51,23,6,4,18,19,33,60,0.55,1
43,92,0.467,12,34,0.353,12,19,0.632,7,31,38,29,9,8,14,21,31,58,0.5344827586206896,0
50,110,0.455,6,28,0.214,18,28,0.643,28,39,67,31,10,4,10,19,44,82,0.5365853658536586,1
43,88,0.489,14,38,0.368,17,20,0.85,7,29,36,28,4,6,15,23,29,50,0.58,0
41,84,0.488,12,38,0.316,23,25,0.92,7,32,39,23,10,4,15,14,29,46,0.6304347826086957,1
38,87,0.437,18,46,0.391,15,18,0.833,15,33,48,23,6,6,22,19,20,41,0.4878048780487805,0
35,91,0.385,10,37,0.27,14,16,0.875,7,30,37,25,8,1,9,14,25,54,0.46296296296296297,0
47,86,0.547,15,44,0.341,8,13,0.615,5,41,46,30,1,4,13,14,32,42,0.7619047619047619,1
37,86,0.43,11,30,0.367,33,43,0.767,11,34,45,23,13,3,11,24,26,56,0.4642857142857143,1
37,90,0.411,13,38,0.342,23,30,0.767,15,40,55,26,5,3,20,29,24,52,0.46153846153846156,0
38,77,0.494,9,29,0.31,12,25,0.48,5,31,36,25,9,6,19,24,29,48,0.6041666666666666,0
36,84,0.429,10,26,0.385,30,35,0.857,15,28,43,24,9,2,16,17,26,58,0.4482758620689655,1
33,88,0.375,10,41,0.244,18,25,0.72,7,35,42,20,14,3,12,15,23,47,0.48936170212765956,0
37,98,0.378,12,49,0.245,16,20,0.8,20,46,66,22,6,6,19,18,25,49,0.5102040816326531,1
38,88,0.432,11,32,0.344,21,26,0.808,16,33,49,26,4,6,16,19,27,56,0.48214285714285715,0
44,91,0.484,11,30,0.367,20,25,0.8,11,29,40,22,12,6,7,21,33,61,0.5409836065573771,1
43,82,0.524,9,27,0.333,21,30,0.7,9,38,47,27,8,6,14,19,34,55,0.6181818181818182,1
37,96,0.385,12,43,0.279,24,28,0.857,19,32,51,24,9,0,14,28,25,53,0.4716981132075472,0
42,91,0.462,9,32,0.281,11,14,0.786,12,37,49,24,3,5,11,20,33,59,0.559322033898305,0
37,87,0.425,10,32,0.313,23,29,0.793,12,33,45,20,7,4,9,16,27,55,0.4909090909090909,1
37,88,0.42,13,41,0.317,18,24,0.75,11,30,41,25,7,6,16,23,24,47,0.5106382978723404,1
37,85,0.435,12,34,0.353,15,23,0.652,8,33,41,26,9,3,16,23,25,51,0.49019607843137253,0
45,90,0.5,13,37,0.351,7,9,0.778,5,33,38,29,2,8,16,25,32,53,0.6037735849056604,0
41,84,0.488,4,19,0.211,30,37,0.811,7,34,41,27,8,4,9,11,37,65,0.5692307692307692,1
50,102,0.49,20,53,0.377,16,21,0.762,8,34,42,29,7,6,6,19,30,49,0.6122448979591837,1
47,92,0.511,17,36,0.472,13,22,0.591,13,41,54,31,2,3,18,20,30,56,0.5357142857142857,0
44,94,0.468,12,35,0.343,7,11,0.636,15,21,36,21,5,4,12,25,32,59,0.5423728813559322,0
47,87,0.54,15,36,0.417,20,30,0.667,10,30,40,25,8,4,9,18,32,51,0.6274509803921569,1
47,90,0.522,16,39,0.41,16,19,0.842,8,24,32,31,8,9,10,14,31,51,0.6078431372549019,0
53,105,0.505,14,33,0.424,17,20,0.85,23,31,54,28,5,7,12,15,39,72,0.5416666666666666,1
40,82,0.488,10,27,0.37,21,25,0.84,6,27,33,23,9,8,9,21,30,55,0.5454545454545454,1
32,83,0.386,9,29,0.31,26,31,0.839,16,35,51,20,4,7,17,19,23,54,0.42592592592592593,0
39,89,0.438,12,31,0.387,28,30,0.933,11,30,41,26,7,3,7,12,27,58,0.46551724137931033,1
42,91,0.462,19,44,0.432,10,12,0.833,11,39,50,35,3,6,17,21,23,47,0.48936170212765956,0
33,79,0.418,15,35,0.429,17,24,0.708,12,25,37,17,5,2,12,16,18,44,0.4090909090909091,0
40,79,0.506,19,43,0.442,15,16,0.938,8,29,37,27,3,3,11,22,21,36,0.5833333333333334,1
38,100,0.38,14,42,0.333,19,21,0.905,18,29,47,24,9,7,8,25,24,58,0.41379310344827586,0
42,89,0.472,15,47,0.319,19,27,0.704,13,40,53,23,3,5,17,23,27,42,0.6428571428571429,1
45,91,0.495,16,35,0.457,14,17,0.824,14,25,39,24,3,1,11,18,29,56,0.5178571428571429,0
49,83,0.59,20,42,0.476,14,22,0.636,8,29,37,32,3,4,10,19,29,41,0.7073170731707317,1
43,84,0.512,12,26,0.462,9,12,0.75,8,30,38,32,11,5,22,22,31,58,0.5344827586206896,0
45,90,0.5,4,20,0.2,17,25,0.68,16,32,48,28,11,4,19,13,41,70,0.5857142857142857,1
36,82,0.439,16,46,0.348,16,21,0.762,9,28,37,23,9,4,16,16,20,36,0.5555555555555556,0
46,85,0.541,19,39,0.487,13,20,0.65,13,31,44,22,13,3,16,24,27,46,0.5869565217391305,1
40,83,0.482,8,31,0.258,23,28,0.821,10,32,42,26,12,5,8,19,32,52,0.6153846153846154,1
36,81,0.444,15,32,0.469,18,22,0.818,13,32,45,21,6,0,18,21,21,49,0.42857142857142855,0
37,86,0.43,13,29,0.448,21,24,0.875,14,28,42,21,10,1,11,24,24,57,0.42105263157894735,0
39,73,0.534,8,23,0.348,25,32,0.781,6,30,36,26,4,2,14,19,31,50,0.62,1
45,87,0.517,12,33,0.364,24,26,0.923,10,31,41,28,9,7,14,19,33,54,0.6111111111111112,1
47,90,0.522,10,29,0.345,16,23,0.696,14,28,42,36,9,6,17,20,37,61,0.6065573770491803,0
36,81,0.444,14,34,0.412,18,21,0.857,9,33,42,24,9,5,20,19,22,47,0.46808510638297873,1
37,88,0.42,13,39,0.333,14,16,0.875,13,33,46,28,11,2,20,22,24,49,0.4897959183673469,0
39,106,0.368,20,53,0.377,9,12,0.75,13,20,33,28,8,9,9,15,19,53,0.3584905660377358,0
47,81,0.58,22,35,0.629,18,24,0.75,10,44,54,30,4,10,19,13,25,46,0.5434782608695652,1
38,90,0.422,14,42,0.333,20,26,0.769,16,29,45,25,4,3,20,16,24,48,0.5,0
49,94,0.521,14,38,0.368,19,26,0.731,12,30,42,33,17,6,13,20,35,56,0.625,1
36,93,0.387,9,30,0.3,6,9,0.667,13,30,43,24,7,6,25,13,27,63,0.42857142857142855,0
46,89,0.517,15,39,0.385,16,20,0.8,4,36,40,34,19,6,16,17,31,50,0.62,1
48,93,0.516,13,37,0.351,23,33,0.697,10,31,41,32,7,5,11,28,35,56,0.625,1
43,86,0.5,6,22,0.273,34,35,0.971,5,33,38,22,5,3,16,26,37,64,0.578125,0
37,88,0.42,11,35,0.314,14,20,0.7,13,30,43,23,5,6,17,15,26,53,0.49056603773584906,0
44,95,0.463,13,43,0.302,14,15,0.933,16,36,52,26,11,6,13,18,31,52,0.5961538461538461,1
45,94,0.479,16,34,0.471,10,11,0.909,14,28,42,29,9,2,17,20,29,60,0.48333333333333334,1
41,75,0.547,12,31,0.387,20,26,0.769,6,24,30,28,11,6,15,20,29,44,0.6590909090909091,0
32,82,0.39,8,28,0.286,24,30,0.8,12,34,46,20,12,3,15,21,24,54,0.4444444444444444,1
33,83,0.398,9,33,0.273,19,22,0.864,14,39,53,16,7,4,19,25,24,50,0.48,0
48,96,0.5,16,44,0.364,13,17,0.765,11,34,45,31,20,1,16,20,32,52,0.6153846153846154,1
42,83,0.506,11,29,0.379,15,19,0.789,7,36,43,25,12,6,23,17,31,54,0.5740740740740741,0
42,88,0.477,18,50,0.36,15,19,0.789,12,33,45,23,7,8,10,15,24,38,0.631578947368421,1
39,85,0.459,11,30,0.367,18,22,0.818,10,31,41,18,5,1,9,14,28,55,0.509090909090909,0
42,92,0.457,5,27,0.185,26,28,0.929,16,24,40,18,8,5,6,14,37,65,0.5692307692307692,0
51,85,0.6,17,31,0.548,14,15,0.933,5,27,32,31,1,4,9,21,34,54,0.6296296296296297,1
42,75,0.56,9,30,0.3,16,21,0.762,7,40,47,23,5,9,18,16,33,45,0.7333333333333333,1
34,91,0.374,13,38,0.342,14,16,0.875,8,22,30,24,9,3,14,21,21,53,0.39622641509433965,0
44,85,0.518,20,39,0.513,20,21,0.952,9,32,41,25,8,9,13,25,24,46,0.5217391304347826,1
38,96,0.396,9,33,0.273,27,31,0.871,26,29,55,28,10,8,14,19,29,63,0.4603174603174603,0
48,92,0.522,17,42,0.405,17,29,0.586,9,37,46,32,6,4,10,16,31,50,0.62,1
43,89,0.483,12,36,0.333,19,23,0.826,8,38,46,23,6,1,12,22,31,53,0.5849056603773585,0
44,87,0.506,19,32,0.594,21,23,0.913,7,35,42,31,10,3,13,20,25,55,0.45454545454545453,1
40,98,0.408,14,41,0.341,15,19,0.789,20,29,49,27,5,4,16,19,26,57,0.45614035087719296,0
40,85,0.471,14,36,0.389,21,27,0.778,10,30,40,29,5,3,15,20,26,49,0.5306122448979592,0
42,81,0.519,15,35,0.429,23,24,0.958,7,25,32,26,8,3,9,20,27,46,0.5869565217391305,1
43,88,0.489,13,30,0.433,27,28,0.964,13,30,43,32,9,4,17,20,30,58,0.5172413793103449,1
40,89,0.449,12,33,0.364,24,30,0.8,14,25,39,24,8,4,13,20,28,56,0.5,0
38,79,0.481,11,34,0.324,16,23,0.696,10,36,46,24,7,7,19,22,27,45,0.6,1
35,79,0.443,10,29,0.345,17,22,0.773,5,29,34,19,10,3,16,21,25,50,0.5,0
49,89,0.551,22,45,0.489,10,13,0.769,4,45,49,32,4,7,13,21,27,44,0.6136363636363636,1
37,91,0.407,6,26,0.231,19,22,0.864,9,34,43,18,5,2,12,14,31,65,0.47692307692307695,0
39,91,0.429,9,35,0.257,13,15,0.867,18,33,51,20,8,6,17,19,30,56,0.5357142857142857,0
42,82,0.512,9,21,0.429,15,21,0.714,7,32,39,21,9,6,12,9,33,61,0.5409836065573771,1
38,88,0.432,10,31,0.323,14,20,0.7,12,35,47,24,6,5,17,28,28,57,0.49122807017543857,0
36,83,0.434,13,34,0.382,21,30,0.7,8,39,47,22,10,7,14,19,23,49,0.46938775510204084,1
47,96,0.49,10,40,0.25,6,12,0.5,11,40,51,37,4,3,13,20,37,56,0.6607142857142857,0
46,88,0.523,12,23,0.522,11,21,0.524,4,35,39,33,8,5,11,13,34,65,0.5230769230769231,1
40,81,0.494,12,29,0.414,15,22,0.682,11,33,44,27,11,6,18,16,28,52,0.5384615384615384,1
36,89,0.404,10,37,0.27,13,18,0.722,19,29,48,17,11,2,19,17,26,52,0.5,0
46,85,0.541,18,42,0.429,19,24,0.792,4,38,42,31,10,2,14,22,28,43,0.6511627906976745,1
43,92,0.467,15,36,0.417,19,23,0.826,6,36,42,33,7,3,15,21,28,56,0.5,0
42,92,0.457,16,46,0.348,8,9,0.889,8,36,44,29,5,4,11,13,26,46,0.5652173913043478,1
42,87,0.483,12,33,0.364,9,14,0.643,5,36,41,29,4,1,13,11,30,54,0.5555555555555556,0
45,86,0.523,18,33,0.545,23,26,0.885,5,31,36,35,5,4,9,22,27,53,0.5094339622641509,1
43,85,0.506,16,36,0.444,26,31,0.839,10,29,39,27,3,10,8,23,27,49,0.5510204081632653,0
45,91,0.495,16,38,0.421,14,20,0.7,14,34,48,26,5,6,11,21,29,53,0.5471698113207547,1
37,82,0.451,10,32,0.313,15,16,0.938,7,25,32,25,4,4,14,18,27,50,0.54,0
33,77,0.429,12,36,0.333,19,23,0.826,5,29,34,23,9,0,15,18,21,41,0.5121951219512195,0
36,81,0.444,16,45,0.356,14,19,0.737,10,34,44,24,9,6,13,22,20,36,0.5555555555555556,1
46,91,0.505,16,37,0.432,14,19,0.737,13,34,47,27,7,4,12,13,30,54,0.5555555555555556,1
40,82,0.488,17,35,0.486,11,13,0.846,4,32,36,29,5,5,13,22,23,47,0.48936170212765956,0
52,100,0.52,8,23,0.348,18,20,0.9,9,38,47,26,8,7,12,16,44,77,0.5714285714285714,1
44,97,0.454,18,46,0.391,17,21,0.81,14,35,49,33,6,4,16,18,26,51,0.5098039215686274,0
51,103,0.495,16,47,0.34,7,10,0.7,11,38,49,27,1,2,12,16,35,56,0.625,0
49,94,0.521,17,45,0.378,17,20,0.85,5,36,41,29,8,3,7,16,32,49,0.6530612244897959,1
43,80,0.538,13,31,0.419,22,27,0.815,5,28,33,29,6,7,14,21,30,49,0.6122448979591837,1
44,86,0.512,12,29,0.414,20,23,0.87,13,27,40,27,9,5,17,26,32,57,0.5614035087719298,0
40,86,0.465,11,33,0.333,29,36,0.806,12,33,45,23,7,3,14,25,29,53,0.5471698113207547,1
36,83,0.434,15,40,0.375,21,26,0.808,12,28,40,26,5,9,15,28,21,43,0.4883720930232558,0
44,94,0.468,16,35,0.457,17,18,0.944,10,34,44,32,8,4,5,18,28,59,0.4745762711864407,1
38,81,0.469,11,28,0.393,12,16,0.75,9,36,45,24,2,8,15,14,27,53,0.5094339622641509,0
39,82,0.476,14,29,0.483,17,23,0.739,9,24,33,23,7,5,13,21,25,53,0.4716981132075472,0
45,82,0.549,11,27,0.407,20,26,0.769,11,36,47,30,6,5,14,18,34,55,0.6181818181818182,1
48,90,0.533,17,40,0.425,16,21,0.762,14,34,48,34,9,3,13,20,31,50,0.62,1
41,88,0.466,12,34,0.353,19,26,0.731,11,29,40,23,8,2,10,15,29,54,0.5370370370370371,0
43,87,0.494,7,20,0.35,35,42,0.833,8,34,42,21,10,10,15,23,36,67,0.5373134328358209,1
42,95,0.442,8,31,0.258,24,31,0.774,11,29,40,24,10,7,16,32,34,64,0.53125,0
41,84,0.488,14,37,0.378,8,10,0.8,6,28,34,35,7,3,18,25,27,47,0.574468085106383,0
39,83,0.47,6,29,0.207,21,29,0.724,10,32,42,26,13,1,18,13,33,54,0.6111111111111112,1
35,77,0.455,12,31,0.387,20,25,0.8,9,36,45,20,6,10,17,19,23,46,0.5,1
37,95,0.389,17,44,0.386,9,10,0.9,14,28,42,28,7,5,11,21,20,51,0.39215686274509803,0
49,81,0.605,22,36,0.611,14,14,1.0,10,33,43,28,8,3,18,18,27,45,0.6,1
34,85,0.4,9,34,0.265,14,21,0.667,13,18,31,21,10,2,19,15,25,51,0.49019607843137253,0
39,83,0.47,9,26,0.346,26,35,0.743,7,34,41,25,3,3,17,23,30,57,0.5263157894736842,0
55,102,0.539,14,36,0.389,18,29,0.621,12,35,47,44,10,5,8,23,41,66,0.6212121212121212,1
50,102,0.49,18,45,0.4,22,26,0.846,11,33,44,36,11,13,18,28,32,57,0.5614035087719298,1
48,115,0.417,15,46,0.326,26,32,0.813,27,32,59,27,11,5,19,27,33,69,0.4782608695652174,0
42,84,0.5,17,35,0.486,17,20,0.85,9,34,43,31,7,1,10,19,25,49,0.5102040816326531,1
37,81,0.457,11,37,0.297,15,16,0.938,7,29,36,21,2,7,11,16,26,44,0.5909090909090909,0
42,97,0.433,16,50,0.32,18,28,0.643,11,37,48,19,6,8,15,15,26,47,0.5531914893617021,0
46,104,0.442,13,39,0.333,16,17,0.941,17,40,57,29,9,7,13,18,33,65,0.5076923076923077,1
40,87,0.46,11,28,0.393,16,21,0.762,11,32,43,30,7,8,14,17,29,59,0.4915254237288136,1
36,81,0.444,7,21,0.333,24,26,0.923,11,32,43,21,7,5,18,24,29,60,0.48333333333333334,0
44,95,0.463,13,41,0.317,15,19,0.789,15,33,48,28,6,3,8,24,31,54,0.5740740740740741,0
36,77,0.468,21,43,0.488,28,33,0.848,8,35,43,26,3,1,8,21,15,34,0.4411764705882353,1
32,92,0.348,9,38,0.237,27,34,0.794,17,33,50,16,8,3,10,23,23,54,0.42592592592592593,0
41,80,0.513,11,34,0.324,24,32,0.75,7,37,44,30,7,7,14,26,30,46,0.6521739130434783,1
33,87,0.379,11,45,0.244,16,24,0.667,9,27,36,27,4,5,13,21,22,42,0.5238095238095238,0
50,92,0.543,12,28,0.429,17,21,0.81,10,45,55,38,8,6,12,19,38,64,0.59375,1
45,95,0.474,12,36,0.333,22,25,0.88,10,41,51,30,15,3,7,10,33,59,0.559322033898305,1
39,90,0.433,10,38,0.263,11,14,0.786,13,36,49,23,4,7,16,17,29,52,0.5576923076923077,0
55,94,0.585,11,29,0.379,21,28,0.75,16,39,55,33,3,6,15,13,44,65,0.676923076923077,1
55,99,0.556,10,29,0.345,9,11,0.818,5,21,26,29,6,4,4,19,45,70,0.6428571428571429,0
57,94,0.606,22,45,0.489,21,28,0.75,7,22,29,35,7,11,14,25,35,49,0.7142857142857143,1
57,95,0.6,15,31,0.484,23,28,0.821,12,27,39,28,8,4,15,23,42,64,0.65625,0
38,98,0.388,11,44,0.25,12,16,0.75,13,29,42,25,6,3,14,22,27,54,0.5,0
49,86,0.57,11,29,0.379,22,27,0.815,9,43,52,35,6,5,15,15,38,57,0.6666666666666666,1
38,75,0.507,14,28,0.5,17,22,0.773,5,33,38,29,6,6,24,20,24,47,0.5106382978723404,0
50,100,0.5,12,31,0.387,14,20,0.7,15,25,40,31,12,8,13,19,38,69,0.5507246376811594,1
46,94,0.489,9,25,0.36,21,25,0.84,14,42,56,33,9,4,16,21,37,69,0.5362318840579711,1
40,96,0.417,11,35,0.314,28,34,0.824,14,30,44,19,12,8,14,25,29,61,0.47540983606557374,0
38,87,0.437,14,31,0.452,17,20,0.85,12,18,30,20,8,3,13,20,24,56,0.42857142857142855,0
43,76,0.566,7,17,0.412,27,28,0.964,11,27,38,26,8,8,15,18,36,59,0.6101694915254238,1
55,113,0.487,15,35,0.429,20,24,0.833,22,37,59,28,8,6,16,24,40,78,0.5128205128205128,0
51,116,0.44,18,49,0.367,27,29,0.931,22,36,58,24,10,8,14,18,33,67,0.4925373134328358,1
45,101,0.446,13,34,0.382,13,17,0.765,13,34,47,23,9,2,9,19,32,67,0.47761194029850745,0
44,84,0.524,17,42,0.405,14,17,0.824,4,39,43,27,3,5,15,15,27,42,0.6428571428571429,1
44,97,0.454,11,32,0.344,15,18,0.833,11,36,47,26,7,3,10,18,33,65,0.5076923076923077,0
43,91,0.473,16,37,0.432,15,21,0.714,11,38,49,27,6,4,13,15,27,54,0.5,1
46,88,0.523,20,35,0.571,17,21,0.81,10,31,41,30,11,7,12,19,26,53,0.49056603773584906,1
36,77,0.468,14,30,0.467,10,14,0.714,7,27,34,25,5,6,19,17,22,47,0.46808510638297873,0
27,82,0.329,7,32,0.219,30,35,0.857,9,37,46,17,3,7,9,19,20,50,0.4,0
40,92,0.435,14,43,0.326,17,20,0.85,6,43,49,22,6,6,7,22,26,49,0.5306122448979592,1
48,90,0.533,11,27,0.407,25,30,0.833,13,33,46,26,7,3,19,15,37,63,0.5873015873015873,1
50,91,0.549,18,39,0.462,13,16,0.813,5,26,31,33,10,6,15,24,32,52,0.6153846153846154,0
38,96,0.396,16,50,0.32,12,16,0.75,11,37,48,21,5,4,4,18,22,46,0.4782608695652174,1
39,84,0.464,11,29,0.379,12,19,0.632,9,42,51,26,1,2,13,17,28,55,0.509090909090909,0
34,87,0.391,7,32,0.219,24,30,0.8,16,32,48,21,9,12,15,23,27,55,0.4909090909090909,0
43,89,0.483,10,26,0.385,16,24,0.667,10,38,48,28,10,8,13,21,33,63,0.5238095238095238,1
34,76,0.447,15,44,0.341,29,35,0.829,4,34,38,22,3,1,16,25,19,32,0.59375,0
41,87,0.471,7,30,0.233,28,37,0.757,13,35,48,23,10,2,10,28,34,57,0.5964912280701754,1
34,88,0.386,17,44,0.386,17,17,1.0,11,27,38,22,7,2,12,26,17,44,0.38636363636363635,0
37,75,0.493,11,29,0.379,31,38,0.816,11,34,45,24,4,12,14,17,26,46,0.5652173913043478,1
44,93,0.473,15,35,0.429,16,21,0.762,17,25,42,29,6,2,12,25,29,58,0.5,0
44,81,0.543,10,29,0.345,26,30,0.867,11,30,41,27,9,7,12,21,34,52,0.6538461538461539,1
43,90,0.478,10,32,0.313,19,29,0.655,11,32,43,29,10,3,16,34,33,58,0.5689655172413793,0
34,76,0.447,11,28,0.393,44,52,0.846,11,32,43,22,9,8,15,22,23,48,0.4791666666666667,1
37,79,0.468,10,31,0.323,21,26,0.808,14,30,44,25,7,3,24,13,27,48,0.5625,0
47,92,0.511,17,39,0.436,10,15,0.667,14,23,37,31,9,6,14,21,30,53,0.5660377358490566,1
39,85,0.459,9,28,0.321,22,29,0.759,11,39,50,29,10,3,16,23,30,57,0.5263157894736842,1
35,91,0.385,11,38,0.289,21,23,0.913,10,34,44,26,8,6,14,24,24,53,0.4528301886792453,0
45,100,0.45,12,47,0.255,10,12,0.833,15,31,46,28,10,3,20,18,33,53,0.6226415094339622,0
40,81,0.494,19,42,0.452,19,24,0.792,7,34,41,35,7,2,24,21,21,39,0.5384615384615384,1
32,94,0.34,7,30,0.233,15,21,0.714,16,30,46,17,8,4,15,14,25,64,0.390625,0
40,82,0.488,12,29,0.414,13,15,0.867,6,43,49,25,9,9,14,21,28,53,0.5283018867924528,1
43,90,0.478,7,18,0.389,20,24,0.833,14,29,43,22,6,11,14,18,36,72,0.5,0
49,102,0.48,16,38,0.421,22,24,0.917,15,25,40,24,7,8,9,21,33,64,0.515625,1
43,88,0.489,10,24,0.417,20,27,0.741,12,38,50,26,6,5,15,19,33,64,0.515625,1
42,92,0.457,11,37,0.297,11,17,0.647,8,31,39,27,11,8,11,24,31,55,0.5636363636363636,0
39,76,0.513,11,31,0.355,21,28,0.75,7,34,41,22,10,6,13,12,28,45,0.6222222222222222,1
37,80,0.463,9,33,0.273,6,10,0.6,6,29,35,22,6,2,15,22,28,47,0.5957446808510638,0
48,100,0.48,15,37,0.405,17,21,0.81,12,34,46,29,3,4,9,24,33,63,0.5238095238095238,0
48,92,0.522,9,31,0.29,26,33,0.788,10,40,50,28,6,6,9,22,39,61,0.639344262295082,1
49,100,0.49,17,35,0.486,9,11,0.818,14,32,46,25,7,4,13,19,32,65,0.49230769230769234,1
36,82,0.439,12,33,0.364,27,29,0.931,10,34,44,25,6,9,18,18,24,49,0.4897959183673469,0
34,87,0.391,10,37,0.27,20,21,0.952,10,31,41,20,11,0,11,19,24,50,0.48,0
39,81,0.481,10,29,0.345,12,18,0.667,6,40,46,21,7,2,19,14,29,52,0.5576923076923077,1
31,76,0.408,7,29,0.241,27,37,0.73,4,27,31,17,10,4,15,18,24,47,0.5106382978723404,0
43,85,0.506,11,28,0.393,16,22,0.727,13,35,48,23,5,3,18,28,32,57,0.5614035087719298,1
42,82,0.512,12,27,0.444,12,19,0.632,9,28,37,20,5,2,13,20,30,55,0.5454545454545454,0
44,83,0.53,13,39,0.333,20,27,0.741,13,27,40,32,8,6,14,14,31,44,0.7045454545454546,1
38,87,0.437,11,34,0.324,10,13,0.769,13,31,44,24,6,3,18,18,27,53,0.5094339622641509,0
39,78,0.5,14,36,0.389,20,23,0.87,8,34,42,27,11,9,13,18,25,42,0.5952380952380952,1
47,90,0.522,9,27,0.333,18,21,0.857,9,35,44,34,9,8,18,15,38,63,0.6031746031746031,1
43,91,0.473,9,28,0.321,20,23,0.87,7,30,37,30,13,4,14,16,34,63,0.5396825396825397,0
34,91,0.374,9,38,0.237,11,14,0.786,10,27,37,17,6,5,9,24,25,53,0.4716981132075472,0
38,88,0.432,8,29,0.276,23,31,0.742,17,40,57,25,2,6,13,16,30,59,0.5084745762711864,1
38,83,0.458,14,41,0.341,37,45,0.822,17,32,49,30,2,9,13,26,24,42,0.5714285714285714,1
43,98,0.439,16,43,0.372,21,26,0.808,13,25,38,29,3,3,4,27,27,55,0.4909090909090909,0
39,93,0.419,11,36,0.306,11,18,0.611,13,29,42,31,15,4,13,17,28,57,0.49122807017543857,0
38,87,0.437,15,43,0.349,14,17,0.824,14,38,52,23,8,6,24,13,23,44,0.5227272727272727,1
52,102,0.51,18,37,0.486,14,20,0.7,17,32,49,29,13,2,10,15,34,65,0.5230769230769231,1
43,88,0.489,10,38,0.263,12,12,1.0,8,33,41,33,5,6,20,17,33,50,0.66,0
36,88,0.409,19,53,0.358,12,19,0.632,11,32,43,15,5,4,16,17,17,35,0.4857142857142857,0
42,95,0.442,13,47,0.277,16,20,0.8,18,40,58,24,9,3,13,19,29,48,0.6041666666666666,1
40,83,0.482,12,32,0.375,17,22,0.773,10,30,40,21,3,2,11,18,28,51,0.5490196078431373,0
41,83,0.494,25,53,0.472,11,15,0.733,8,31,39,29,7,2,11,19,16,30,0.5333333333333333,1
37,89,0.416,8,32,0.25,20,29,0.69,17,33,50,17,9,3,12,11,29,57,0.5087719298245614,0
45,97,0.464,10,31,0.323,5,6,0.833,12,37,49,29,2,5,14,18,35,66,0.5303030303030303,1
42,93,0.452,14,37,0.378,22,26,0.846,10,25,35,34,10,6,15,22,28,56,0.5,0
50,89,0.562,12,28,0.429,20,25,0.8,11,34,45,38,8,3,20,25,38,61,0.6229508196721312,1
43,81,0.531,15,34,0.441,18,23,0.783,6,36,42,30,5,5,16,26,28,47,0.5957446808510638,1
34,88,0.386,10,37,0.27,19,27,0.704,11,24,35,24,4,4,14,18,24,51,0.47058823529411764,0
37,91,0.407,13,32,0.406,15,20,0.75,11,29,40,21,15,4,20,26,24,59,0.4067796610169492,0
35,89,0.393,14,42,0.333,24,32,0.75,18,34,52,19,13,11,17,20,21,47,0.44680851063829785,1
42,91,0.462,16,38,0.421,16,21,0.762,18,29,47,27,4,11,13,25,26,53,0.49056603773584906,1
39,86,0.453,12,29,0.414,23,32,0.719,13,25,38,18,7,5,7,19,27,57,0.47368421052631576,0
44,83,0.53,13,30,0.433,16,25,0.64,5,31,36,27,6,7,18,26,31,53,0.5849056603773585,0
47,87,0.54,10,27,0.37,26,33,0.788,7,37,44,33,10,3,15,26,37,60,0.6166666666666667,1
45,89,0.506,10,29,0.345,26,28,0.929,6,40,46,29,8,6,16,19,35,60,0.5833333333333334,1
43,102,0.422,8,38,0.211,13,19,0.684,18,31,49,29,7,11,17,22,35,64,0.546875,0
40,85,0.471,9,18,0.5,25,31,0.806,9,29,38,20,6,4,16,21,31,67,0.4626865671641791,1
42,88,0.477,8,33,0.242,18,24,0.75,10,32,42,26,10,6,20,24,34,55,0.6181818181818182,0
44,92,0.478,10,22,0.455,15,28,0.536,18,34,52,28,8,6,11,22,34,70,0.4857142857142857,1
35,85,0.412,6,20,0.3,28,34,0.824,16,33,49,18,6,9,13,23,29,65,0.4461538461538462,0
39,83,0.47,7,28,0.25,9,13,0.692,6,26,32,23,3,4,17,18,32,55,0.5818181818181818,0
47,93,0.505,22,46,0.478,22,26,0.846,15,33,48,33,11,2,7,17,25,47,0.5319148936170213,1
44,88,0.5,7,22,0.318,17,25,0.68,11,37,48,27,5,1,8,25,37,66,0.5606060606060606,0
37,88,0.42,17,48,0.354,23,28,0.821,9,34,43,31,6,4,10,23,20,40,0.5,1
39,90,0.433,9,28,0.321,10,18,0.556,9,28,37,25,11,7,8,13,30,62,0.4838709677419355,0
47,90,0.522,21,49,0.429,9,12,0.75,11,41,52,36,6,9,16,18,26,41,0.6341463414634146,1
39,101,0.386,13,36,0.361,12,19,0.632,15,31,46,27,11,3,7,21,26,65,0.4,0
40,89,0.449,13,38,0.342,22,26,0.846,13,46,59,26,7,8,15,17,27,51,0.5294117647058824,1
35,101,0.347,13,44,0.295,22,24,0.917,14,30,44,21,9,3,11,16,22,57,0.38596491228070173,0
50,93,0.538,13,36,0.361,15,17,0.882,12,43,55,27,8,12,17,20,37,57,0.6491228070175439,1
42,85,0.494,8,29,0.276,23,29,0.793,10,30,40,33,2,6,12,27,34,56,0.6071428571428571,0
42,89,0.472,12,34,0.353,25,29,0.862,9,29,38,25,5,4,7,25,30,55,0.5454545454545454,1
47,88,0.534,13,35,0.371,24,27,0.889,8,37,45,26,3,4,9,21,34,53,0.6415094339622641,1
48,94,0.511,14,30,0.467,14,21,0.667,8,27,35,32,3,5,6,22,34,64,0.53125,0
37,90,0.411,11,30,0.367,18,23,0.783,9,27,36,22,8,4,10,23,26,60,0.43333333333333335,0
33,78,0.423,14,33,0.424,26,32,0.813,10,41,51,18,3,9,20,17,19,45,0.4222222222222222,1
37,89,0.416,13,31,0.419,4,7,0.571,13,28,41,21,8,2,17,14,24,58,0.41379310344827586,0
41,88,0.466,15,38,0.395,18,20,0.9,15,39,54,21,10,7,16,12,26,50,0.52,1
40,83,0.482,17,41,0.415,26,30,0.867,9,43,52,25,6,6,20,31,23,42,0.5476190476190477,0
41,91,0.451,15,44,0.341,27,42,0.643,12,34,46,25,8,7,10,23,26,47,0.5531914893617021,1
47,86,0.547,16,41,0.39,14,19,0.737,8,27,35,27,3,5,9,20,31,45,0.6888888888888889,0
48,95,0.505,19,43,0.442,19,26,0.731,13,28,41,37,4,2,4,18,29,52,0.5576923076923077,1
45,88,0.511,12,34,0.353,31,38,0.816,8,41,49,28,7,10,12,12,33,54,0.6111111111111112,1
40,97,0.412,15,36,0.417,12,14,0.857,10,29,39,28,8,3,14,31,25,61,0.4098360655737705,0
34,90,0.378,16,39,0.41,7,12,0.583,12,27,39,26,8,8,18,14,18,51,0.35294117647058826,0
43,87,0.494,13,39,0.333,6,8,0.75,12,39,51,26,9,10,17,15,30,48,0.625,1
42,81,0.519,14,34,0.412,16,18,0.889,8,22,30,28,8,7,21,26,28,47,0.5957446808510638,0
42,78,0.538,10,30,0.333,30,34,0.882,13,27,40,33,11,4,21,22,32,48,0.6666666666666666,1
41,87,0.471,11,29,0.379,27,35,0.771,7,22,29,28,14,3,10,20,30,58,0.5172413793103449,0
51,84,0.607,17,27,0.63,20,24,0.833,9,35,44,34,5,6,19,22,34,57,0.5964912280701754,1
50,93,0.538,14,28,0.5,17,22,0.773,8,29,37,28,8,5,7,20,36,65,0.5538461538461539,1
40,86,0.465,13,41,0.317,24,28,0.857,13,34,47,22,1,1,14,20,27,45,0.6,0
38,94,0.404,7,26,0.269,22,23,0.957,12,35,47,25,3,5,10,15,31,68,0.45588235294117646,0
42,93,0.452,10,27,0.37,18,21,0.857,15,34,49,25,7,5,10,22,32,66,0.48484848484848486,1
46,91,0.505,21,36,0.583,16,16,1.0,13,28,41,30,6,7,9,16,25,55,0.45454545454545453,1
52,105,0.495,14,36,0.389,10,15,0.667,22,30,52,21,6,4,9,11,38,69,0.5507246376811594,0
44,98,0.449,16,48,0.333,9,13,0.692,9,34,43,28,12,6,21,21,28,50,0.56,0
45,98,0.459,13,37,0.351,17,22,0.773,14,37,51,32,14,4,21,18,32,61,0.5245901639344263,1
39,77,0.506,14,35,0.4,11,11,1.0,9,31,40,29,10,4,23,17,25,42,0.5952380952380952,1
38,89,0.427,7,32,0.219,12,12,1.0,14,21,35,25,12,2,19,15,31,57,0.543859649122807,0
42,95,0.442,12,32,0.375,18,24,0.75,15,28,43,26,5,1,6,21,30,63,0.47619047619047616,0
41,82,0.5,15,39,0.385,23,31,0.742,10,37,47,30,3,4,9,18,26,43,0.6046511627906976,1
50,98,0.51,11,43,0.256,21,32,0.656,10,24,34,30,11,5,10,31,39,55,0.7090909090909091,0
48,86,0.558,8,21,0.381,38,45,0.844,10,38,48,25,4,1,14,28,40,65,0.6153846153846154,1
33,87,0.379,11,34,0.324,13,14,0.929,13,38,51,22,6,4,21,19,22,53,0.41509433962264153,0
39,89,0.438,13,35,0.371,10,13,0.769,10,32,42,29,13,7,12,16,26,54,0.48148148148148145,1
43,81,0.531,15,35,0.429,11,17,0.647,8,34,42,22,4,3,20,25,28,46,0.6086956521739131,0
41,88,0.466,16,41,0.39,20,28,0.714,12,29,41,25,8,3,11,17,25,47,0.5319148936170213,1
36,81,0.444,11,33,0.333,27,32,0.844,7,34,41,24,6,2,14,20,25,48,0.5208333333333334,0
50,94,0.532,14,42,0.333,19,22,0.864,8,40,48,29,9,6,9,24,36,52,0.6923076923076923,1
49,96,0.51,14,33,0.424,25,29,0.862,8,29,37,24,14,2,10,25,35,63,0.5555555555555556,1
48,89,0.539,18,41,0.439,21,23,0.913,11,36,47,34,4,7,21,22,30,48,0.625,0
43,94,0.457,16,35,0.457,17,23,0.739,15,27,42,16,16,5,16,24,27,59,0.4576271186440678,0
39,77,0.506,16,33,0.485,31,36,0.861,10,36,46,25,10,8,20,18,23,44,0.5227272727272727,1
44,90,0.489,11,34,0.324,9,11,0.818,13,39,52,27,8,12,15,23,33,56,0.5892857142857143,1
34,92,0.37,12,39,0.308,14,21,0.667,13,29,42,27,9,5,12,13,22,53,0.41509433962264153,0
38,83,0.458,16,39,0.41,14,17,0.824,8,31,39,28,5,5,20,21,22,44,0.5,0
42,85,0.494,10,31,0.323,27,29,0.931,10,32,42,26,8,6,12,15,32,54,0.5925925925925926,1
45,89,0.506,13,28,0.464,22,31,0.71,8,32,40,25,8,5,14,29,32,61,0.5245901639344263,0
46,89,0.517,12,31,0.387,26,33,0.788,10,34,44,35,6,8,15,23,34,58,0.5862068965517241,1
50,88,0.568,12,32,0.375,7,12,0.583,4,28,32,38,8,4,9,21,38,56,0.6785714285714286,1
39,84,0.464,9,27,0.333,24,26,0.923,8,35,43,22,4,9,12,17,30,57,0.5263157894736842,0
45,90,0.5,16,36,0.444,13,16,0.813,11,32,43,30,6,3,13,15,29,54,0.5370370370370371,1
44,100,0.44,6,32,0.188,12,17,0.706,19,29,48,32,7,6,12,19,38,68,0.5588235294117647,0
35,88,0.398,9,29,0.31,22,27,0.815,8,29,37,24,3,5,11,27,26,59,0.4406779661016949,0
46,91,0.505,14,34,0.412,23,31,0.742,14,43,57,31,4,8,11,21,32,57,0.5614035087719298,1
41,82,0.5,8,25,0.32,28,35,0.8,13,26,39,20,10,1,12,17,33,57,0.5789473684210527,0
48,88,0.545,17,40,0.425,11,15,0.733,12,29,41,32,6,8,13,21,31,48,0.6458333333333334,1
43,84,0.512,11,31,0.355,26,30,0.867,10,31,41,26,5,3,11,16,32,53,0.6037735849056604,1
44,91,0.484,12,25,0.48,17,19,0.895,10,26,36,29,6,4,8,22,32,66,0.48484848484848486,0
44,100,0.44,20,44,0.455,18,22,0.818,16,34,50,24,8,5,13,24,24,56,0.42857142857142855,1
39,87,0.448,19,52,0.365,23,35,0.657,15,32,47,26,5,12,16,21,20,35,0.5714285714285714,0
44,89,0.494,10,30,0.333,12,18,0.667,8,35,43,25,11,1,11,18,34,59,0.576271186440678,1
39,83,0.47,8,30,0.267,15,23,0.652,10,39,49,24,9,3,16,20,31,53,0.5849056603773585,0
38,86,0.442,17,43,0.395,19,24,0.792,6,36,42,31,5,4,15,15,21,43,0.4883720930232558,0
44,90,0.489,13,39,0.333,12,14,0.857,5,35,40,31,5,6,11,21,31,51,0.6078431372549019,1
36,89,0.404,11,31,0.355,14,18,0.778,11,43,54,24,5,7,17,23,25,58,0.43103448275862066,0
40,89,0.449,8,27,0.296,19,27,0.704,9,39,48,24,11,7,12,17,32,62,0.5161290322580645,1
56,85,0.659,16,32,0.5,16,20,0.8,3,29,32,35,4,8,10,24,40,53,0.7547169811320755,1
48,89,0.539,12,25,0.48,21,24,0.875,6,22,28,27,3,1,12,22,36,64,0.5625,0
45,101,0.446,15,38,0.395,16,21,0.762,15,25,40,23,11,4,11,14,30,63,0.47619047619047616,0
53,89,0.596,14,33,0.424,12,15,0.8,8,36,44,33,5,6,16,19,39,56,0.6964285714285714,1
39,86,0.453,9,31,0.29,22,24,0.917,8,32,40,14,9,8,17,31,30,55,0.5454545454545454,0
36,83,0.434,9,26,0.346,35,43,0.814,12,32,44,24,10,5,17,21,27,57,0.47368421052631576,1
49,99,0.495,6,25,0.24,13,20,0.65,8,38,46,35,9,7,11,14,43,74,0.581081081081081,0
48,99,0.485,16,34,0.471,11,15,0.733,9,38,47,33,7,5,11,14,32,65,0.49230769230769234,1
38,95,0.4,13,40,0.325,24,27,0.889,11,29,40,17,11,5,11,20,25,55,0.45454545454545453,0
46,94,0.489,7,34,0.206,19,24,0.792,16,40,56,27,5,11,18,21,39,60,0.65,1
46,97,0.474,12,41,0.293,8,12,0.667,13,43,56,27,5,9,18,19,34,56,0.6071428571428571,0
43,94,0.457,19,40,0.475,17,21,0.81,7,34,41,28,8,4,6,15,24,54,0.4444444444444444,1
47,87,0.54,14,31,0.452,19,23,0.826,13,29,42,29,12,7,14,22,33,56,0.5892857142857143,1
38,85,0.447,14,41,0.341,27,33,0.818,11,27,38,29,8,2,14,18,24,44,0.5454545454545454,0
37,75,0.493,12,25,0.48,17,21,0.81,8,36,44,25,8,5,22,21,25,50,0.5,0
38,102,0.373,9,30,0.3,21,25,0.84,21,24,45,24,11,2,10,19,29,72,0.4027777777777778,1
43,87,0.494,7,23,0.304,29,33,0.879,12,24,36,27,8,4,17,17,36,64,0.5625,0
55,91,0.604,23,38,0.605,13,19,0.684,12,25,37,32,12,6,12,23,32,53,0.6037735849056604,1
43,94,0.457,11,27,0.407,17,24,0.708,12,33,45,24,7,6,12,19,32,67,0.47761194029850745,1
42,94,0.447,12,35,0.343,17,18,0.944,11,38,49,25,5,4,13,23,30,59,0.5084745762711864,0
39,90,0.433,10,37,0.27,12,12,1.0,12,30,42,25,9,9,17,24,29,53,0.5471698113207547,0
38,90,0.422,12,25,0.48,23,29,0.793,21,36,57,23,6,6,16,16,26,65,0.4,1
41,84,0.488,2,23,0.087,27,37,0.73,7,29,36,22,10,6,11,21,39,61,0.639344262295082,0
46,86,0.535,14,34,0.412,15,20,0.75,10,35,45,29,5,2,17,27,32,52,0.6153846153846154,1
35,87,0.402,12,33,0.364,15,18,0.833,11,32,43,22,6,3,19,20,23,54,0.42592592592592593,0
56,101,0.554,22,49,0.449,13,19,0.684,11,36,47,37,11,5,8,14,34,52,0.6538461538461539,1
47,91,0.516,11,26,0.423,11,14,0.786,9,37,46,26,10,8,14,9,36,65,0.5538461538461539,1
41,91,0.451,11,35,0.314,9,9,1.0,8,34,42,30,9,6,17,17,30,56,0.5357142857142857,0
39,95,0.411,16,46,0.348,12,16,0.75,11,29,40,22,8,3,10,30,23,49,0.46938775510204084,0
36,86,0.419,10,34,0.294,28,33,0.848,15,35,50,20,4,3,17,19,26,52,0.5,1
37,87,0.425,8,29,0.276,19,24,0.792,4,26,30,22,14,10,9,21,29,58,0.5,0
40,83,0.482,15,33,0.455,15,22,0.682,10,43,53,28,6,5,21,16,25,50,0.5,1
41,98,0.418,12,31,0.387,8,9,0.889,14,32,46,29,7,5,11,20,29,67,0.43283582089552236,0
40,87,0.46,12,27,0.444,19,25,0.76,13,38,51,21,7,9,11,14,28,60,0.4666666666666667,1
38,101,0.376,8,36,0.222,10,15,0.667,13,36,49,23,7,4,12,17,30,65,0.46153846153846156,0
36,87,0.414,12,40,0.3,18,21,0.857,11,44,55,20,4,10,14,16,24,47,0.5106382978723404,1
41,89,0.461,14,38,0.368,16,19,0.842,8,36,44,33,5,4,7,18,27,51,0.5294117647058824,1
37,86,0.43,14,37,0.378,15,17,0.882,8,38,46,29,3,8,14,18,23,49,0.46938775510204084,0
47,92,0.511,8,27,0.296,29,34,0.853,11,32,43,29,7,2,11,14,39,65,0.6,1
52,92,0.565,14,35,0.4,8,8,1.0,2,30,32,39,8,6,11,22,38,57,0.6666666666666666,0
34,95,0.358,7,31,0.226,14,20,0.7,12,30,42,22,7,5,12,21,27,64,0.421875,0
47,86,0.547,17,35,0.486,22,29,0.759,11,48,59,31,6,4,15,16,30,51,0.5882352941176471,1
50,102,0.49,7,33,0.212,21,25,0.84,15,36,51,30,9,8,10,21,43,69,0.6231884057971014,1
43,96,0.448,12,33,0.364,21,28,0.75,12,34,46,19,3,9,12,17,31,63,0.49206349206349204,0
44,88,0.5,15,37,0.405,20,27,0.741,12,32,44,28,4,3,14,20,29,51,0.5686274509803921,0
48,91,0.527,19,47,0.404,18,21,0.857,8,26,34,24,8,5,8,19,29,44,0.6590909090909091,1
38,91,0.418,6,33,0.182,15,21,0.714,12,29,41,19,4,7,16,19,32,58,0.5517241379310345,0
50,104,0.481,10,33,0.303,14,18,0.778,18,37,55,27,8,8,11,18,40,71,0.5633802816901409,1
47,93,0.505,6,32,0.188,16,21,0.762,14,28,42,32,7,2,14,21,41,61,0.6721311475409836,0
44,79,0.557,13,25,0.52,18,20,0.9,7,24,31,30,7,4,16,15,31,54,0.5740740740740741,1
35,82,0.427,13,39,0.333,31,42,0.738,11,36,47,21,3,3,10,20,22,43,0.5116279069767442,1
38,90,0.422,10,28,0.357,20,27,0.741,12,35,47,22,4,5,10,24,28,62,0.45161290322580644,0
44,88,0.5,15,38,0.395,24,26,0.923,15,39,54,30,4,8,13,17,29,50,0.58,1
37,86,0.43,15,35,0.429,14,19,0.737,8,20,28,24,7,4,10,23,22,51,0.43137254901960786,0
40,87,0.46,14,38,0.368,17,26,0.654,12,39,51,21,13,2,13,17,26,49,0.5306122448979592,1
37,86,0.43,15,42,0.357,10,15,0.667,7,30,37,23,5,5,18,23,22,44,0.5,0
49,104,0.471,19,48,0.396,19,23,0.826,24,36,60,29,3,2,29,28,30,56,0.5357142857142857,0
51,98,0.52,5,29,0.172,31,36,0.861,11,28,39,15,17,7,11,22,46,69,0.6666666666666666,1
34,81,0.42,6,30,0.2,17,24,0.708,8,30,38,17,3,2,16,17,28,51,0.5490196078431373,0
49,89,0.551,10,26,0.385,15,19,0.789,6,39,45,26,5,4,10,20,39,63,0.6190476190476191,1
41,104,0.394,13,39,0.333,19,21,0.905,23,32,55,20,3,4,14,23,28,65,0.4307692307692308,0
42,87,0.483,11,30,0.367,30,37,0.811,14,34,48,24,6,8,11,14,31,57,0.543859649122807,1
42,92,0.457,14,39,0.359,16,20,0.8,15,35,50,25,7,0,13,22,28,53,0.5283018867924528,1
40,83,0.482,11,32,0.344,15,23,0.652,8,32,40,26,8,5,11,19,29,51,0.5686274509803921,0
47,91,0.516,12,39,0.308,19,22,0.864,9,33,42,26,8,5,15,23,35,52,0.6730769230769231,1
39,105,0.371,18,53,0.34,16,18,0.889,18,30,48,20,9,1,15,24,21,52,0.40384615384615385,0
47,102,0.461,13,28,0.464,14,24,0.583,24,32,56,27,9,2,8,19,34,74,0.4594594594594595,1
39,83,0.47,17,42,0.405,17,20,0.85,10,34,44,35,4,9,13,20,22,41,0.5365853658536586,0
43,88,0.489,15,34,0.441,16,21,0.762,11,29,40,23,8,9,14,18,28,54,0.5185185185185185,1
38,84,0.452,9,31,0.29,18,24,0.75,8,32,40,23,10,10,16,17,29,53,0.5471698113207547,0
35,95,0.368,10,41,0.244,29,33,0.879,9,23,32,27,10,7,9,33,25,54,0.46296296296296297,0
47,88,0.534,2,13,0.154,27,35,0.771,12,43,55,25,5,10,18,25,45,75,0.6,1
47,88,0.534,12,29,0.414,23,29,0.793,14,35,49,29,9,8,16,19,35,59,0.5932203389830508,1
44,96,0.458,17,44,0.386,17,18,0.944,13,22,35,25,9,2,10,21,27,52,0.5192307692307693,0
37,77,0.481,15,35,0.429,27,34,0.794,8,35,43,31,7,3,11,22,22,42,0.5238095238095238,1
40,84,0.476,17,41,0.415,17,22,0.773,6,25,31,31,3,2,11,22,23,43,0.5348837209302325,0
52,92,0.565,13,31,0.419,14,19,0.737,11,32,43,33,8,5,18,20,39,61,0.639344262295082,1
45,81,0.556,10,29,0.345,23,30,0.767,6,24,30,26,11,4,15,18,35,52,0.6730769230769231,0
31,87,0.356,5,41,0.122,15,22,0.682,9,42,51,20,9,5,17,14,26,46,0.5652173913043478,0
32,93,0.344,12,39,0.308,17,20,0.85,15,45,60,20,7,2,16,18,20,54,0.37037037037037035,1
43,90,0.478,19,40,0.475,22,26,0.846,11,25,36,25,5,4,12,21,24,50,0.48,0
49,89,0.551,13,34,0.382,21,22,0.955,9,26,35,33,7,9,9,20,36,55,0.6545454545454545,1
43,86,0.5,17,40,0.425,17,19,0.895,10,33,43,27,8,9,17,17,26,46,0.5652173913043478,1
41,89,0.461,18,44,0.409,13,16,0.813,10,28,38,26,9,5,18,19,23,45,0.5111111111111111,0
47,114,0.412,15,34,0.441,20,25,0.8,18,33,51,25,3,4,6,27,32,80,0.4,0
44,86,0.512,15,37,0.405,30,37,0.811,6,42,48,34,5,4,11,21,29,49,0.5918367346938775,1
40,91,0.44,13,36,0.361,14,19,0.737,11,36,47,26,5,3,14,28,27,55,0.4909090909090909,0
40,82,0.488,10,27,0.37,31,40,0.775,10,37,47,27,7,7,14,20,30,55,0.5454545454545454,1
47,96,0.49,14,39,0.359,22,30,0.733,17,21,38,32,12,0,10,21,33,57,0.5789473684210527,0
52,86,0.605,17,29,0.586,15,23,0.652,14,28,42,36,5,3,15,22,35,57,0.6140350877192983,1
44,92,0.478,12,38,0.316,20,21,0.952,9,32,41,32,9,9,17,21,32,54,0.5925925925925926,0
50,96,0.521,18,38,0.474,16,17,0.941,7,32,39,35,9,7,12,17,32,58,0.5517241379310345,1
30,85,0.353,9,40,0.225,25,33,0.758,18,30,48,15,10,3,14,23,21,45,0.4666666666666667,0
39,84,0.464,7,26,0.269,19,25,0.76,12,31,43,22,7,8,14,22,32,58,0.5517241379310345,1
36,85,0.424,9,31,0.29,20,31,0.645,13,31,44,21,5,2,22,19,27,54,0.5,0
52,95,0.547,20,46,0.435,22,25,0.88,9,38,47,37,14,6,14,27,32,49,0.6530612244897959,1
42,88,0.477,14,29,0.483,20,21,0.952,10,31,41,24,4,6,13,13,28,59,0.4745762711864407,0
48,94,0.511,25,45,0.556,10,14,0.714,10,33,43,38,4,3,13,24,23,49,0.46938775510204084,1
44,92,0.478,19,45,0.422,6,9,0.667,6,29,35,27,6,4,13,18,25,47,0.5319148936170213,0
38,84,0.452,18,44,0.409,26,26,1.0,12,33,45,23,9,9,15,13,20,40,0.5,1
39,83,0.47,14,30,0.467,22,32,0.688,15,31,46,28,4,4,11,20,25,53,0.4716981132075472,1
36,86,0.419,13,40,0.325,21,23,0.913,11,30,41,26,6,9,14,22,23,46,0.5,0
49,91,0.538,15,29,0.517,12,18,0.667,10,30,40,34,4,4,15,20,34,62,0.5483870967741935,0
44,89,0.494,21,43,0.488,18,21,0.857,12,24,36,28,7,5,10,17,23,46,0.5,1
36,86,0.419,10,37,0.27,17,24,0.708,7,31,38,27,8,2,14,19,26,49,0.5306122448979592,0
44,84,0.524,11,29,0.379,20,21,0.952,6,43,49,21,7,2,17,17,33,55,0.6,1
41,92,0.446,16,46,0.348,18,27,0.667,13,38,51,26,9,1,15,28,25,46,0.5434782608695652,0
38,84,0.452,14,39,0.359,29,34,0.853,7,34,41,27,8,7,15,22,24,45,0.5333333333333333,1
45,87,0.517,11,30,0.367,28,34,0.824,10,43,53,28,6,4,11,20,34,57,0.5964912280701754,1
39,88,0.443,10,33,0.303,23,30,0.767,6,29,35,24,6,3,10,22,29,55,0.5272727272727272,0
35,82,0.427,10,38,0.263,24,34,0.706,5,34,39,25,7,4,11,30,25,44,0.5681818181818182,0
39,86,0.453,12,32,0.375,27,37,0.73,15,43,58,23,6,3,19,28,27,54,0.5,1
41,77,0.532,12,31,0.387,10,11,0.909,4,27,31,27,11,5,21,18,29,46,0.6304347826086957,0
41,86,0.477,15,30,0.5,18,19,0.947,17,30,47,29,10,3,23,12,26,56,0.4642857142857143,1
45,100,0.45,11,36,0.306,25,32,0.781,16,29,45,30,7,6,18,32,34,64,0.53125,0
48,89,0.539,7,27,0.259,37,48,0.771,12,31,43,27,8,8,16,24,41,62,0.6612903225806451,1
41,89,0.461,15,41,0.366,19,24,0.792,10,26,36,24,9,4,7,17,26,48,0.5416666666666666,1
40,84,0.476,9,28,0.321,23,27,0.852,14,35,49,28,5,4,12,20,31,56,0.5535714285714286,0
49,91,0.538,14,35,0.4,10,17,0.588,5,41,46,31,14,4,16,16,35,56,0.625,1
45,96,0.469,16,37,0.432,13,18,0.722,10,36,46,28,8,6,17,16,29,59,0.4915254237288136,0
48,100,0.48,18,41,0.439,14,19,0.737,13,29,42,32,9,8,7,18,30,59,0.5084745762711864,0
50,87,0.575,18,34,0.529,17,24,0.708,9,38,47,39,3,9,15,18,32,53,0.6037735849056604,1
41,94,0.436,9,39,0.231,22,32,0.688,14,32,46,21,10,4,11,21,32,55,0.5818181818181818,0
43,98,0.439,16,42,0.381,15,21,0.714,15,38,53,31,5,4,16,27,27,56,0.48214285714285715,1
50,96,0.521,16,34,0.471,26,30,0.867,10,36,46,30,11,3,10,17,34,62,0.5483870967741935,1
42,82,0.512,19,44,0.432,19,24,0.792,3,30,33,28,7,6,15,16,23,38,0.6052631578947368,0
40,83,0.482,11,33,0.333,16,17,0.941,9,30,39,21,7,1,16,18,29,50,0.58,0
43,85,0.506,13,36,0.361,17,20,0.85,13,31,44,22,7,8,13,15,30,49,0.6122448979591837,1
44,88,0.5,14,31,0.452,17,25,0.68,12,33,45,30,9,4,17,19,30,57,0.5263157894736842,1
39,83,0.47,7,32,0.219,16,18,0.889,4,30,34,21,6,2,16,19,32,51,0.6274509803921569,0
39,95,0.411,8,30,0.267,15,20,0.75,18,35,53,28,5,4,16,23,31,65,0.47692307692307695,0
47,99,0.475,12,36,0.333,18,21,0.857,12,36,48,31,13,6,9,15,35,63,0.5555555555555556,1
40,92,0.435,16,45,0.356,17,19,0.895,16,27,43,22,8,2,13,24,24,47,0.5106382978723404,0
41,81,0.506,13,32,0.406,26,30,0.867,10,30,40,27,6,9,14,20,28,49,0.5714285714285714,1
45,93,0.484,14,36,0.389,20,30,0.667,11,32,43,32,8,2,5,23,31,57,0.543859649122807,1
37,80,0.463,15,34,0.441,27,35,0.771,8,34,42,26,2,1,11,20,22,46,0.4782608695652174,0
49,92,0.533,11,33,0.333,13,14,0.929,13,32,45,27,9,9,11,14,38,59,0.6440677966101694,1
43,103,0.417,16,45,0.356,12,18,0.667,21,28,49,30,9,4,11,12,27,58,0.46551724137931033,0
44,102,0.431,11,36,0.306,24,27,0.889,16,28,44,26,8,7,14,25,33,66,0.5,0
47,95,0.495,18,45,0.4,16,21,0.762,11,36,47,32,6,4,17,22,29,50,0.58,1
42,87,0.483,14,35,0.4,13,18,0.722,13,32,45,25,5,2,21,22,28,52,0.5384615384615384,0
48,92,0.522,18,42,0.429,14,20,0.7,9,25,34,31,14,7,11,22,30,50,0.6,1
38,80,0.475,9,27,0.333,27,32,0.844,11,38,49,24,4,5,16,17,29,53,0.5471698113207547,1
41,92,0.446,9,31,0.29,16,21,0.762,8,31,39,18,7,4,8,24,32,61,0.5245901639344263,0
32,88,0.364,11,29,0.379,28,32,0.875,15,36,51,18,10,10,11,19,21,59,0.3559322033898305,1
37,92,0.402,11,40,0.275,11,15,0.733,13,35,48,19,4,8,18,24,26,52,0.5,0
35,81,0.432,4,21,0.19,18,23,0.783,7,35,42,19,3,7,21,25,31,60,0.5166666666666667,0
41,98,0.418,14,37,0.378,28,31,0.903,16,38,54,24,17,8,12,23,27,61,0.4426229508196721,1
49,82,0.598,17,29,0.586,24,28,0.857,9,29,38,28,9,5,11,20,32,53,0.6037735849056604,1
47,90,0.522,11,28,0.393,17,21,0.81,10,23,33,30,4,3,12,17,36,62,0.5806451612903226,0
43,89,0.483,11,36,0.306,18,28,0.643,9,34,43,32,5,5,6,15,32,53,0.6037735849056604,0
47,95,0.495,18,42,0.429,17,19,0.895,9,36,45,35,5,5,9,19,29,53,0.5471698113207547,1
52,101,0.515,16,41,0.39,5,6,0.833,16,39,55,34,4,4,14,19,36,60,0.6,1
40,77,0.519,10,31,0.323,14,25,0.56,3,29,32,30,8,6,14,19,30,46,0.6521739130434783,0
48,107,0.449,15,40,0.375,12,16,0.75,13,28,41,35,7,8,15,25,33,67,0.4925373134328358,0
52,92,0.565,13,27,0.481,20,26,0.769,8,39,47,36,7,8,19,18,39,65,0.6,1
53,88,0.602,14,31,0.452,15,17,0.882,5,40,45,30,10,6,10,17,39,57,0.6842105263157895,1
33,91,0.363,7,35,0.2,9,11,0.818,8,28,36,15,3,4,13,14,26,56,0.4642857142857143,0
41,85,0.482,15,36,0.417,22,25,0.88,6,28,34,21,5,4,11,21,26,49,0.5306122448979592,0
49,101,0.485,16,42,0.381,13,15,0.867,18,31,49,32,8,3,11,22,33,59,0.559322033898305,1
43,84,0.512,7,21,0.333,25,30,0.833,9,31,40,22,4,9,11,19,36,63,0.5714285714285714,1
42,93,0.452,12,32,0.375,21,24,0.875,16,30,46,30,5,0,9,22,30,61,0.4918032786885246,0
45,93,0.484,17,43,0.395,13,15,0.867,14,28,42,31,6,8,16,21,28,50,0.56,0
44,91,0.484,17,32,0.531,19,20,0.95,13,29,42,29,7,5,14,15,27,59,0.4576271186440678,1
44,94,0.468,11,35,0.314,23,26,0.885,12,27,39,20,7,4,10,22,33,59,0.559322033898305,0
50,88,0.568,16,33,0.485,28,34,0.824,8,34,42,36,8,6,9,21,34,55,0.6181818181818182,1
37,77,0.481,16,38,0.421,26,29,0.897,11,29,40,25,8,4,15,19,21,39,0.5384615384615384,0
43,83,0.518,13,35,0.371,19,25,0.76,8,23,31,26,7,2,10,19,30,48,0.625,1
43,96,0.448,6,28,0.214,22,26,0.846,10,26,36,25,10,4,8,23,37,68,0.5441176470588235,0
50,88,0.568,19,42,0.452,27,32,0.844,8,41,49,24,5,8,15,24,31,46,0.6739130434782609,1
45,90,0.5,6,21,0.286,13,16,0.813,13,27,40,25,10,6,15,15,39,69,0.5652173913043478,0
48,86,0.558,18,30,0.6,13,16,0.813,8,28,36,33,10,4,15,16,30,56,0.5357142857142857,1
48,97,0.495,16,47,0.34,19,21,0.905,11,36,47,27,7,2,13,17,32,50,0.64,1
47,94,0.5,7,32,0.219,19,22,0.864,10,34,44,17,8,2,11,21,40,62,0.6451612903225806,0
38,86,0.442,12,37,0.324,16,21,0.762,9,28,37,28,8,3,13,12,26,49,0.5306122448979592,0
46,85,0.541,22,45,0.489,11,15,0.733,8,37,45,36,6,2,18,17,24,40,0.6,1
34,89,0.382,11,36,0.306,18,24,0.75,10,33,43,18,7,4,9,16,23,53,0.4339622641509434,0
45,95,0.474,17,36,0.472,7,8,0.875,10,45,55,18,4,10,14,19,28,59,0.4745762711864407,1
45,85,0.529,11,27,0.407,18,21,0.857,6,25,31,26,8,4,10,21,34,58,0.5862068965517241,0
45,90,0.5,13,36,0.361,25,32,0.781,16,30,46,25,4,1,17,23,32,54,0.5925925925925926,1
39,95,0.411,14,46,0.304,16,20,0.8,10,34,44,24,8,6,10,25,25,49,0.5102040816326531,0
41,90,0.456,7,31,0.226,23,30,0.767,13,41,54,29,8,6,17,16,34,59,0.576271186440678,1
46,87,0.529,13,38,0.342,13,19,0.684,11,32,43,31,10,4,14,20,33,49,0.673469387755102,1
40,85,0.471,13,35,0.371,21,23,0.913,9,28,37,23,10,4,14,20,27,50,0.54,0
55,98,0.561,22,42,0.524,14,22,0.636,11,40,51,38,11,3,15,19,33,56,0.5892857142857143,1
40,94,0.426,15,42,0.357,15,21,0.714,9,30,39,29,6,6,13,15,25,52,0.4807692307692308,0
48,94,0.511,9,22,0.409,19,27,0.704,12,24,36,23,7,3,13,26,39,72,0.5416666666666666,0
46,85,0.541,16,36,0.444,22,27,0.815,11,29,40,25,6,10,18,24,30,49,0.6122448979591837,1
47,102,0.461,12,33,0.364,24,27,0.889,15,32,47,34,9,5,14,32,35,69,0.5072463768115942,0
47,97,0.485,19,48,0.396,22,34,0.647,14,24,38,29,7,8,12,25,28,49,0.5714285714285714,1
41,92,0.446,13,38,0.342,9,19,0.474,15,28,43,19,2,0,11,20,28,54,0.5185185185185185,0
49,87,0.563,14,26,0.538,18,22,0.818,9,37,46,29,7,4,9,19,35,61,0.5737704918032787,1
56,98,0.571,19,38,0.5,20,23,0.87,14,32,46,26,4,9,11,19,37,60,0.6166666666666667,1
49,95,0.516,12,33,0.364,17,21,0.81,11,23,34,38,6,7,11,21,37,62,0.5967741935483871,0
42,88,0.477,10,30,0.333,20,23,0.87,11,41,52,21,5,6,16,16,32,58,0.5517241379310345,1
42,99,0.424,13,41,0.317,12,13,0.923,9,32,41,29,9,3,10,17,29,58,0.5,0
42,85,0.494,11,29,0.379,17,19,0.895,12,33,45,27,10,9,14,19,31,56,0.5535714285714286,1
41,87,0.471,11,30,0.367,15,18,0.833,9,31,40,27,10,4,15,18,30,57,0.5263157894736842,0
30,85,0.353,19,54,0.352,18,21,0.857,7,38,45,25,6,3,22,19,11,31,0.3548387096774194,0
42,92,0.457,11,36,0.306,21,23,0.913,10,43,53,31,11,10,12,18,31,56,0.5535714285714286,1
42,89,0.472,12,29,0.414,12,15,0.8,11,34,45,24,7,9,10,15,30,60,0.5,1
38,88,0.432,11,32,0.344,17,19,0.895,9,35,44,23,8,8,12,17,27,56,0.48214285714285715,0
44,85,0.518,18,38,0.474,25,30,0.833,5,34,39,26,3,6,12,21,26,47,0.5531914893617021,0
53,100,0.53,17,43,0.395,20,26,0.769,9,33,42,35,8,5,7,24,36,57,0.631578947368421,1
39,89,0.438,8,32,0.25,13,13,1.0,10,26,36,18,8,6,13,19,31,57,0.543859649122807,0
44,86,0.512,8,29,0.276,18,22,0.818,15,36,51,30,4,4,19,16,36,57,0.631578947368421,1
39,90,0.433,16,39,0.41,14,20,0.7,11,25,36,25,4,9,14,17,23,51,0.45098039215686275,0
45,91,0.495,14,34,0.412,21,24,0.875,12,39,51,30,6,8,14,20,31,57,0.543859649122807,1
47,114,0.412,17,58,0.293,15,17,0.882,18,37,55,28,6,5,8,13,30,56,0.5357142857142857,0
50,109,0.459,20,50,0.4,12,14,0.857,18,41,59,29,4,5,10,15,30,59,0.5084745762711864,1
46,96,0.479,9,30,0.3,18,21,0.857,8,44,52,27,4,4,16,17,37,66,0.5606060606060606,0
50,106,0.472,18,49,0.367,14,18,0.778,11,36,47,34,11,7,7,15,32,57,0.5614035087719298,1
41,82,0.5,10,31,0.323,23,29,0.793,13,29,42,19,5,7,18,19,31,51,0.6078431372549019,1
40,85,0.471,11,25,0.44,22,24,0.917,11,28,39,23,4,3,11,23,29,60,0.48333333333333334,0
42,94,0.447,5,23,0.217,15,21,0.714,14,33,47,23,10,6,15,15,37,71,0.5211267605633803,0
39,87,0.448,14,28,0.5,17,19,0.895,10,32,42,23,8,4,17,18,25,59,0.423728813559322,1
44,95,0.463,13,33,0.394,20,25,0.8,12,42,54,24,8,7,11,15,31,62,0.5,1
37,101,0.366,15,47,0.319,13,17,0.765,17,32,49,25,6,9,11,20,22,54,0.4074074074074074,0
42,94,0.447,12,37,0.324,12,15,0.8,8,32,40,27,7,7,14,11,30,57,0.5263157894736842,0
48,88,0.545,18,34,0.529,10,11,0.909,7,41,48,25,7,6,16,15,30,54,0.5555555555555556,1
40,78,0.513,13,30,0.433,23,28,0.821,6,32,38,24,5,6,16,22,27,48,0.5625,0
45,96,0.469,23,51,0.451,11,16,0.688,14,30,44,34,8,3,12,23,22,45,0.4888888888888889,1
43,77,0.558,11,31,0.355,23,25,0.92,7,37,44,27,6,4,14,22,32,46,0.6956521739130435,1
39,91,0.429,14,43,0.326,19,27,0.704,13,23,36,23,8,3,8,19,25,48,0.5208333333333334,0
47,91,0.516,17,40,0.425,23,28,0.821,12,32,44,31,4,3,12,18,30,51,0.5882352941176471,1
44,89,0.494,16,34,0.471,23,23,1.0,8,29,37,25,4,6,9,23,28,55,0.509090909090909,0
45,95,0.474,8,31,0.258,15,19,0.789,16,21,37,23,6,0,12,18,37,64,0.578125,0
49,80,0.613,18,39,0.462,28,30,0.933,8,30,38,37,6,8,13,20,31,41,0.7560975609756098,1
40,83,0.482,15,29,0.517,20,24,0.833,10,29,39,25,6,2,11,17,25,54,0.46296296296296297,1
41,89,0.461,9,36,0.25,15,19,0.789,15,34,49,29,8,5,12,24,32,53,0.6037735849056604,0
42,82,0.512,9,25,0.36,20,24,0.833,9,30,39,22,4,2,19,22,33,57,0.5789473684210527,0
45,84,0.536,8,22,0.364,29,32,0.906,7,29,36,20,9,3,12,25,37,62,0.5967741935483871,1
51,92,0.554,22,42,0.524,20,24,0.833,14,36,50,35,6,10,9,17,29,50,0.58,1
43,91,0.473,21,44,0.477,12,23,0.522,12,25,37,29,4,8,7,15,22,47,0.46808510638297873,0
49,98,0.5,12,33,0.364,3,7,0.429,15,31,46,29,9,9,9,13,37,65,0.5692307692307692,1
43,90,0.478,9,27,0.333,9,13,0.692,10,31,41,26,3,5,11,12,34,63,0.5396825396825397,0
37,81,0.457,10,30,0.333,11,16,0.688,9,32,41,24,6,7,19,11,27,51,0.5294117647058824,0
49,90,0.544,7,28,0.25,9,11,0.818,5,31,36,24,11,5,12,18,42,62,0.6774193548387096,1
47,86,0.547,15,35,0.429,14,16,0.875,7,33,40,32,7,4,9,15,32,51,0.6274509803921569,1
41,87,0.471,17,44,0.386,5,8,0.625,6,29,35,34,4,3,12,13,24,43,0.5581395348837209,0
43,94,0.457,11,30,0.367,22,24,0.917,15,29,44,26,15,7,13,18,32,64,0.5,1
43,86,0.5,9,31,0.29,16,19,0.842,12,29,41,24,6,9,21,19,34,55,0.6181818181818182,0
38,90,0.422,18,52,0.346,9,11,0.818,12,27,39,28,12,9,17,21,20,38,0.5263157894736842,0
43,84,0.512,16,35,0.457,14,21,0.667,8,33,41,27,8,7,20,14,27,49,0.5510204081632653,1
45,99,0.455,8,33,0.242,16,23,0.696,13,32,45,26,6,9,7,23,37,66,0.5606060606060606,0
38,90,0.422,11,37,0.297,31,35,0.886,10,41,51,26,3,6,13,22,27,53,0.5094339622641509,1
41,83,0.494,10,24,0.417,19,24,0.792,7,31,38,21,6,6,18,18,31,59,0.5254237288135594,0
42,87,0.483,14,36,0.389,20,25,0.8,9,31,40,32,13,7,14,19,28,51,0.5490196078431373,1
44,93,0.473,17,43,0.395,10,12,0.833,12,28,40,23,9,5,16,18,27,50,0.54,0
51,87,0.586,16,34,0.471,16,18,0.889,6,32,38,35,9,5,12,11,35,53,0.660377358490566,1
42,84,0.5,12,30,0.4,22,32,0.688,7,30,37,26,9,6,12,17,30,54,0.5555555555555556,1
43,95,0.453,14,30,0.467,17,23,0.739,20,31,51,24,7,6,16,27,29,65,0.4461538461538462,0
45,87,0.517,11,26,0.423,21,25,0.84,8,33,41,29,6,5,6,19,34,61,0.5573770491803278,1
43,89,0.483,13,33,0.394,18,26,0.692,14,31,45,32,4,7,11,23,30,56,0.5357142857142857,0
44,97,0.454,11,35,0.314,19,24,0.792,9,30,39,25,7,4,9,16,33,62,0.532258064516129,0
47,97,0.485,18,45,0.4,17,20,0.85,14,43,57,33,5,2,12,17,29,52,0.5576923076923077,1
35,101,0.347,7,40,0.175,19,26,0.731,14,33,47,18,10,1,12,17,28,61,0.45901639344262296,0
46,95,0.484,11,38,0.289,19,23,0.826,12,51,63,21,7,3,17,22,35,57,0.6140350877192983,1
42,96,0.438,19,54,0.352,10,14,0.714,12,31,43,29,9,2,14,23,23,42,0.5476190476190477,0
40,86,0.465,17,39,0.436,25,30,0.833,12,36,48,21,7,2,17,18,23,47,0.48936170212765956,1
39,87,0.448,9,33,0.273,24,28,0.857,11,35,46,30,9,6,12,16,30,54,0.5555555555555556,0
44,83,0.53,14,31,0.452,19,21,0.905,3,35,38,34,6,6,14,21,30,52,0.5769230769230769,1
39,88,0.443,5,25,0.2,22,28,0.786,15,30,45,19,8,4,15,19,34,63,0.5396825396825397,0
44,83,0.53,12,38,0.316,20,26,0.769,7,30,37,32,7,7,14,24,32,45,0.7111111111111111,1
50,97,0.515,11,33,0.333,14,22,0.636,15,36,51,29,6,7,12,16,39,64,0.609375,1
45,96,0.469,13,43,0.302,16,20,0.8,13,28,41,28,8,5,11,22,32,53,0.6037735849056604,0
39,79,0.494,15,35,0.429,22,29,0.759,6,30,36,26,5,3,14,25,24,44,0.5454545454545454,0
45,86,0.523,10,24,0.417,26,32,0.813,7,31,38,32,10,3,12,22,35,62,0.5645161290322581,1
39,88,0.443,12,45,0.267,19,26,0.731,15,33,48,28,7,4,13,16,27,43,0.627906976744186,1
35,80,0.438,8,35,0.229,17,19,0.895,5,32,37,23,6,5,12,22,27,45,0.6,0
39,90,0.433,12,30,0.4,12,14,0.857,12,36,48,25,11,13,17,21,27,60,0.45,1
34,88,0.386,8,28,0.286,19,23,0.826,13,34,47,23,8,11,18,15,26,60,0.43333333333333335,0
44,98,0.449,14,45,0.311,17,24,0.708,8,34,42,32,9,3,10,16,30,53,0.5660377358490566,0
52,100,0.52,23,45,0.511,17,21,0.81,11,41,52,26,7,6,13,18,29,55,0.5272727272727272,1
38,84,0.452,13,35,0.371,17,25,0.68,8,22,30,26,13,3,12,20,25,49,0.5102040816326531,0
48,83,0.578,10,33,0.303,20,24,0.833,13,36,49,38,8,2,18,14,38,50,0.76,1
39,73,0.534,6,18,0.333,33,41,0.805,10,29,39,22,9,5,15,18,33,55,0.6,1
43,82,0.524,15,34,0.441,9,13,0.692,7,26,33,27,7,6,15,30,28,48,0.5833333333333334,0
49,94,0.521,25,53,0.472,22,28,0.786,15,36,51,33,4,5,10,19,24,41,0.5853658536585366,1
41,89,0.461,11,34,0.324,15,15,1.0,9,25,34,25,4,4,11,24,30,55,0.5454545454545454,0
35,82,0.427,9,29,0.31,27,35,0.771,13,31,44,21,9,2,12,20,26,53,0.49056603773584906,1
38,82,0.463,8,31,0.258,20,29,0.69,13,33,46,21,9,7,16,22,30,51,0.5882352941176471,0
48,91,0.527,16,32,0.5,18,23,0.783,12,41,53,25,4,2,14,22,32,59,0.5423728813559322,1
41,93,0.441,9,29,0.31,20,21,0.952,11,30,41,17,5,2,11,22,32,64,0.5,0
47,90,0.522,16,32,0.5,19,23,0.826,8,36,44,37,7,7,9,13,31,58,0.5344827586206896,1
46,95,0.484,13,41,0.317,15,19,0.789,11,31,42,24,6,7,9,17,33,54,0.6111111111111112,0
44,87,0.506,10,33,0.303,12,14,0.857,7,36,43,31,9,5,12,18,34,54,0.6296296296296297,1
37,85,0.435,8,33,0.242,16,21,0.762,8,32,40,23,10,2,11,20,29,52,0.5576923076923077,0
48,91,0.527,17,38,0.447,13,14,0.929,8,33,41,35,7,5,12,17,31,53,0.5849056603773585,1
45,94,0.479,13,32,0.406,16,19,0.842,12,27,39,35,7,5,11,17,32,62,0.5161290322580645,0
40,87,0.46,14,40,0.35,20,23,0.87,9,30,39,23,7,3,13,23,26,47,0.5531914893617021,0
40,82,0.488,14,34,0.412,26,32,0.813,10,33,43,25,6,4,14,17,26,48,0.5416666666666666,1
46,91,0.505,13,42,0.31,21,28,0.75,11,33,44,31,8,7,8,17,33,49,0.673469387755102,1
43,90,0.478,13,32,0.406,16,21,0.762,13,30,43,24,4,1,12,19,30,58,0.5172413793103449,0
40,94,0.426,17,45,0.378,16,25,0.64,5,31,36,23,11,4,8,22,23,49,0.46938775510204084,0
40,84,0.476,12,32,0.375,27,35,0.771,13,43,56,27,5,7,14,17,28,52,0.5384615384615384,1
45,95,0.474,13,42,0.31,19,24,0.792,17,27,44,26,7,4,11,23,32,53,0.6037735849056604,0
50,92,0.543,8,26,0.308,21,26,0.808,7,34,41,27,7,4,12,18,42,66,0.6363636363636364,1
45,84,0.536,16,44,0.364,22,30,0.733,8,30,38,28,7,6,11,20,29,40,0.725,1
40,90,0.444,14,41,0.341,20,25,0.8,14,33,47,28,5,2,16,21,26,49,0.5306122448979592,0
41,89,0.461,13,45,0.289,18,21,0.857,12,28,40,24,6,3,16,21,28,44,0.6363636363636364,0
42,92,0.457,7,25,0.28,27,31,0.871,18,30,48,23,10,2,10,17,35,67,0.5223880597014925,1
41,82,0.5,9,22,0.409,27,43,0.628,7,35,42,22,6,7,9,22,32,60,0.5333333333333333,1
40,90,0.444,9,25,0.36,23,32,0.719,16,36,52,20,6,4,14,27,31,65,0.47692307692307695,0
43,82,0.524,19,43,0.442,18,21,0.857,10,35,45,28,5,7,20,22,24,39,0.6153846153846154,1
47,97,0.485,5,24,0.208,18,22,0.818,15,29,44,19,15,2,11,16,42,73,0.5753424657534246,0
43,93,0.462,6,29,0.207,12,16,0.75,8,34,42,31,8,6,11,23,37,64,0.578125,0
40,85,0.471,14,34,0.412,19,25,0.76,11,34,45,24,7,3,13,14,26,51,0.5098039215686274,1
39,90,0.433,11,46,0.239,27,32,0.844,8,42,50,24,10,17,18,24,28,44,0.6363636363636364,1
42,97,0.433,10,31,0.323,21,33,0.636,10,36,46,18,12,6,15,26,32,66,0.48484848484848486,0
34,73,0.466,12,27,0.444,26,32,0.813,8,26,34,22,8,1,24,16,22,46,0.4782608695652174,0
49,81,0.605,18,39,0.462,13,16,0.813,3,26,29,35,9,7,15,24,31,42,0.7380952380952381,1
45,93,0.484,10,42,0.238,13,16,0.813,11,29,40,25,5,7,12,16,35,51,0.6862745098039216,0
49,98,0.5,16,40,0.4,16,20,0.8,16,30,46,28,5,5,10,17,33,58,0.5689655172413793,1
47,95,0.495,16,43,0.372,20,22,0.909,13,40,53,34,4,7,14,21,31,52,0.5961538461538461,1
44,98,0.449,16,35,0.457,14,21,0.667,13,30,43,36,8,8,9,18,28,63,0.4444444444444444,0
49,93,0.527,12,26,0.462,17,25,0.68,7,33,40,30,11,5,16,16,37,67,0.5522388059701493,1
43,87,0.494,16,42,0.381,17,21,0.81,10,37,47,27,10,8,20,21,27,45,0.6,0
52,89,0.584,23,51,0.451,17,23,0.739,8,33,41,41,6,8,10,18,29,38,0.7631578947368421,1
45,101,0.446,7,32,0.219,25,29,0.862,17,30,47,29,7,2,9,17,38,69,0.5507246376811594,0
40,92,0.435,17,43,0.395,16,23,0.696,18,39,57,33,7,4,16,21,23,49,0.46938775510204084,1
39,88,0.443,10,37,0.27,22,26,0.846,7,30,37,21,12,7,10,21,29,51,0.5686274509803921,0
47,82,0.573,14,33,0.424,21,26,0.808,8,36,44,28,4,11,19,17,33,49,0.673469387755102,1
40,96,0.417,17,41,0.415,16,22,0.727,9,24,33,20,11,3,10,21,23,55,0.41818181818181815,0
41,82,0.5,14,34,0.412,24,30,0.8,9,31,40,24,2,2,18,21,27,48,0.5625,0
49,90,0.544,14,32,0.438,17,22,0.773,3,24,27,20,6,10,4,21,35,58,0.603448275862069,1
45,96,0.469,10,28,0.357,12,17,0.706,12,36,48,14,10,8,10,19,35,68,0.5147058823529411,1
31,79,0.392,9,33,0.273,21,24,0.875,9,34,43,17,5,11,16,18,22,46,0.4782608695652174,0
52,91,0.571,15,38,0.395,13,19,0.684,14,39,53,43,12,5,20,18,37,53,0.6981132075471698,1
42,90,0.467,8,33,0.242,10,15,0.667,10,24,34,25,11,3,17,17,34,57,0.5964912280701754,0
48,101,0.475,14,43,0.326,12,19,0.632,19,38,57,27,7,4,19,21,34,58,0.5862068965517241,0
48,99,0.485,11,39,0.282,21,25,0.84,11,32,43,25,10,4,12,15,37,60,0.6166666666666667,1
43,85,0.506,19,42,0.452,15,22,0.682,6,41,47,30,6,9,14,21,24,43,0.5581395348837209,1
40,97,0.412,7,27,0.259,17,22,0.773,13,34,47,19,7,4,8,20,33,70,0.4714285714285714,0
37,89,0.416,13,35,0.371,18,25,0.72,11,25,36,23,8,5,11,13,24,54,0.4444444444444444,0
55,96,0.573,20,41,0.488,12,14,0.857,12,41,53,43,6,7,12,19,35,55,0.6363636363636364,1
44,91,0.484,10,31,0.323,16,22,0.727,10,34,44,26,6,1,10,19,34,60,0.5666666666666667,1
37,88,0.42,8,33,0.242,20,25,0.8,12,31,43,27,4,7,13,19,29,55,0.5272727272727272,0
40,85,0.471,15,33,0.455,17,28,0.607,8,35,43,29,5,5,19,14,25,52,0.4807692307692308,0
52,97,0.536,15,30,0.5,14,14,1.0,5,37,42,41,11,7,11,21,37,67,0.5522388059701493,1
40,90,0.444,14,33,0.424,16,19,0.842,13,26,39,29,9,3,18,27,26,57,0.45614035087719296,0
38,74,0.514,17,33,0.515,25,34,0.735,6,32,38,23,9,10,22,21,21,41,0.5121951219512195,1
36,85,0.424,12,39,0.308,21,25,0.84,17,25,42,27,5,3,19,15,24,46,0.5217391304347826,0
45,82,0.549,10,27,0.37,12,15,0.8,6,29,35,27,10,7,15,19,35,55,0.6363636363636364,1
41,85,0.482,10,36,0.278,26,28,0.929,7,35,42,33,9,10,11,20,31,49,0.6326530612244898,1
35,101,0.347,11,36,0.306,24,32,0.75,22,35,57,16,6,4,13,22,24,65,0.36923076923076925,0
46,89,0.517,17,45,0.378,8,15,0.533,5,33,38,35,9,3,12,20,29,44,0.6590909090909091,1
37,94,0.394,15,43,0.349,21,25,0.84,18,33,51,29,9,4,15,16,22,51,0.43137254901960786,0
44,95,0.463,17,44,0.386,13,20,0.65,9,29,38,29,10,6,5,15,27,51,0.5294117647058824,0
43,88,0.489,17,39,0.436,17,20,0.85,13,39,52,29,3,6,16,17,26,49,0.5306122448979592,1
41,80,0.513,12,29,0.414,25,28,0.893,7,36,43,26,5,6,17,15,29,51,0.5686274509803921,1
49,103,0.476,6,43,0.14,7,9,0.778,7,30,37,28,11,7,8,20,43,60,0.7166666666666667,0
46,91,0.505,12,35,0.343,15,16,0.938,10,41,51,29,10,8,12,20,34,56,0.6071428571428571,1
36,85,0.424,10,37,0.27,11,15,0.733,5,31,36,30,6,5,17,17,26,48,0.5416666666666666,0
45,86,0.523,12,33,0.364,29,33,0.879,11,19,30,22,10,5,10,21,33,53,0.6226415094339622,1
49,91,0.538,14,30,0.467,15,21,0.714,14,28,42,30,8,6,17,24,35,61,0.5737704918032787,0
38,87,0.437,13,40,0.325,17,20,0.85,3,30,33,29,10,4,12,22,25,47,0.5319148936170213,0
43,87,0.494,11,39,0.282,20,25,0.8,11,43,54,28,3,6,18,19,32,48,0.6666666666666666,1
38,86,0.442,6,30,0.2,26,29,0.897,6,34,40,22,8,4,16,30,32,56,0.5714285714285714,0
40,89,0.449,7,33,0.212,30,40,0.75,14,35,49,24,10,6,15,20,33,56,0.5892857142857143,1
44,92,0.478,23,46,0.5,8,8,1.0,8,18,26,32,5,3,6,17,21,46,0.45652173913043476,0
46,74,0.622,18,30,0.6,23,24,0.958,6,33,39,34,3,11,15,14,28,44,0.6363636363636364,1
48,94,0.511,14,33,0.424,18,25,0.72,13,29,42,31,9,3,14,19,34,61,0.5573770491803278,0
48,95,0.505,16,27,0.593,22,27,0.815,16,27,43,28,8,6,14,19,32,68,0.47058823529411764,1
39,91,0.429,9,28,0.321,17,27,0.63,18,36,54,24,5,4,10,13,30,63,0.47619047619047616,0
46,91,0.505,15,38,0.395,3,7,0.429,8,35,43,28,5,5,7,19,31,53,0.5849056603773585,1
36,92,0.391,9,38,0.237,11,15,0.733,12,24,36,24,12,5,8,22,27,54,0.5,0
40,79,0.506,7,25,0.28,18,30,0.6,12,41,53,21,5,5,17,15,33,54,0.6111111111111112,1
46,91,0.505,12,24,0.5,23,28,0.821,6,27,33,26,9,5,8,27,34,67,0.5074626865671642,0
41,82,0.5,12,28,0.429,35,40,0.875,6,35,41,29,4,4,12,22,29,54,0.5370370370370371,1
49,88,0.557,16,40,0.4,18,22,0.818,6,37,43,25,5,2,9,14,33,48,0.6875,1
47,103,0.456,19,48,0.396,9,13,0.692,16,31,47,32,8,3,11,21,28,55,0.509090909090909,0
45,95,0.474,17,37,0.459,19,27,0.704,15,27,42,24,12,2,14,19,28,58,0.4827586206896552,0
50,85,0.588,23,43,0.535,17,21,0.81,7,27,34,40,6,7,16,18,27,42,0.6428571428571429,1
37,88,0.42,7,24,0.292,25,32,0.781,8,31,39,23,12,4,10,15,30,64,0.46875,0
38,76,0.5,12,34,0.353,20,24,0.833,7,38,45,24,8,8,19,26,26,42,0.6190476190476191,1
34,78,0.436,9,31,0.29,32,40,0.8,8,38,46,20,8,8,16,24,25,47,0.5319148936170213,0
43,93,0.462,11,41,0.268,20,28,0.714,9,34,43,29,8,6,10,25,32,52,0.6153846153846154,1
47,92,0.511,16,33,0.485,13,17,0.765,9,50,59,28,2,4,13,22,31,59,0.5254237288135594,1
30,82,0.366,12,40,0.3,20,28,0.714,1,33,34,20,4,1,8,14,18,42,0.42857142857142855,0
39,82,0.476,10,32,0.313,21,25,0.84,4,31,35,26,8,10,13,15,29,50,0.58,0
45,87,0.517,17,34,0.5,22,27,0.815,12,35,47,33,9,6,13,22,28,53,0.5283018867924528,1
38,100,0.38,12,46,0.261,20,31,0.645,17,30,47,26,9,2,7,21,26,54,0.48148148148148145,0
45,83,0.542,18,33,0.545,16,20,0.8,5,41,46,31,1,6,15,24,27,50,0.54,1
42,90,0.467,12,37,0.324,11,12,0.917,8,37,45,22,2,4,15,18,30,53,0.5660377358490566,0
44,88,0.5,8,27,0.296,16,19,0.842,6,29,35,21,11,4,6,17,36,61,0.5901639344262295,1
51,95,0.537,15,42,0.357,17,22,0.773,13,44,57,29,6,7,11,12,36,53,0.6792452830188679,1
40,94,0.426,12,45,0.267,9,12,0.75,9,30,39,28,6,1,16,17,28,49,0.5714285714285714,0
47,95,0.495,12,32,0.375,24,37,0.649,12,46,58,27,5,3,12,18,35,63,0.5555555555555556,1
46,98,0.469,17,53,0.321,17,21,0.81,6,36,42,35,5,9,9,21,29,45,0.6444444444444445,0
36,86,0.419,10,26,0.385,11,16,0.688,8,37,45,24,4,5,14,15,26,60,0.43333333333333335,0
41,83,0.494,15,38,0.395,14,18,0.778,4,40,44,27,9,9,11,15,26,45,0.5777777777777777,1
40,83,0.482,13,29,0.448,20,27,0.741,10,27,37,27,3,4,18,21,27,54,0.5,0
51,91,0.56,15,35,0.429,19,24,0.792,6,33,39,34,11,1,10,19,36,56,0.6428571428571429,1
35,83,0.422,11,34,0.324,23,29,0.793,12,23,35,24,7,3,14,17,24,49,0.4897959183673469,0
47,80,0.588,14,29,0.483,13,14,0.929,6,31,37,25,10,3,17,20,33,51,0.6470588235294118,1
43,97,0.443,5,35,0.143,31,38,0.816,14,38,52,23,7,5,7,24,38,62,0.6129032258064516,1
41,93,0.441,10,40,0.25,21,26,0.808,8,38,46,27,4,8,11,26,31,53,0.5849056603773585,0
36,76,0.474,11,28,0.393,23,29,0.793,4,30,34,19,6,4,14,22,25,48,0.5208333333333334,0
39,89,0.438,12,34,0.353,22,28,0.786,16,33,49,23,7,4,15,24,27,55,0.4909090909090909,1
33,80,0.413,8,30,0.267,14,19,0.737,6,30,36,21,6,10,19,19,25,50,0.5,0
38,80,0.475,11,29,0.379,22,33,0.667,9,38,47,24,10,5,16,20,27,51,0.5294117647058824,1
43,89,0.483,12,36,0.333,23,26,0.885,6,37,43,25,9,2,9,29,31,53,0.5849056603773585,0
42,87,0.483,11,30,0.367,29,40,0.725,10,37,47,25,5,4,11,22,31,57,0.543859649122807,1
37,93,0.398,11,40,0.275,5,10,0.5,8,33,41,28,6,5,16,15,26,53,0.49056603773584906,0
49,96,0.51,12,44,0.273,17,18,0.944,7,46,53,37,9,6,13,15,37,52,0.7115384615384616,1
41,92,0.446,14,36,0.389,19,23,0.826,16,25,41,19,8,4,18,24,27,56,0.48214285714285715,0
42,78,0.538,13,35,0.371,24,37,0.649,9,27,36,23,9,6,12,19,29,43,0.6744186046511628,1
36,85,0.424,10,31,0.323,16,23,0.696,6,34,40,21,6,8,16,24,26,54,0.48148148148148145,0
37,80,0.463,12,38,0.316,20,25,0.8,8,38,46,24,5,8,15,23,25,42,0.5952380952380952,1
35,98,0.357,11,43,0.256,4,8,0.5,18,25,43,26,7,4,15,13,24,55,0.43636363636363634,0
41,88,0.466,16,39,0.41,14,18,0.778,17,36,53,23,10,9,17,12,25,49,0.5102040816326531,1
42,92,0.457,15,40,0.375,24,29,0.828,17,30,47,33,7,10,14,15,27,52,0.5192307692307693,0
48,91,0.527,18,40,0.45,13,17,0.765,10,28,38,34,7,10,12,22,30,51,0.5882352941176471,1
37,96,0.385,7,37,0.189,16,23,0.696,19,32,51,17,9,7,18,21,30,59,0.5084745762711864,0
38,80,0.475,12,30,0.4,22,30,0.733,6,37,43,28,9,6,19,22,26,50,0.52,1
42,82,0.512,12,34,0.353,15,19,0.789,4,31,35,23,8,10,15,15,30,48,0.625,1
40,92,0.435,14,36,0.389,10,17,0.588,15,33,48,23,8,2,21,23,26,56,0.4642857142857143,0
50,91,0.549,18,36,0.5,20,26,0.769,9,28,37,30,10,1,13,23,32,55,0.5818181818181818,0
48,95,0.505,14,39,0.359,31,33,0.939,15,34,49,30,8,5,13,21,34,56,0.6071428571428571,1
42,101,0.416,12,35,0.343,5,11,0.455,12,24,36,22,8,5,8,14,30,66,0.45454545454545453,0
54,101,0.535,20,42,0.476,12,16,0.75,18,44,62,37,5,8,11,13,34,59,0.576271186440678,1
34,87,0.391,13,40,0.325,16,22,0.727,10,36,46,23,4,3,22,34,21,47,0.44680851063829785,0
42,84,0.5,13,30,0.433,29,41,0.707,7,36,43,25,12,7,12,18,29,54,0.5370370370370371,1
36,93,0.387,13,44,0.295,16,26,0.615,15,35,50,25,11,6,10,19,23,49,0.46938775510204084,0
37,76,0.487,19,39,0.487,19,27,0.704,5,43,48,27,5,4,16,19,18,37,0.4864864864864865,1
46,92,0.5,14,37,0.378,24,32,0.75,10,32,42,30,6,4,13,25,32,55,0.5818181818181818,0
50,90,0.556,14,35,0.4,28,34,0.824,7,37,44,34,7,5,11,27,36,55,0.6545454545454545,1
41,93,0.441,16,42,0.381,12,17,0.706,7,32,39,30,14,3,10,23,25,51,0.49019607843137253,1
35,83,0.422,4,30,0.133,22,24,0.917,9,41,50,29,3,6,22,14,31,53,0.5849056603773585,0
41,85,0.482,12,26,0.462,22,27,0.815,7,39,46,25,5,6,12,20,29,59,0.4915254237288136,1
40,94,0.426,15,42,0.357,16,19,0.842,9,34,43,25,7,5,10,19,25,52,0.4807692307692308,0
45,81,0.556,12,26,0.462,15,17,0.882,9,32,41,30,7,5,14,24,33,55,0.6,1
37,82,0.451,10,31,0.323,22,27,0.815,8,20,28,26,7,6,13,13,27,51,0.5294117647058824,0
37,89,0.416,13,32,0.406,13,16,0.813,11,28,39,24,9,7,11,17,24,57,0.42105263157894735,0
46,89,0.517,15,38,0.395,9,11,0.818,13,39,52,29,6,7,16,17,31,51,0.6078431372549019,1
42,76,0.553,18,34,0.529,29,32,0.906,10,26,36,25,9,5,14,18,24,42,0.5714285714285714,1
42,79,0.532,15,35,0.429,23,26,0.885,10,22,32,23,9,2,17,23,27,44,0.6136363636363636,0
44,90,0.489,25,44,0.568,22,27,0.815,7,32,39,33,10,7,21,30,19,46,0.41304347826086957,0
51,105,0.486,15,40,0.375,21,31,0.677,18,40,58,36,9,3,21,21,36,65,0.5538461538461539,1
56,105,0.533,19,41,0.463,17,22,0.773,16,32,48,33,5,3,17,27,37,64,0.578125,0
53,103,0.515,16,32,0.5,32,35,0.914,15,28,43,28,11,8,12,22,37,71,0.5211267605633803,1
48,85,0.565,9,26,0.346,25,29,0.862,11,25,36,28,7,4,9,15,39,59,0.6610169491525424,1
49,90,0.544,15,36,0.417,14,16,0.875,9,24,33,35,4,3,10,20,34,54,0.6296296296296297,0
49,92,0.533,12,34,0.353,15,19,0.789,8,34,42,27,5,5,14,16,37,58,0.6379310344827587,1
46,95,0.484,14,40,0.35,15,17,0.882,10,32,42,31,10,8,12,16,32,55,0.5818181818181818,0
34,94,0.362,6,34,0.176,23,34,0.676,16,41,57,23,11,2,18,24,28,60,0.4666666666666667,0
39,90,0.433,17,49,0.347,31,36,0.861,9,47,56,24,9,8,14,23,22,41,0.5365853658536586,1
45,84,0.536,9,31,0.29,16,24,0.667,7,29,36,29,8,5,13,26,36,53,0.6792452830188679,0
41,91,0.451,14,39,0.359,28,33,0.848,20,31,51,25,9,3,15,24,27,52,0.5192307692307693,1
36,89,0.404,10,34,0.294,9,12,0.75,12,30,42,20,7,1,13,20,26,55,0.4727272727272727,0
40,74,0.541,10,28,0.357,14,17,0.824,4,37,41,29,7,6,15,17,30,46,0.6521739130434783,1
35,84,0.417,9,30,0.3,11,15,0.733,7,24,31,19,12,8,17,19,26,54,0.48148148148148145,0
41,77,0.532,16,33,0.485,16,23,0.696,12,40,52,31,9,1,24,19,25,44,0.5681818181818182,1
39,95,0.411,13,40,0.325,12,17,0.706,10,32,42,27,9,3,19,15,26,55,0.4727272727272727,0
56,96,0.583,17,38,0.447,10,15,0.667,10,42,52,35,11,8,17,21,39,58,0.6724137931034483,1
41,82,0.5,17,36,0.472,23,34,0.676,11,29,40,25,9,3,15,20,24,46,0.5217391304347826,1
48,95,0.505,9,33,0.273,15,19,0.789,9,29,38,28,8,1,13,23,39,62,0.6290322580645161,0
44,98,0.449,13,44,0.295,8,10,0.8,10,30,40,25,8,9,11,23,31,54,0.5740740740740741,0
38,82,0.463,16,38,0.421,21,25,0.84,7,38,45,24,3,5,19,18,22,44,0.5,1
46,88,0.523,14,33,0.424,16,20,0.8,9,43,52,31,12,7,14,18,32,55,0.5818181818181818,1
36,90,0.4,12,32,0.375,11,15,0.733,7,31,38,18,7,2,15,15,24,58,0.41379310344827586,0
40,93,0.43,10,42,0.238,26,30,0.867,14,25,39,21,6,3,14,11,30,51,0.5882352941176471,0
60,94,0.638,19,39,0.487,11,13,0.846,8,31,39,50,12,3,16,24,41,55,0.7454545454545455,1
44,82,0.537,23,45,0.511,16,20,0.8,6,38,44,33,8,4,19,20,21,37,0.5675675675675675,1
42,85,0.494,10,28,0.357,19,27,0.704,8,27,35,26,13,3,14,14,32,57,0.5614035087719298,0
40,82,0.488,15,36,0.417,16,20,0.8,10,40,50,28,6,7,15,18,25,46,0.5434782608695652,1
33,92,0.359,12,29,0.414,17,23,0.739,14,29,43,22,9,5,9,17,21,63,0.3333333333333333,0
43,89,0.483,18,41,0.439,24,25,0.96,10,39,49,27,7,7,13,22,25,48,0.5208333333333334,1
33,81,0.407,6,23,0.261,20,27,0.741,8,30,38,22,8,9,14,18,27,58,0.46551724137931033,0
34,83,0.41,10,37,0.27,19,22,0.864,11,33,44,26,5,2,16,21,24,46,0.5217391304347826,0
44,87,0.506,14,35,0.4,11,17,0.647,9,35,44,30,13,5,11,18,30,52,0.5769230769230769,1
47,87,0.54,13,37,0.351,23,27,0.852,8,29,37,31,5,10,14,20,34,50,0.68,0
52,100,0.52,21,38,0.553,10,15,0.667,11,31,42,35,4,1,15,23,31,62,0.5,1
35,76,0.461,9,34,0.265,29,42,0.69,4,37,41,20,7,4,11,24,26,42,0.6190476190476191,0
36,83,0.434,13,34,0.382,27,32,0.844,7,39,46,22,7,2,10,24,23,49,0.46938775510204084,1
46,90,0.511,16,41,0.39,10,19,0.526,13,43,56,26,6,6,18,20,30,49,0.6122448979591837,1
38,92,0.413,8,42,0.19,17,22,0.773,10,28,38,23,12,2,9,18,30,50,0.6,0
46,80,0.575,8,30,0.267,20,24,0.833,9,39,48,30,4,4,24,18,38,50,0.76,1
42,104,0.404,7,38,0.184,18,23,0.783,15,19,34,30,12,6,6,20,35,66,0.5303030303030303,0
43,87,0.494,14,36,0.389,21,24,0.875,11,34,45,27,9,2,14,16,29,51,0.5686274509803921,1
40,85,0.471,13,37,0.351,12,20,0.6,12,33,45,33,5,3,20,20,27,48,0.5625,0
45,95,0.474,20,38,0.526,24,30,0.8,9,29,38,21,5,5,10,20,25,57,0.43859649122807015,1
46,91,0.505,14,37,0.378,21,25,0.84,9,35,44,29,7,7,16,25,32,54,0.5925925925925926,0
41,86,0.477,14,37,0.378,19,22,0.864,8,32,40,22,10,6,11,18,27,49,0.5510204081632653,0
43,88,0.489,16,43,0.372,15,21,0.714,12,32,44,27,6,3,16,16,27,45,0.6,1
41,94,0.436,13,41,0.317,13,21,0.619,18,33,51,22,6,4,13,22,28,53,0.5283018867924528,0
43,95,0.453,15,40,0.375,14,20,0.7,15,29,44,20,7,8,11,19,28,55,0.509090909090909,1
42,89,0.472,9,24,0.375,21,30,0.7,13,24,37,28,6,0,12,20,33,65,0.5076923076923077,0
47,80,0.588,10,27,0.37,27,31,0.871,6,32,38,35,6,10,14,23,37,53,0.6981132075471698,1
55,94,0.585,15,33,0.455,8,14,0.571,9,36,45,38,7,6,7,14,40,61,0.6557377049180327,1
45,100,0.45,14,46,0.304,14,15,0.933,15,28,43,30,5,4,11,11,31,54,0.5740740740740741,0
36,91,0.396,14,37,0.378,17,19,0.895,13,27,40,21,12,5,16,19,22,54,0.4074074074074074,0
42,82,0.512,11,29,0.379,11,16,0.688,8,32,40,23,9,6,19,11,31,53,0.5849056603773585,1
42,91,0.462,9,30,0.3,17,29,0.586,8,42,50,21,9,10,13,23,33,61,0.5409836065573771,0
43,98,0.439,17,41,0.415,14,22,0.636,13,44,57,25,8,3,13,24,26,57,0.45614035087719296,1
43,97,0.443,17,49,0.347,18,24,0.75,15,39,54,29,7,8,18,24,26,48,0.5416666666666666,1
46,102,0.451,8,28,0.286,15,22,0.682,16,34,50,29,5,6,12,27,38,74,0.5135135135135135,0
50,82,0.61,19,35,0.543,14,16,0.875,9,42,51,35,2,9,16,14,31,47,0.6595744680851063,1
38,91,0.418,15,45,0.333,9,12,0.75,8,17,25,28,9,2,9,12,23,46,0.5,0
45,92,0.489,9,26,0.346,20,24,0.833,12,39,51,27,7,7,14,18,36,66,0.5454545454545454,1
40,94,0.426,17,42,0.405,15,17,0.882,14,30,44,26,3,7,15,22,23,52,0.4423076923076923,0
47,90,0.522,17,35,0.486,20,29,0.69,13,29,42,26,3,8,15,20,30,55,0.5454545454545454,0
48,91,0.527,19,40,0.475,18,22,0.818,9,30,39,29,6,7,13,23,29,51,0.5686274509803921,1
38,77,0.494,10,30,0.333,25,29,0.862,5,20,25,17,6,4,14,20,28,47,0.5957446808510638,0
53,85,0.624,15,29,0.517,17,23,0.739,11,33,44,32,11,3,14,21,38,56,0.6785714285714286,1
37,88,0.42,14,41,0.341,25,28,0.893,12,30,42,20,8,4,12,31,23,47,0.48936170212765956,0
41,82,0.5,15,36,0.417,23,32,0.719,10,35,45,30,6,5,11,21,26,46,0.5652173913043478,1
47,90,0.522,20,44,0.455,18,22,0.818,10,37,47,33,6,8,11,15,27,46,0.5869565217391305,1
42,94,0.447,17,36,0.472,15,19,0.789,11,27,38,31,6,6,9,20,25,58,0.43103448275862066,0
52,88,0.591,14,28,0.5,18,24,0.75,10,30,40,37,11,7,15,21,38,60,0.6333333333333333,1
44,89,0.494,15,32,0.469,25,29,0.862,12,26,38,32,7,5,15,23,29,57,0.5087719298245614,0
44,91,0.484,14,37,0.378,18,21,0.857,18,36,54,27,7,3,17,18,30,54,0.5555555555555556,1
36,82,0.439,9,27,0.333,22,27,0.815,8,25,33,20,9,4,13,17,27,55,0.4909090909090909,0
54,94,0.574,13,33,0.394,10,14,0.714,10,34,44,39,8,6,18,21,41,61,0.6721311475409836,1
40,85,0.471,14,37,0.378,16,21,0.762,13,27,40,27,12,2,21,19,26,48,0.5416666666666666,0
53,94,0.564,17,35,0.486,8,13,0.615,5,32,37,34,8,4,12,26,36,59,0.6101694915254238,0
44,81,0.543,16,36,0.444,28,36,0.778,5,34,39,34,6,4,15,16,28,45,0.6222222222222222,1
33,86,0.384,6,29,0.207,12,18,0.667,12,31,43,19,8,7,15,17,27,57,0.47368421052631576,0
37,89,0.416,18,48,0.375,20,23,0.87,15,40,55,26,11,4,15,16,19,41,0.4634146341463415,1
43,80,0.538,12,30,0.4,15,19,0.789,5,43,48,34,8,4,18,18,31,50,0.62,1
34,94,0.362,13,42,0.31,11,18,0.611,16,30,46,20,13,5,13,22,21,52,0.40384615384615385,0
46,102,0.451,12,34,0.353,28,33,0.848,13,38,51,26,8,9,11,28,34,68,0.5,0
48,102,0.471,12,34,0.353,31,42,0.738,16,39,55,32,6,8,13,21,36,68,0.5294117647058824,1
44,95,0.463,14,34,0.412,18,20,0.9,8,39,47,22,4,6,9,27,30,61,0.4918032786885246,0
39,90,0.433,19,47,0.404,30,31,0.968,7,39,46,21,5,4,8,19,20,43,0.46511627906976744,1
48,101,0.475,11,45,0.244,12,20,0.6,9,41,50,29,9,4,14,18,37,56,0.6607142857142857,0
42,95,0.442,19,47,0.404,21,25,0.84,8,38,46,31,9,4,14,19,23,48,0.4791666666666667,1
46,89,0.517,13,35,0.371,18,23,0.783,14,39,53,24,2,8,10,15,33,54,0.6111111111111112,1
35,87,0.402,16,38,0.421,12,16,0.75,8,28,36,17,2,3,10,16,19,49,0.3877551020408163,0
49,94,0.521,9,27,0.333,23,27,0.852,10,36,46,36,7,4,5,15,40,67,0.5970149253731343,1
44,96,0.458,10,32,0.313,10,13,0.769,9,34,43,33,4,3,10,19,34,64,0.53125,0
54,94,0.574,19,40,0.475,14,19,0.737,13,34,47,37,11,7,11,19,35,54,0.6481481481481481,1
39,89,0.438,12,39,0.308,15,18,0.833,14,29,43,24,4,4,17,19,27,50,0.54,0
38,88,0.432,7,31,0.226,21,30,0.7,13,33,46,24,8,8,14,23,31,57,0.543859649122807,0
41,92,0.446,8,25,0.32,22,24,0.917,14,40,54,31,7,6,14,22,33,67,0.4925373134328358,1
46,84,0.548,12,30,0.4,16,18,0.889,7,30,37,31,4,2,15,17,34,54,0.6296296296296297,0
49,93,0.527,15,34,0.441,13,13,1.0,11,25,36,34,6,5,7,17,34,59,0.576271186440678,1
51,86,0.593,14,33,0.424,12,16,0.75,4,38,42,36,4,4,13,19,37,53,0.6981132075471698,1
41,89,0.461,15,36,0.417,23,28,0.821,8,30,38,25,8,3,10,13,26,53,0.49056603773584906,0
37,81,0.457,13,33,0.394,24,28,0.857,8,26,34,26,11,4,16,23,24,48,0.5,0
46,83,0.554,13,33,0.394,19,23,0.826,7,33,40,34,12,8,17,19,33,50,0.66,1
37,82,0.451,8,27,0.296,20,28,0.714,9,32,41,18,5,4,17,29,29,55,0.5272727272727272,0
32,82,0.39,13,44,0.295,34,43,0.791,12,35,47,16,11,6,11,24,19,38,0.5,1
44,89,0.494,14,42,0.333,22,28,0.786,13,32,45,27,7,2,16,25,30,47,0.6382978723404256,0
44,88,0.5,17,41,0.415,23,30,0.767,11,27,38,27,6,2,10,19,27,47,0.574468085106383,1
46,93,0.495,14,39,0.359,21,23,0.913,13,33,46,23,12,3,13,16,32,54,0.5925925925925926,1
40,80,0.5,13,34,0.382,16,25,0.64,7,30,37,33,8,4,18,19,27,46,0.5869565217391305,0
34,91,0.374,9,35,0.257,25,30,0.833,6,25,31,22,5,5,6,13,25,56,0.44642857142857145,0
52,92,0.565,18,42,0.429,13,16,0.813,12,42,54,34,3,6,11,22,34,50,0.68,1
28,101,0.277,11,49,0.224,10,16,0.625,13,29,42,16,8,8,10,19,17,52,0.3269230769230769,0
53,93,0.57,14,35,0.4,19,22,0.864,8,51,59,41,6,8,13,10,39,58,0.6724137931034483,1
53,79,0.671,11,18,0.611,9,12,0.75,10,35,45,41,12,9,27,21,42,61,0.6885245901639344,1
40,89,0.449,11,30,0.367,17,23,0.739,12,16,28,25,14,2,15,13,29,59,0.4915254237288136,0
49,94,0.521,20,47,0.426,22,30,0.733,13,31,44,39,7,4,5,16,29,47,0.6170212765957447,1
50,86,0.581,18,40,0.45,13,16,0.813,6,30,36,31,1,3,12,21,32,46,0.6956521739130435,0
42,89,0.472,13,33,0.394,16,22,0.727,8,27,35,30,9,3,9,10,29,56,0.5178571428571429,0
50,90,0.556,14,33,0.424,11,15,0.733,10,38,48,30,5,4,17,18,36,57,0.631578947368421,1
41,90,0.456,8,30,0.267,22,25,0.88,10,31,41,21,8,5,9,16,33,60,0.55,1
44,88,0.5,12,35,0.343,10,16,0.625,11,35,46,32,6,9,15,21,32,53,0.6037735849056604,0
49,89,0.551,15,31,0.484,15,20,0.75,11,32,43,22,9,7,12,16,34,58,0.5862068965517241,1
41,95,0.432,18,44,0.409,19,27,0.704,17,29,46,30,5,4,9,21,23,51,0.45098039215686275,0
36,82,0.439,12,40,0.3,12,20,0.6,10,28,38,26,10,8,13,20,24,42,0.5714285714285714,0
37,83,0.446,8,26,0.308,17,20,0.85,12,29,41,23,6,1,17,17,29,57,0.5087719298245614,1
30,77,0.39,10,28,0.357,23,34,0.676,10,28,38,18,8,5,20,19,20,49,0.40816326530612246,0
44,80,0.55,11,31,0.355,17,24,0.708,8,37,45,35,14,5,16,23,33,49,0.673469387755102,1
32,95,0.337,8,38,0.211,21,26,0.808,23,31,54,20,6,4,17,18,24,57,0.42105263157894735,0
40,93,0.43,15,35,0.429,17,18,0.944,14,32,46,23,11,9,14,19,25,58,0.43103448275862066,1
32,89,0.36,10,34,0.294,25,28,0.893,16,28,44,22,11,3,20,24,22,55,0.4,0
45,87,0.517,18,38,0.474,27,34,0.794,7,38,45,31,9,7,15,20,27,49,0.5510204081632653,1
35,81,0.432,17,34,0.5,26,37,0.703,8,23,31,25,5,8,13,21,18,47,0.3829787234042553,0
52,93,0.559,21,43,0.488,20,26,0.769,14,42,56,34,7,8,14,23,31,50,0.62,1
47,97,0.485,12,32,0.375,21,26,0.808,12,42,54,32,10,9,12,22,35,65,0.5384615384615384,1
32,93,0.344,11,40,0.275,24,33,0.727,16,34,50,21,9,7,16,20,21,53,0.39622641509433965,0
40,99,0.404,7,30,0.233,26,30,0.867,15,35,50,20,10,3,13,18,33,69,0.4782608695652174,0
51,95,0.537,24,47,0.511,19,25,0.76,10,40,50,26,7,8,12,21,27,48,0.5625,1
39,79,0.494,12,30,0.4,28,37,0.757,14,30,44,29,7,4,11,20,27,49,0.5510204081632653,1
37,82,0.451,15,41,0.366,19,20,0.95,9,25,34,23,6,1,12,25,22,41,0.5365853658536586,0
40,83,0.482,13,38,0.342,13,19,0.684,15,41,56,25,11,11,23,15,27,45,0.6,1
36,87,0.414,9,38,0.237,13,15,0.867,9,26,35,27,14,6,12,16,27,49,0.5510204081632653,0
47,98,0.48,15,36,0.417,9,14,0.643,12,29,41,23,5,4,8,16,32,62,0.5161290322580645,0
51,94,0.543,13,31,0.419,14,17,0.824,14,36,50,33,6,5,12,15,38,63,0.6031746031746031,1
39,84,0.464,7,35,0.2,15,24,0.625,11,39,50,21,5,8,16,22,32,49,0.6530612244897959,0
43,94,0.457,8,36,0.222,18,21,0.857,12,34,46,23,9,4,9,19,35,58,0.603448275862069,1
46,90,0.511,15,34,0.441,15,20,0.75,7,40,47,31,5,8,9,18,31,56,0.5535714285714286,1
39,95,0.411,18,46,0.391,20,23,0.87,12,35,47,26,7,4,9,19,21,49,0.42857142857142855,0
46,92,0.5,13,29,0.448,20,24,0.833,7,33,40,30,6,8,12,23,33,63,0.5238095238095238,0
42,93,0.452,12,37,0.324,36,39,0.923,13,39,52,28,7,5,10,20,30,56,0.5357142857142857,1
43,92,0.467,8,29,0.276,15,22,0.682,14,23,37,28,11,1,13,21,35,63,0.5555555555555556,0
46,71,0.648,10,20,0.5,15,23,0.652,4,36,40,31,8,3,22,18,36,51,0.7058823529411765,1
33,95,0.347,10,41,0.244,11,15,0.733,17,33,50,17,5,3,15,17,23,54,0.42592592592592593,0
40,81,0.494,11,25,0.44,13,16,0.813,4,40,44,27,6,6,14,15,29,56,0.5178571428571429,1
55,105,0.524,17,41,0.415,15,20,0.75,9,38,47,34,6,2,9,19,38,64,0.59375,0
48,92,0.522,20,43,0.465,27,32,0.844,4,36,40,31,5,3,14,22,28,49,0.5714285714285714,1
36,83,0.434,17,39,0.436,16,18,0.889,7,27,34,28,9,4,11,24,19,44,0.4318181818181818,0
38,67,0.567,13,26,0.5,20,31,0.645,6,35,41,25,8,5,19,23,25,41,0.6097560975609756,1
46,76,0.605,13,28,0.464,22,27,0.815,7,34,41,27,7,5,14,20,33,48,0.6875,1
40,89,0.449,20,42,0.476,16,22,0.727,12,24,36,23,8,1,14,21,20,47,0.425531914893617,0
38,95,0.4,11,42,0.262,12,17,0.706,9,35,44,27,10,8,18,18,27,53,0.5094339622641509,0
40,93,0.43,13,38,0.342,16,21,0.762,13,44,57,24,8,6,20,19,27,55,0.4909090909090909,1
33,87,0.379,8,31,0.258,22,25,0.88,6,48,54,22,6,4,13,16,25,56,0.44642857142857145,1
34,99,0.343,12,55,0.218,15,16,0.938,9,41,50,26,9,9,8,17,22,44,0.5,0
35,83,0.422,9,32,0.281,12,16,0.75,6,37,43,21,8,6,19,17,26,51,0.5098039215686274,0
39,95,0.411,20,57,0.351,11,11,1.0,13,35,48,28,9,3,14,14,19,38,0.5,1
41,81,0.506,7,23,0.304,31,41,0.756,8,29,37,21,9,2,10,28,34,58,0.5862068965517241,0
39,85,0.459,18,43,0.419,29,35,0.829,13,29,42,24,4,6,12,29,21,42,0.5,1
40,96,0.417,15,49,0.306,10,11,0.909,13,27,40,23,11,6,11,18,25,47,0.5319148936170213,0
44,84,0.524,8,24,0.333,16,18,0.889,8,36,44,30,7,9,17,12,36,60,0.6,1
44,90,0.489,10,31,0.323,9,10,0.9,7,38,45,28,4,6,19,25,34,59,0.576271186440678,0
32,86,0.372,20,54,0.37,32,40,0.8,11,31,42,24,13,10,13,12,12,32,0.375,1
38,85,0.447,8,29,0.276,14,21,0.667,13,33,46,26,2,3,8,20,30,56,0.5357142857142857,1
33,83,0.398,13,40,0.325,15,22,0.682,13,28,41,20,3,3,10,20,20,43,0.46511627906976744,0
44,88,0.5,8,27,0.296,19,32,0.594,16,30,46,21,7,9,13,23,36,61,0.5901639344262295,0
40,83,0.482,15,31,0.484,29,34,0.853,8,33,41,25,8,4,11,24,25,52,0.4807692307692308,1
33,82,0.402,16,39,0.41,23,25,0.92,5,48,53,20,3,7,13,16,17,43,0.3953488372093023,1
38,95,0.4,4,32,0.125,16,21,0.762,9,43,52,25,6,2,7,21,34,63,0.5396825396825397,0
38,95,0.4,9,31,0.29,20,25,0.8,18,25,43,27,9,4,14,31,29,64,0.453125,0
45,81,0.556,11,25,0.44,31,35,0.886,10,36,46,29,5,8,15,17,34,56,0.6071428571428571,1
50,90,0.556,12,31,0.387,17,23,0.739,12,40,52,30,4,10,16,13,38,59,0.6440677966101694,1
44,95,0.463,19,41,0.463,10,11,0.909,8,25,33,30,8,7,8,19,25,54,0.46296296296296297,0
42,83,0.506,16,34,0.471,17,20,0.85,9,26,35,30,5,5,12,19,26,49,0.5306122448979592,0
47,87,0.54,20,43,0.465,14,23,0.609,12,27,39,30,5,10,10,18,27,44,0.6136363636363636,1
45,89,0.506,12,29,0.414,19,25,0.76,16,30,46,23,4,3,11,19,33,60,0.55,0
43,76,0.566,15,31,0.484,25,34,0.735,5,27,32,27,6,7,8,21,28,45,0.6222222222222222,1
46,92,0.5,18,40,0.45,7,12,0.583,5,26,31,34,7,4,14,20,28,52,0.5384615384615384,0
42,85,0.494,17,37,0.459,18,20,0.9,8,38,46,32,7,6,20,15,25,48,0.5208333333333334,1
39,88,0.443,10,35,0.286,16,22,0.727,16,24,40,18,16,8,13,22,29,53,0.5471698113207547,0
39,76,0.513,8,25,0.32,20,22,0.909,10,31,41,21,8,2,23,17,31,51,0.6078431372549019,1
39,93,0.419,7,34,0.206,13,16,0.813,11,30,41,26,5,3,10,15,32,59,0.5423728813559322,0
42,90,0.467,18,38,0.474,15,19,0.789,12,42,54,22,5,6,14,15,24,52,0.46153846153846156,1
38,95,0.4,12,42,0.286,7,10,0.7,9,27,36,19,6,6,10,18,26,53,0.49056603773584906,0
55,93,0.591,12,28,0.429,13,19,0.684,11,44,55,36,5,3,11,9,43,65,0.6615384615384615,1
47,93,0.505,15,30,0.5,15,21,0.714,9,33,42,32,7,5,11,14,32,63,0.5079365079365079,1
46,89,0.517,12,31,0.387,13,19,0.684,8,32,40,30,4,7,12,18,34,58,0.5862068965517241,0
42,91,0.462,11,40,0.275,15,18,0.833,11,32,43,26,4,5,15,19,31,51,0.6078431372549019,0
49,91,0.538,12,28,0.429,17,24,0.708,9,36,45,33,8,1,11,15,37,63,0.5873015873015873,1
39,90,0.433,19,45,0.422,15,18,0.833,15,26,41,29,7,8,14,19,20,45,0.4444444444444444,0
44,88,0.5,25,47,0.532,19,23,0.826,16,34,50,32,11,3,13,14,19,41,0.4634146341463415,1
35,84,0.417,8,30,0.267,16,19,0.842,6,32,38,23,6,9,10,18,27,54,0.5,0
39,87,0.448,13,37,0.351,18,22,0.818,12,39,51,24,6,5,15,20,26,50,0.52,1
35,73,0.479,15,38,0.395,18,27,0.667,6,27,33,28,9,3,11,14,20,35,0.5714285714285714,0
42,86,0.488,9,27,0.333,12,14,0.857,10,31,41,21,2,2,13,16,33,59,0.559322033898305,1
41,90,0.456,6,28,0.214,9,12,0.75,12,25,37,24,4,5,14,13,35,62,0.5645161290322581,0
45,88,0.511,20,38,0.526,11,18,0.611,13,32,45,34,9,4,12,14,25,50,0.5,1
39,85,0.459,14,34,0.412,11,17,0.647,8,26,34,22,9,4,15,23,25,51,0.49019607843137253,0
45,82,0.549,12,28,0.429,16,21,0.762,6,33,39,30,8,9,15,13,33,54,0.6111111111111112,1
41,90,0.456,10,31,0.323,17,22,0.773,9,37,46,31,9,4,12,24,31,59,0.5254237288135594,0
39,86,0.453,13,38,0.342,22,26,0.846,7,40,47,22,6,5,17,18,26,48,0.5416666666666666,1
49,89,0.551,13,33,0.394,15,19,0.789,4,30,34,33,5,6,12,20,36,56,0.6428571428571429,1
44,85,0.518,15,37,0.405,18,32,0.563,8,30,38,27,7,6,11,20,29,48,0.6041666666666666,0
48,91,0.527,6,24,0.25,14,17,0.824,9,33,42,30,7,5,12,22,42,67,0.6268656716417911,1
42,83,0.506,10,38,0.263,16,20,0.8,7,31,38,31,7,5,14,18,32,45,0.7111111111111111,0
48,86,0.558,14,32,0.438,24,28,0.857,7,31,38,36,8,10,16,29,34,54,0.6296296296296297,1
43,89,0.483,13,32,0.406,30,36,0.833,11,27,38,33,7,4,15,21,30,57,0.5263157894736842,0
42,81,0.519,8,31,0.258,10,13,0.769,10,37,47,20,0,3,11,13,34,50,0.68,1
38,89,0.427,14,44,0.318,10,14,0.714,12,26,38,21,5,2,3,17,24,45,0.5333333333333333,0
47,84,0.56,15,32,0.469,11,17,0.647,7,27,34,36,9,3,13,17,32,52,0.6153846153846154,0
47,84,0.56,16,29,0.552,14,16,0.875,10,30,40,25,9,4,18,16,31,55,0.5636363636363636,1
50,95,0.526,19,47,0.404,11,14,0.786,8,33,41,31,10,4,11,17,31,48,0.6458333333333334,1
40,90,0.444,12,33,0.364,20,24,0.833,10,34,44,31,7,3,14,11,28,57,0.49122807017543857,0
40,87,0.46,15,35,0.429,14,17,0.824,9,29,38,23,6,2,15,20,25,52,0.4807692307692308,1
38,82,0.463,12,31,0.387,20,22,0.909,13,31,44,21,7,2,18,17,26,51,0.5098039215686274,0
46,93,0.495,15,41,0.366,16,21,0.762,7,41,48,32,7,3,10,17,31,52,0.5961538461538461,1
41,93,0.441,10,42,0.238,17,23,0.739,9,33,42,27,4,5,11,16,31,51,0.6078431372549019,0
42,87,0.483,13,30,0.433,27,29,0.931,16,26,42,23,11,5,8,23,29,57,0.5087719298245614,1
37,78,0.474,10,23,0.435,25,27,0.926,11,25,36,24,3,5,16,23,27,55,0.4909090909090909,0
39,91,0.429,20,47,0.426,17,25,0.68,6,31,37,34,3,6,14,26,19,44,0.4318181818181818,0
42,84,0.5,4,12,0.333,30,35,0.857,9,38,47,18,3,11,11,21,38,72,0.5277777777777778,1
43,85,0.506,16,43,0.372,14,16,0.875,4,45,49,32,7,6,14,16,27,42,0.6428571428571429,1
37,93,0.398,11,38,0.289,10,15,0.667,11,34,45,25,5,4,11,15,26,55,0.4727272727272727,0
32,75,0.427,13,42,0.31,19,23,0.826,3,29,32,28,6,4,16,13,19,33,0.5757575757575758,0
47,91,0.516,14,33,0.424,17,21,0.81,13,39,52,32,11,5,12,18,33,58,0.5689655172413793,1
36,85,0.424,5,25,0.2,20,24,0.833,6,40,46,21,7,6,10,12,31,60,0.5166666666666667,1
35,85,0.412,9,37,0.243,10,14,0.714,7,40,47,23,2,7,17,20,26,48,0.5416666666666666,0
47,85,0.553,12,32,0.375,35,49,0.714,8,41,49,30,6,6,10,18,35,53,0.660377358490566,1
44,94,0.468,21,37,0.568,26,32,0.813,9,31,40,30,6,2,9,30,23,57,0.40350877192982454,0
48,105,0.457,13,43,0.302,17,22,0.773,16,43,59,28,4,8,17,24,35,62,0.5645161290322581,0
50,117,0.427,13,39,0.333,14,22,0.636,23,33,56,27,11,10,7,22,37,78,0.47435897435897434,1
32,81,0.395,8,24,0.333,30,35,0.857,9,28,37,21,12,4,8,20,24,57,0.42105263157894735,1
31,75,0.413,14,37,0.378,21,29,0.724,9,41,50,22,4,7,21,26,17,38,0.4473684210526316,0
38,92,0.413,11,34,0.324,13,23,0.565,11,20,31,29,10,5,10,18,27,58,0.46551724137931033,0
48,88,0.545,14,39,0.359,16,20,0.8,15,46,61,27,4,7,22,20,34,49,0.6938775510204082,1
51,96,0.531,12,31,0.387,17,23,0.739,14,35,49,38,6,10,17,19,39,65,0.6,1
49,103,0.476,9,29,0.31,20,23,0.87,14,32,46,28,10,4,12,21,40,74,0.5405405405405406,0
43,98,0.439,17,47,0.362,13,18,0.722,16,39,55,31,10,12,16,17,26,51,0.5098039215686274,1
41,94,0.436,10,35,0.286,15,22,0.682,11,38,49,26,9,3,15,17,31,59,0.5254237288135594,0
44,90,0.489,14,39,0.359,12,16,0.75,6,30,36,29,6,5,13,21,30,51,0.5882352941176471,0
42,83,0.506,13,26,0.5,28,33,0.848,8,37,45,26,6,5,11,18,29,57,0.5087719298245614,1
42,90,0.467,9,29,0.31,17,20,0.85,10,25,35,24,7,5,14,21,33,61,0.5409836065573771,0
47,86,0.547,13,33,0.394,27,29,0.931,10,35,45,28,9,6,14,18,34,53,0.6415094339622641,1
30,80,0.375,12,37,0.324,15,18,0.833,12,24,36,22,9,1,18,22,18,43,0.4186046511627907,0
37,78,0.474,9,28,0.321,22,28,0.786,12,32,44,21,5,5,14,16,28,50,0.56,1
41,94,0.436,14,31,0.452,14,23,0.609,14,26,40,28,9,4,11,20,27,63,0.42857142857142855,0
47,82,0.573,8,25,0.32,15,18,0.833,6,38,44,25,7,5,17,24,39,57,0.6842105263157895,1
43,88,0.489,8,22,0.364,19,28,0.679,13,37,50,29,9,11,14,16,35,66,0.5303030303030303,1
39,91,0.429,8,27,0.296,18,22,0.818,12,28,40,31,6,9,13,23,31,64,0.484375,0
41,88,0.466,15,46,0.326,22,30,0.733,5,39,44,26,7,8,6,20,26,42,0.6190476190476191,1
43,97,0.443,14,40,0.35,10,14,0.714,10,38,48,24,4,4,10,20,29,57,0.5087719298245614,0
42,94,0.447,10,39,0.256,28,34,0.824,10,39,49,26,7,8,9,22,32,55,0.5818181818181818,1
40,89,0.449,10,30,0.333,23,29,0.793,6,36,42,25,4,9,10,25,30,59,0.5084745762711864,0
50,88,0.568,14,37,0.378,14,18,0.778,7,28,35,30,8,4,10,20,36,51,0.7058823529411765,1
44,84,0.524,18,41,0.439,19,25,0.76,6,30,36,34,4,1,13,15,26,43,0.6046511627906976,0
45,80,0.563,20,38,0.526,16,22,0.727,9,30,39,29,10,4,12,20,25,42,0.5952380952380952,1
34,74,0.459,11,29,0.379,20,30,0.667,8,26,34,25,7,0,15,17,23,45,0.5111111111111111,0
43,93,0.462,13,41,0.317,24,27,0.889,13,30,43,29,3,3,8,22,30,52,0.5769230769230769,0
48,97,0.495,5,20,0.25,32,40,0.8,19,29,48,28,5,3,4,20,43,77,0.5584415584415584,1
45,93,0.484,14,37,0.378,9,14,0.643,14,33,47,25,6,4,10,18,31,56,0.5535714285714286,0
44,85,0.518,14,34,0.412,13,17,0.765,5,34,39,32,5,5,7,13,30,51,0.5882352941176471,1
36,93,0.387,14,40,0.35,21,27,0.778,13,37,50,19,2,7,12,19,22,53,0.41509433962264153,0
43,93,0.462,12,38,0.316,24,27,0.889,10,41,51,22,8,2,9,21,31,55,0.5636363636363636,1
44,95,0.463,13,34,0.382,7,12,0.583,19,28,47,30,11,8,16,15,31,61,0.5081967213114754,1
35,79,0.443,8,23,0.348,22,23,0.957,12,35,47,31,7,8,17,14,27,56,0.48214285714285715,0
40,86,0.465,10,29,0.345,18,19,0.947,11,31,42,21,8,8,14,13,30,57,0.5263157894736842,1
42,95,0.442,15,42,0.357,4,5,0.8,13,27,40,29,7,5,13,19,27,53,0.5094339622641509,0
44,88,0.5,11,33,0.333,15,17,0.882,11,31,42,22,5,9,12,17,33,55,0.6,1
43,87,0.494,5,21,0.238,18,21,0.857,7,31,38,24,4,1,10,16,38,66,0.5757575757575758,0
45,92,0.489,11,32,0.344,15,22,0.682,13,28,41,27,9,8,15,15,34,60,0.5666666666666667,0
52,88,0.591,14,27,0.519,9,12,0.75,6,30,36,33,8,5,15,17,38,61,0.6229508196721312,1
43,92,0.467,12,36,0.333,26,32,0.813,6,32,38,27,4,8,8,15,31,56,0.5535714285714286,0
60,104,0.577,23,46,0.5,10,15,0.667,12,45,57,41,5,4,9,24,37,58,0.6379310344827587,1
37,86,0.43,18,39,0.462,17,21,0.81,12,34,46,27,6,6,19,19,19,47,0.40425531914893614,0
43,89,0.483,7,23,0.304,18,28,0.643,10,33,43,23,9,10,12,18,36,66,0.5454545454545454,1
51,85,0.6,14,34,0.412,16,22,0.727,11,38,49,30,10,4,16,20,37,51,0.7254901960784313,1
41,89,0.461,17,43,0.395,10,18,0.556,10,23,33,25,4,3,14,16,24,46,0.5217391304347826,0
38,87,0.437,15,38,0.395,15,19,0.789,9,39,48,27,5,5,11,22,23,49,0.46938775510204084,0
43,86,0.5,15,38,0.395,12,20,0.6,5,39,44,26,4,0,11,17,28,48,0.5833333333333334,1
39,94,0.415,14,43,0.326,20,26,0.769,13,32,45,30,7,2,11,16,25,51,0.49019607843137253,0
51,91,0.56,16,33,0.485,16,22,0.727,11,38,49,26,6,9,10,18,35,58,0.603448275862069,1
50,98,0.51,15,35,0.429,22,24,0.917,13,35,48,31,6,4,12,18,35,63,0.5555555555555556,1
50,94,0.532,12,36,0.333,19,22,0.864,8,29,37,29,8,6,8,19,38,58,0.6551724137931034,0
36,80,0.45,17,36,0.472,16,19,0.842,7,37,44,30,8,6,18,19,19,44,0.4318181818181818,1
33,82,0.402,11,34,0.324,19,25,0.76,11,33,44,21,9,9,17,17,22,48,0.4583333333333333,0
46,91,0.505,13,38,0.342,11,15,0.733,6,33,39,26,5,2,13,18,33,53,0.6226415094339622,0
45,90,0.5,11,29,0.379,25,28,0.893,10,36,46,24,9,3,12,16,34,61,0.5573770491803278,1
54,96,0.563,18,40,0.45,14,16,0.875,16,31,47,36,11,8,16,20,36,56,0.6428571428571429,1
43,86,0.5,9,32,0.281,19,25,0.76,12,26,38,30,7,11,19,14,34,54,0.6296296296296297,0
42,100,0.42,9,32,0.281,25,29,0.862,15,33,48,26,8,7,7,22,33,68,0.4852941176470588,1
37,77,0.481,10,24,0.417,23,29,0.793,7,42,49,31,2,3,21,22,27,53,0.5094339622641509,0
37,75,0.493,10,21,0.476,12,16,0.75,5,33,38,24,6,4,17,17,27,54,0.5,1
35,77,0.455,10,33,0.303,14,16,0.875,5,27,32,22,7,3,15,15,25,44,0.5681818181818182,0
48,91,0.527,22,48,0.458,16,19,0.842,8,26,34,33,8,5,10,21,26,43,0.6046511627906976,1
48,86,0.558,19,37,0.514,18,23,0.783,6,27,33,30,7,3,13,19,29,49,0.5918367346938775,0
42,87,0.483,7,29,0.241,31,43,0.721,6,25,31,24,13,6,12,20,35,58,0.603448275862069,0
53,93,0.57,12,28,0.429,16,21,0.762,12,43,55,35,6,8,21,33,41,65,0.6307692307692307,1
47,88,0.534,12,37,0.324,26,29,0.897,12,27,39,27,7,6,17,18,35,51,0.6862745098039216,0
53,87,0.609,20,31,0.645,15,20,0.75,5,25,30,35,10,4,14,21,33,56,0.5892857142857143,1
51,80,0.638,22,40,0.55,19,20,0.95,6,41,47,36,4,5,11,10,29,40,0.725,1
42,94,0.447,16,42,0.381,10,13,0.769,11,20,31,25,7,1,5,12,26,52,0.5,0
34,84,0.405,5,26,0.192,11,13,0.846,13,27,40,20,2,2,19,20,29,58,0.5,0
45,85,0.529,15,38,0.395,17,20,0.85,12,32,44,26,12,3,10,14,30,47,0.6382978723404256,1
50,97,0.515,13,31,0.419,10,12,0.833,13,39,52,34,6,2,16,19,37,66,0.5606060606060606,1
43,88,0.489,7,30,0.233,15,20,0.75,5,30,35,33,11,7,11,14,36,58,0.6206896551724138,0
51,85,0.6,19,35,0.543,27,32,0.844,6,31,37,28,3,5,13,25,32,50,0.64,1
51,97,0.526,15,34,0.441,26,30,0.867,12,24,36,32,7,2,7,24,36,63,0.5714285714285714,0
50,89,0.562,13,33,0.394,25,31,0.806,11,42,53,34,7,10,14,20,37,56,0.6607142857142857,1
35,85,0.412,9,29,0.31,25,32,0.781,5,27,32,20,6,7,13,25,26,56,0.4642857142857143,0
51,89,0.573,13,30,0.433,16,18,0.889,7,31,38,24,8,5,20,17,38,59,0.6440677966101694,0
58,109,0.532,8,26,0.308,9,15,0.6,21,27,48,34,8,3,13,17,50,83,0.6024096385542169,1
38,81,0.469,9,34,0.265,21,29,0.724,9,31,40,21,8,4,11,14,29,47,0.6170212765957447,0
42,90,0.467,15,41,0.366,8,13,0.615,9,34,43,30,9,7,14,21,27,49,0.5510204081632653,1
38,92,0.413,14,36,0.389,22,31,0.71,15,36,51,20,7,8,13,22,24,56,0.42857142857142855,1
35,87,0.402,13,34,0.382,17,24,0.708,12,39,51,21,6,4,18,24,22,53,0.41509433962264153,0
42,88,0.477,10,33,0.303,13,14,0.929,6,39,45,22,11,5,13,11,32,55,0.5818181818181818,1
32,82,0.39,9,36,0.25,10,14,0.714,8,33,41,24,9,5,20,16,23,46,0.5,0
38,90,0.422,10,37,0.27,14,19,0.737,8,29,37,23,11,3,15,20,28,53,0.5283018867924528,0
42,92,0.457,10,34,0.294,22,26,0.846,17,42,59,30,12,5,18,11,32,58,0.5517241379310345,1
48,95,0.505,9,32,0.281,22,24,0.917,12,38,50,29,6,7,11,17,39,63,0.6190476190476191,1
44,96,0.458,6,32,0.188,13,22,0.591,15,30,45,26,6,3,11,18,38,64,0.59375,0
45,102,0.441,10,40,0.25,15,18,0.833,15,43,58,28,8,8,8,20,35,62,0.5645161290322581,1
36,100,0.36,10,40,0.25,14,16,0.875,18,34,52,21,2,9,11,13,26,60,0.43333333333333335,0
37,94,0.394,10,37,0.27,20,23,0.87,15,40,55,20,6,3,17,29,27,57,0.47368421052631576,0
36,74,0.486,12,34,0.353,22,37,0.595,2,38,40,24,11,6,19,22,24,40,0.6,1
52,93,0.559,17,41,0.415,13,17,0.765,15,34,49,38,6,6,14,18,35,52,0.6730769230769231,1
47,92,0.511,13,32,0.406,15,21,0.714,9,26,35,35,7,6,10,22,34,60,0.5666666666666667,0
43,80,0.538,11,30,0.367,23,30,0.767,6,33,39,27,4,10,14,20,32,50,0.64,1
43,98,0.439,16,46,0.348,13,18,0.722,13,30,43,35,7,2,10,24,27,52,0.5192307692307693,0
43,81,0.531,6,22,0.273,13,16,0.813,6,33,39,25,5,6,11,29,37,59,0.6271186440677966,0
37,82,0.451,13,37,0.351,24,38,0.632,13,31,44,25,5,3,8,15,24,45,0.5333333333333333,1
45,100,0.45,11,34,0.324,17,21,0.81,16,34,50,26,10,4,10,19,34,66,0.5151515151515151,1
37,85,0.435,9,32,0.281,21,27,0.778,11,34,45,22,2,8,17,20,28,53,0.5283018867924528,0
49,101,0.485,9,27,0.333,38,43,0.884,7,48,55,33,9,5,20,21,40,74,0.5405405405405406,1
55,119,0.462,23,58,0.397,11,16,0.688,11,39,50,37,11,3,17,34,32,61,0.5245901639344263,0
40,85,0.471,9,23,0.391,28,36,0.778,9,34,43,20,5,3,15,17,31,62,0.5,0
51,91,0.56,20,45,0.444,19,25,0.76,6,39,45,30,12,0,9,25,31,46,0.6739130434782609,1
41,88,0.466,14,37,0.378,13,16,0.813,8,30,38,26,6,4,8,18,27,51,0.5294117647058824,0
45,87,0.517,17,33,0.515,18,26,0.692,11,35,46,25,6,3,7,15,28,54,0.5185185185185185,1
45,79,0.57,14,26,0.538,8,15,0.533,7,25,32,30,9,6,13,13,31,53,0.5849056603773585,0
46,84,0.548,13,30,0.433,8,15,0.533,14,25,39,35,7,7,15,14,33,54,0.6111111111111112,1
41,89,0.461,15,31,0.484,28,32,0.875,15,31,46,29,12,3,14,30,26,58,0.4482758620689655,0
44,95,0.463,6,27,0.222,32,40,0.8,20,31,51,27,7,4,14,21,38,68,0.5588235294117647,1
44,92,0.478,8,28,0.286,8,12,0.667,11,32,43,17,7,5,10,18,36,64,0.5625,0
47,95,0.495,11,26,0.423,15,19,0.789,15,38,53,27,6,2,9,11,36,69,0.5217391304347826,1
38,82,0.463,11,30,0.367,23,31,0.742,13,32,45,20,5,7,13,20,27,52,0.5192307692307693,0
44,90,0.489,13,35,0.371,15,16,0.938,11,33,44,31,8,6,10,26,31,55,0.5636363636363636,1
41,73,0.562,4,14,0.286,12,21,0.571,6,33,39,19,4,5,23,19,37,59,0.6271186440677966,0
41,92,0.446,12,36,0.333,19,26,0.731,11,29,40,30,12,7,10,21,29,56,0.5178571428571429,1
42,90,0.467,8,32,0.25,12,17,0.706,5,35,40,27,7,10,5,19,34,58,0.5862068965517241,1
32,79,0.405,6,33,0.182,26,29,0.897,7,41,48,22,2,5,14,21,26,46,0.5652173913043478,0
46,91,0.505,10,35,0.286,10,13,0.769,9,31,40,21,7,6,12,14,36,56,0.6428571428571429,0
43,85,0.506,17,46,0.37,15,20,0.75,6,34,40,27,7,5,11,15,26,39,0.6666666666666666,1
39,86,0.453,9,27,0.333,27,34,0.794,12,32,44,23,3,7,17,14,30,59,0.5084745762711864,0
54,105,0.514,21,45,0.467,18,19,0.947,16,34,50,41,12,9,9,24,33,60,0.55,1
44,84,0.524,12,37,0.324,13,16,0.813,7,35,42,25,5,3,9,16,32,47,0.6808510638297872,1
37,81,0.457,11,32,0.344,7,14,0.5,9,32,41,23,4,6,14,14,26,49,0.5306122448979592,0
38,80,0.475,11,34,0.324,21,28,0.75,6,31,37,28,8,3,13,21,27,46,0.5869565217391305,0
42,86,0.488,13,40,0.325,21,26,0.808,11,35,46,28,6,3,13,18,29,46,0.6304347826086957,1
45,88,0.511,18,38,0.474,21,28,0.75,12,23,35,27,7,1,12,33,27,50,0.54,0
43,69,0.623,13,27,0.481,32,43,0.744,3,32,35,27,6,2,15,24,30,42,0.7142857142857143,1
36,84,0.429,16,40,0.4,19,25,0.76,7,33,40,24,3,7,13,22,20,44,0.45454545454545453,0
44,91,0.484,4,18,0.222,21,24,0.875,9,38,47,29,7,4,8,22,40,73,0.547945205479452,1
45,91,0.495,13,35,0.371,16,26,0.615,4,31,35,26,10,6,12,13,32,56,0.5714285714285714,0
52,98,0.531,12,36,0.333,19,25,0.76,14,42,56,36,10,2,15,19,40,62,0.6451612903225806,1
43,84,0.512,11,38,0.289,6,10,0.6,11,40,51,24,10,1,19,17,32,46,0.6956521739130435,1
30,80,0.375,13,36,0.361,21,28,0.75,9,28,37,22,11,1,14,16,17,44,0.38636363636363635,0
46,94,0.489,14,40,0.35,12,17,0.706,10,37,47,30,8,8,8,16,32,54,0.5925925925925926,1
33,84,0.393,14,36,0.389,25,25,1.0,8,36,44,20,5,5,13,18,19,48,0.3958333333333333,0
40,83,0.482,14,29,0.483,13,15,0.867,9,36,45,21,7,2,13,19,26,54,0.48148148148148145,1
35,79,0.443,14,35,0.4,17,22,0.773,8,30,38,21,5,7,12,17,21,44,0.4772727272727273,0
37,83,0.446,5,29,0.172,25,28,0.893,12,22,34,17,6,5,17,25,32,54,0.5925925925925926,0
46,84,0.548,12,28,0.429,26,29,0.897,11,28,39,29,7,5,13,24,34,56,0.6071428571428571,1
46,86,0.535,9,25,0.36,17,24,0.708,14,31,45,32,9,8,19,15,37,61,0.6065573770491803,1
43,92,0.467,12,30,0.4,15,17,0.882,10,26,36,31,10,7,15,17,31,62,0.5,0
48,90,0.533,12,33,0.364,14,25,0.56,7,30,37,28,12,3,14,16,36,57,0.631578947368421,0
53,101,0.525,16,38,0.421,16,18,0.889,12,34,46,32,10,2,12,18,37,63,0.5873015873015873,1
50,108,0.463,12,39,0.308,12,15,0.8,19,31,50,33,4,2,8,21,38,69,0.5507246376811594,0
47,87,0.54,17,36,0.472,18,22,0.818,7,33,40,25,6,9,12,16,30,51,0.5882352941176471,1
43,83,0.518,14,29,0.483,18,20,0.9,9,29,38,34,10,4,20,20,29,54,0.5370370370370371,1
38,75,0.507,11,32,0.344,20,27,0.741,6,27,33,21,9,9,20,16,27,43,0.627906976744186,0
39,85,0.459,13,30,0.433,16,21,0.762,13,26,39,11,14,2,16,24,26,55,0.4727272727272727,0
44,79,0.557,14,32,0.438,17,19,0.895,8,34,42,32,6,6,18,20,30,47,0.6382978723404256,1
39,86,0.453,12,36,0.333,13,17,0.765,15,28,43,23,3,5,15,16,27,50,0.54,0
44,94,0.468,13,34,0.382,17,18,0.944,14,31,45,29,9,7,6,16,31,60,0.5166666666666667,1
49,79,0.62,14,28,0.5,24,32,0.75,9,33,42,35,5,6,16,12,35,51,0.6862745098039216,1
47,94,0.5,16,39,0.41,10,13,0.769,8,19,27,28,11,1,11,24,31,55,0.5636363636363636,0
45,87,0.517,11,29,0.379,16,22,0.727,11,33,44,28,4,7,10,13,34,58,0.5862068965517241,1
40,90,0.444,16,46,0.348,14,17,0.824,9,31,40,25,4,6,10,18,24,44,0.5454545454545454,0
45,81,0.556,16,31,0.516,15,19,0.789,7,28,35,27,8,3,19,17,29,50,0.58,0
47,89,0.528,12,35,0.343,22,23,0.957,10,23,33,26,13,5,9,15,35,54,0.6481481481481481,1
41,82,0.5,11,34,0.324,17,24,0.708,12,44,56,20,3,6,16,22,30,48,0.625,1
35,87,0.402,13,44,0.295,16,17,0.941,5,24,29,19,11,2,5,21,22,43,0.5116279069767442,0
41,93,0.441,12,40,0.3,12,18,0.667,12,32,44,26,6,3,9,17,29,53,0.5471698113207547,0
42,84,0.5,13,28,0.464,18,23,0.783,7,42,49,38,3,2,10,16,29,56,0.5178571428571429,1
31,76,0.408,6,29,0.207,19,26,0.731,9,22,31,18,4,4,17,24,25,47,0.5319148936170213,0
45,80,0.563,13,30,0.433,18,30,0.6,9,36,45,31,6,4,10,24,32,50,0.64,1
37,93,0.398,15,37,0.405,11,16,0.688,12,35,47,21,7,9,10,23,22,56,0.39285714285714285,0
37,87,0.425,11,26,0.423,20,25,0.8,15,38,53,24,2,9,13,14,26,61,0.4262295081967213,1
45,92,0.489,13,45,0.289,13,18,0.722,10,29,39,27,7,5,13,17,32,47,0.6808510638297872,0
49,92,0.533,12,28,0.429,9,9,1.0,9,30,39,26,9,1,11,20,37,64,0.578125,1
41,86,0.477,7,20,0.35,19,23,0.826,12,33,45,29,10,5,16,20,34,66,0.5151515151515151,1
36,80,0.45,9,31,0.29,17,24,0.708,7,34,41,24,9,9,19,20,27,49,0.5510204081632653,0
47,100,0.47,12,30,0.4,19,22,0.864,18,34,52,25,9,7,8,16,35,70,0.5,1
45,97,0.464,9,29,0.31,10,15,0.667,12,33,45,19,4,10,13,19,36,68,0.5294117647058824,0
38,94,0.404,19,36,0.528,19,26,0.731,15,37,52,30,11,2,7,8,19,58,0.3275862068965517,1
41,97,0.423,16,48,0.333,7,7,1.0,14,40,54,30,4,12,15,19,25,49,0.5102040816326531,0
41,86,0.477,14,35,0.4,12,18,0.667,10,38,48,26,6,8,14,16,27,51,0.5294117647058824,1
37,90,0.411,12,38,0.316,15,17,0.882,7,36,43,25,9,12,13,19,25,52,0.4807692307692308,0
42,93,0.452,13,33,0.394,8,13,0.615,9,35,44,21,9,9,13,25,29,60,0.48333333333333334,0
41,103,0.398,8,38,0.211,19,25,0.76,24,36,60,15,8,7,10,14,33,65,0.5076923076923077,1
47,94,0.5,14,32,0.438,19,21,0.905,10,30,40,27,6,11,5,22,33,62,0.532258064516129,1
45,87,0.517,12,36,0.333,22,25,0.88,10,33,43,36,3,9,11,15,33,51,0.6470588235294118,0
47,88,0.534,14,37,0.378,12,14,0.857,8,30,38,31,6,5,17,17,33,51,0.6470588235294118,0
49,95,0.516,17,44,0.386,14,18,0.778,12,31,43,29,7,4,10,13,32,51,0.6274509803921569,1
37,80,0.463,10,28,0.357,24,30,0.8,13,24,37,14,7,4,10,16,27,52,0.5192307692307693,0
46,91,0.505,12,36,0.333,16,17,0.941,16,32,48,34,3,6,12,20,34,55,0.6181818181818182,1
53,89,0.596,14,29,0.483,16,19,0.842,7,29,36,31,12,5,11,21,39,60,0.65,1
45,89,0.506,17,40,0.425,18,24,0.75,13,25,38,28,5,3,17,18,28,49,0.5714285714285714,0
40,91,0.44,11,33,0.333,15,20,0.75,8,29,37,17,11,5,14,18,29,58,0.5,0
55,93,0.591,11,31,0.355,14,17,0.824,7,42,49,30,9,3,15,20,44,62,0.7096774193548387,1
51,90,0.567,13,34,0.382,18,28,0.643,9,29,38,26,15,3,17,17,38,56,0.6785714285714286,1
46,85,0.541,10,29,0.345,20,24,0.833,8,31,39,23,13,3,22,20,36,56,0.6428571428571429,0
46,83,0.554,11,29,0.379,18,22,0.818,6,40,46,32,7,8,14,17,35,54,0.6481481481481481,1
35,87,0.402,14,46,0.304,17,24,0.708,9,28,37,30,7,4,14,20,21,41,0.5121951219512195,0
39,85,0.459,9,25,0.36,21,26,0.808,10,32,42,24,11,4,15,17,30,60,0.5,1
38,82,0.463,12,38,0.316,18,20,0.9,6,32,38,24,8,5,17,20,26,44,0.5909090909090909,0
41,92,0.446,14,31,0.452,10,14,0.714,7,28,35,22,12,4,14,21,27,61,0.4426229508196721,0
44,75,0.587,17,36,0.472,21,27,0.778,3,41,44,31,10,10,19,17,27,39,0.6923076923076923,1
46,95,0.484,7,26,0.269,15,21,0.714,13,26,39,29,14,3,9,17,39,69,0.5652173913043478,1
46,96,0.479,10,39,0.256,11,18,0.611,18,37,55,35,6,10,18,16,36,57,0.631578947368421,0
38,88,0.432,7,31,0.226,27,35,0.771,14,45,59,24,4,1,12,18,31,57,0.543859649122807,1
37,90,0.411,11,42,0.262,17,21,0.81,6,37,43,28,5,4,9,25,26,48,0.5416666666666666,0
50,112,0.446,18,56,0.321,16,20,0.8,14,43,57,26,4,7,14,23,32,56,0.5714285714285714,0
55,114,0.482,14,43,0.326,17,22,0.773,16,41,57,27,5,4,8,20,41,71,0.5774647887323944,1
42,84,0.5,15,39,0.385,24,29,0.828,4,36,40,33,12,1,17,18,27,45,0.6,1
42,91,0.462,11,34,0.324,20,22,0.909,11,36,47,24,13,3,16,20,31,57,0.543859649122807,0
50,88,0.568,12,30,0.4,17,25,0.68,5,31,36,34,13,2,12,21,38,58,0.6551724137931034,1
40,81,0.494,16,39,0.41,21,23,0.913,8,34,42,22,9,1,21,19,24,42,0.5714285714285714,0
39,80,0.488,12,31,0.387,23,27,0.852,3,35,38,28,4,11,5,16,27,49,0.5510204081632653,1
41,100,0.41,10,35,0.286,13,15,0.867,18,33,51,21,1,4,7,20,31,65,0.47692307692307695,0
49,95,0.516,20,51,0.392,18,23,0.783,13,40,53,35,3,5,12,20,29,44,0.6590909090909091,1
44,96,0.458,12,29,0.414,21,27,0.778,11,33,44,26,7,1,5,17,32,67,0.47761194029850745,0
46,97,0.474,13,44,0.295,12,13,0.923,10,41,51,31,6,4,10,19,33,53,0.6226415094339622,1
36,98,0.367,12,40,0.3,17,21,0.81,14,40,54,23,6,6,12,13,24,58,0.41379310344827586,0
35,92,0.38,11,38,0.289,10,12,0.833,16,30,46,19,5,3,20,15,24,54,0.4444444444444444,0
48,99,0.485,19,51,0.373,16,18,0.889,17,40,57,30,12,4,11,13,29,48,0.6041666666666666,1
45,92,0.489,11,33,0.333,14,18,0.778,11,38,49,34,5,4,11,15,34,59,0.576271186440678,1
35,88,0.398,8,29,0.276,21,25,0.84,11,32,43,18,6,5,11,16,27,59,0.4576271186440678,0
39,85,0.459,11,31,0.355,14,15,0.933,15,27,42,29,6,3,13,16,28,54,0.5185185185185185,0
42,86,0.488,12,28,0.429,16,19,0.842,14,28,42,26,8,6,9,11,30,58,0.5172413793103449,1
45,84,0.536,10,24,0.417,11,15,0.733,7,30,37,22,7,3,10,18,35,60,0.5833333333333334,1
36,80,0.45,8,31,0.258,19,22,0.864,9,27,36,22,6,5,15,18,28,49,0.5714285714285714,0
34,77,0.442,16,39,0.41,19,22,0.864,9,39,48,23,6,5,17,12,18,38,0.47368421052631576,1
38,91,0.418,8,30,0.267,11,12,0.917,12,33,45,24,9,0,10,19,30,61,0.4918032786885246,0
31,88,0.352,10,30,0.333,18,27,0.667,10,31,41,20,10,7,11,26,21,58,0.3620689655172414,0
40,90,0.444,11,30,0.367,20,27,0.741,11,47,58,21,6,11,16,19,29,60,0.48333333333333334,1
48,101,0.475,14,35,0.4,17,21,0.81,11,37,48,38,6,5,12,16,34,66,0.5151515151515151,0
52,110,0.473,23,63,0.365,8,8,1.0,14,31,45,40,6,8,11,15,29,47,0.6170212765957447,1
39,84,0.464,15,41,0.366,15,25,0.6,7,25,32,27,8,3,12,21,24,43,0.5581395348837209,0
43,89,0.483,17,44,0.386,20,24,0.833,12,40,52,31,3,3,16,24,26,45,0.5777777777777777,1
54,88,0.614,11,25,0.44,21,26,0.808,9,33,42,33,13,6,18,12,43,63,0.6825396825396826,1
47,96,0.49,7,32,0.219,11,17,0.647,13,22,35,32,11,4,18,19,40,64,0.625,0
52,89,0.584,21,35,0.6,24,31,0.774,8,28,36,32,8,5,8,19,31,54,0.5740740740740741,1
51,95,0.537,20,39,0.513,22,27,0.815,13,26,39,35,5,4,11,22,31,56,0.5535714285714286,0
43,93,0.462,4,22,0.182,19,23,0.826,16,44,60,24,7,8,14,17,39,71,0.5492957746478874,1
34,89,0.382,13,42,0.31,17,22,0.773,11,27,38,23,7,12,10,23,21,47,0.44680851063829785,0
50,89,0.562,8,34,0.235,16,19,0.842,7,41,48,36,5,6,17,12,42,55,0.7636363636363637,1
47,96,0.49,13,32,0.406,11,14,0.786,5,29,34,26,9,1,9,16,34,64,0.53125,0
43,93,0.462,17,44,0.386,7,12,0.583,10,30,40,28,5,1,12,18,26,49,0.5306122448979592,0
51,88,0.58,23,41,0.561,11,17,0.647,5,40,45,36,10,5,9,15,28,47,0.5957446808510638,1
40,84,0.476,10,31,0.323,10,15,0.667,10,28,38,27,4,6,18,12,30,53,0.5660377358490566,0
53,104,0.51,19,45,0.422,13,13,1.0,17,34,51,36,11,5,7,13,34,59,0.576271186440678,1
42,87,0.483,17,43,0.395,17,23,0.739,8,36,44,28,6,4,10,16,25,44,0.5681818181818182,1
40,93,0.43,8,29,0.276,14,20,0.7,16,35,51,20,8,5,12,21,32,64,0.5,0
46,91,0.505,19,43,0.442,8,13,0.615,6,39,45,25,7,3,11,12,27,48,0.5625,1
41,91,0.451,12,33,0.364,13,15,0.867,8,35,43,33,6,5,10,13,29,58,0.5,0
42,92,0.457,20,45,0.444,19,26,0.731,10,32,42,28,6,5,14,25,22,47,0.46808510638297873,0
45,93,0.484,12,30,0.4,27,32,0.844,13,35,48,24,9,16,14,22,33,63,0.5238095238095238,1
50,97,0.515,12,25,0.48,17,23,0.739,20,28,48,26,5,3,15,16,38,72,0.5277777777777778,0
54,86,0.628,15,32,0.469,9,14,0.643,5,20,25,35,7,7,12,20,39,54,0.7222222222222222,1
35,80,0.438,10,35,0.286,15,21,0.714,8,31,39,25,7,3,18,17,25,45,0.5555555555555556,0
47,87,0.54,13,36,0.361,14,18,0.778,11,34,45,31,10,3,13,19,34,51,0.6666666666666666,1
41,80,0.513,21,37,0.568,10,16,0.625,8,27,35,33,4,5,18,15,20,43,0.46511627906976744,0
48,86,0.558,11,27,0.407,16,20,0.8,8,29,37,28,12,5,10,12,37,59,0.6271186440677966,1
39,90,0.433,13,40,0.325,15,25,0.6,10,34,44,23,10,4,13,21,26,50,0.52,0
44,87,0.506,8,28,0.286,18,27,0.667,8,41,49,17,8,5,14,19,36,59,0.6101694915254238,1
43,90,0.478,19,37,0.514,12,18,0.667,9,23,32,26,9,9,11,16,24,53,0.4528301886792453,0
46,89,0.517,14,35,0.4,18,20,0.9,15,33,48,29,9,8,17,17,32,54,0.5925925925925926,1
43,102,0.422,13,41,0.317,18,20,0.9,13,36,49,24,8,2,9,13,30,61,0.4918032786885246,0
49,93,0.527,17,49,0.347,10,11,0.909,6,39,45,33,6,9,14,16,32,44,0.7272727272727273,1
43,81,0.531,17,33,0.515,20,24,0.833,7,34,41,30,5,3,11,17,26,48,0.5416666666666666,1
44,90,0.489,16,39,0.41,13,20,0.65,9,29,38,27,6,2,10,20,28,51,0.5490196078431373,0
47,88,0.534,12,32,0.375,11,16,0.688,8,30,38,30,13,5,15,17,35,56,0.625,1
36,78,0.462,12,32,0.375,22,26,0.846,8,29,37,23,7,2,19,17,24,46,0.5217391304347826,0
41,90,0.456,12,37,0.324,10,17,0.588,6,40,46,30,6,2,15,21,29,53,0.5471698113207547,0
43,87,0.494,12,38,0.316,18,23,0.783,5,40,45,29,8,2,11,20,31,49,0.6326530612244898,1
47,94,0.5,16,38,0.421,17,22,0.773,12,40,52,30,7,8,13,21,31,56,0.5535714285714286,1
41,98,0.418,8,32,0.25,14,14,1.0,11,29,40,21,7,8,15,16,33,66,0.5,0
47,84,0.56,17,31,0.548,22,22,1.0,6,42,48,32,2,2,13,21,30,53,0.5660377358490566,1
45,95,0.474,15,44,0.341,15,22,0.682,5,28,33,31,7,6,4,20,30,51,0.5882352941176471,0
43,88,0.489,12,35,0.343,16,22,0.727,7,39,46,25,4,5,14,11,31,53,0.5849056603773585,1
42,94,0.447,16,40,0.4,6,9,0.667,12,35,47,27,10,5,15,23,26,54,0.48148148148148145,0
43,80,0.538,15,37,0.405,17,17,1.0,7,41,48,26,8,13,17,18,28,43,0.6511627906976745,1
37,93,0.398,10,25,0.4,11,14,0.786,12,22,34,22,9,3,12,17,27,68,0.39705882352941174,0
52,93,0.559,17,32,0.531,10,13,0.769,10,39,49,33,7,7,17,22,35,61,0.5737704918032787,1
39,81,0.481,12,31,0.387,19,27,0.704,7,23,30,31,11,6,14,17,27,50,0.54,0
47,97,0.485,14,32,0.438,6,7,0.857,14,36,50,33,4,6,14,17,33,65,0.5076923076923077,1
41,89,0.461,8,25,0.32,16,22,0.727,10,29,39,27,12,10,7,10,33,64,0.515625,0
43,79,0.544,12,26,0.462,20,22,0.909,8,38,46,24,3,4,15,16,31,53,0.5849056603773585,1
42,91,0.462,18,46,0.391,8,13,0.615,9,25,34,26,8,4,10,24,24,45,0.5333333333333333,0
48,87,0.552,21,41,0.512,12,16,0.75,12,31,43,34,8,3,8,17,27,46,0.5869565217391305,1
40,81,0.494,14,33,0.424,11,16,0.688,10,25,35,35,6,3,13,10,26,48,0.5416666666666666,0
43,82,0.524,18,42,0.429,18,23,0.783,6,34,40,30,7,6,9,13,25,40,0.625,1
42,94,0.447,14,37,0.378,10,11,0.909,14,32,46,27,5,2,14,19,28,57,0.49122807017543857,0
42,81,0.519,11,35,0.314,16,17,0.941,4,23,27,29,7,5,15,16,31,46,0.6739130434782609,0
49,82,0.598,16,27,0.593,13,20,0.65,8,31,39,34,11,5,17,20,33,55,0.6,1
41,94,0.436,12,35,0.343,21,31,0.677,19,33,52,28,7,7,15,14,29,59,0.4915254237288136,0
52,88,0.591,14,29,0.483,11,16,0.688,5,32,37,37,10,7,12,22,38,59,0.6440677966101694,1
45,93,0.484,16,27,0.593,22,31,0.71,16,29,45,26,3,7,17,23,29,66,0.4393939393939394,1
41,89,0.461,11,30,0.367,29,33,0.879,11,27,38,29,9,7,17,27,30,59,0.5084745762711864,0
45,95,0.474,20,47,0.426,19,21,0.905,5,34,39,32,8,1,12,25,25,48,0.5208333333333334,0
48,92,0.522,11,34,0.324,26,28,0.929,9,40,49,25,9,5,13,17,37,58,0.6379310344827587,1
46,89,0.517,11,29,0.379,19,23,0.826,10,31,41,28,5,7,13,22,35,60,0.5833333333333334,0
49,88,0.557,14,31,0.452,27,32,0.844,5,27,32,32,5,5,8,20,35,57,0.6140350877192983,1
27,79,0.342,7,29,0.241,23,29,0.793,8,40,48,17,2,2,15,20,20,50,0.4,0
41,94,0.436,18,52,0.346,20,24,0.833,10,43,53,26,8,5,7,24,23,42,0.5476190476190477,1
42,81,0.519,16,36,0.444,27,33,0.818,9,31,40,31,4,9,13,19,26,45,0.5777777777777777,1
42,98,0.429,15,45,0.333,22,29,0.759,18,31,49,24,7,6,10,24,27,53,0.5094339622641509,0
38,82,0.463,10,29,0.345,20,28,0.714,9,26,35,26,9,5,21,16,28,53,0.5283018867924528,0
51,87,0.586,17,34,0.5,16,18,0.889,6,36,42,32,11,1,16,22,34,53,0.6415094339622641,1
38,85,0.447,15,38,0.395,13,16,0.813,12,36,48,22,5,3,22,20,23,47,0.48936170212765956,0
40,95,0.421,10,33,0.303,17,19,0.895,16,25,41,24,14,8,12,17,30,62,0.4838709677419355,1
44,100,0.44,13,43,0.302,12,19,0.632,16,42,58,22,6,6,17,26,31,57,0.543859649122807,0
40,88,0.455,14,41,0.341,28,37,0.757,9,32,41,25,7,8,11,18,26,47,0.5531914893617021,1
36,91,0.396,11,34,0.324,20,21,0.952,15,26,41,20,5,3,14,11,25,57,0.43859649122807015,0
49,87,0.563,17,34,0.5,8,11,0.727,9,32,41,31,8,7,12,23,32,53,0.6037735849056604,1
43,92,0.467,16,44,0.364,4,8,0.5,9,23,32,33,12,5,12,13,27,48,0.5625,0
47,82,0.573,16,31,0.516,5,7,0.714,5,38,43,30,8,4,19,9,31,51,0.6078431372549019,1
38,98,0.388,17,47,0.362,18,21,0.857,12,28,40,23,5,4,10,23,21,51,0.4117647058823529,0
53,91,0.582,15,38,0.395,25,33,0.758,11,43,54,30,8,3,12,23,38,53,0.7169811320754716,1
43,94,0.457,11,34,0.324,15,16,0.938,9,33,42,28,9,8,14,13,32,60,0.5333333333333333,0
45,101,0.446,17,41,0.415,6,11,0.545,13,39,52,33,6,2,14,20,28,60,0.4666666666666667,1
45,102,0.441,9,30,0.3,7,7,1.0,14,43,57,27,7,2,14,19,36,72,0.5,0
37,82,0.451,13,39,0.333,25,26,0.962,0,35,35,20,9,6,11,13,24,43,0.5581395348837209,1
50,82,0.61,14,29,0.483,11,19,0.579,6,35,41,30,4,3,16,20,36,53,0.6792452830188679,1
40,84,0.476,10,32,0.313,21,23,0.913,5,27,32,16,7,4,9,15,30,52,0.5769230769230769,0
43,99,0.434,12,37,0.324,10,14,0.714,18,25,43,21,10,6,8,24,31,62,0.5,0
41,88,0.466,13,39,0.333,19,26,0.731,13,35,48,23,4,6,17,18,28,49,0.5714285714285714,1
36,76,0.474,10,27,0.37,11,16,0.688,8,28,36,27,9,6,12,14,26,49,0.5306122448979592,1
33,76,0.434,6,21,0.286,12,17,0.706,11,31,42,19,7,4,18,14,27,55,0.4909090909090909,0
48,92,0.522,14,41,0.341,9,13,0.692,14,33,47,36,5,4,11,18,34,51,0.6666666666666666,1
35,87,0.402,9,31,0.29,16,23,0.696,12,28,40,22,7,3,11,14,26,56,0.4642857142857143,0
48,100,0.48,8,27,0.296,15,23,0.652,13,35,48,28,8,4,11,18,40,73,0.547945205479452,1
42,86,0.488,13,35,0.371,16,21,0.762,7,32,39,28,7,8,17,23,29,51,0.5686274509803921,0
41,81,0.506,16,39,0.41,12,17,0.706,6,36,42,27,1,9,11,13,25,42,0.5952380952380952,1
40,97,0.412,12,40,0.3,14,15,0.933,14,31,45,21,4,2,7,14,28,57,0.49122807017543857,0
44,90,0.489,16,42,0.381,9,13,0.692,10,30,40,32,5,5,18,22,28,48,0.5833333333333334,0
46,85,0.541,13,27,0.481,22,27,0.815,5,31,36,30,8,9,11,17,33,58,0.5689655172413793,1
51,92,0.554,13,28,0.464,21,29,0.724,7,36,43,29,6,2,6,22,38,64,0.59375,1
44,94,0.468,14,43,0.326,24,29,0.828,15,34,49,33,4,3,12,20,30,51,0.5882352941176471,0
42,83,0.506,8,30,0.267,10,16,0.625,2,30,32,31,9,3,11,11,34,53,0.6415094339622641,0
44,82,0.537,10,34,0.294,13,16,0.813,5,41,46,27,5,3,19,17,34,48,0.7083333333333334,1
48,88,0.545,11,26,0.423,16,19,0.842,11,31,42,25,5,4,11,22,37,62,0.5967741935483871,1
44,92,0.478,13,37,0.351,20,25,0.8,15,28,43,33,6,8,11,17,31,55,0.5636363636363636,0
44,106,0.415,7,32,0.219,9,15,0.6,12,40,52,27,9,7,16,25,37,74,0.5,0
43,96,0.448,9,36,0.25,17,26,0.654,12,44,56,27,7,12,16,18,34,60,0.5666666666666667,1
42,92,0.457,12,36,0.333,7,12,0.583,19,32,51,19,4,4,17,23,30,56,0.5357142857142857,0
36,80,0.45,10,26,0.385,23,33,0.697,12,27,39,22,12,3,12,16,26,54,0.48148148148148145,1
46,86,0.535,11,34,0.324,18,19,0.947,9,32,41,33,9,7,13,20,35,52,0.6730769230769231,1
34,84,0.405,9,28,0.321,23,26,0.885,10,26,36,20,6,3,13,14,25,56,0.44642857142857145,0
32,78,0.41,13,35,0.371,19,24,0.792,12,37,49,21,12,4,19,18,19,43,0.4418604651162791,1
34,81,0.42,12,44,0.273,7,8,0.875,3,33,36,28,7,8,18,17,22,37,0.5945945945945946,0
36,94,0.383,11,40,0.275,12,17,0.706,12,36,48,24,7,2,13,14,25,54,0.46296296296296297,0
42,84,0.5,16,34,0.471,12,18,0.667,9,42,51,30,8,6,13,19,26,50,0.52,1
46,87,0.529,11,30,0.367,19,23,0.826,5,41,46,37,12,13,19,14,35,57,0.6140350877192983,1
39,98,0.398,8,31,0.258,13,16,0.813,16,31,47,25,11,4,19,20,31,67,0.4626865671641791,0
48,100,0.48,20,44,0.455,13,17,0.765,12,39,51,31,8,4,13,13,28,56,0.5,1
41,92,0.446,11,32,0.344,14,16,0.875,9,35,44,23,8,7,18,17,30,60,0.5,0
43,83,0.518,15,37,0.405,17,23,0.739,7,32,39,31,6,1,14,24,28,46,0.6086956521739131,1
39,79,0.494,15,33,0.455,17,26,0.654,7,30,37,28,6,3,12,21,24,46,0.5217391304347826,0
45,108,0.417,8,28,0.286,13,17,0.765,17,33,50,30,8,2,10,24,37,80,0.4625,0
43,84,0.512,14,35,0.4,25,30,0.833,7,40,47,32,6,11,16,14,29,49,0.5918367346938775,1
45,87,0.517,19,40,0.475,14,18,0.778,7,40,47,34,10,3,14,13,26,47,0.5531914893617021,1
37,83,0.446,13,39,0.333,10,11,0.909,5,33,38,24,8,4,18,12,24,44,0.5454545454545454,0
46,84,0.548,13,32,0.406,22,24,0.917,4,27,31,28,9,8,12,20,33,52,0.6346153846153846,1
41,91,0.451,11,36,0.306,20,25,0.8,14,34,48,29,6,3,16,19,30,55,0.5454545454545454,0
49,95,0.516,9,31,0.29,18,24,0.75,15,35,50,27,8,6,13,27,40,64,0.625,0
44,85,0.518,13,31,0.419,29,36,0.806,7,32,39,29,11,6,12,16,31,54,0.5740740740740741,1
39,84,0.464,13,33,0.394,30,34,0.882,12,29,41,24,8,9,12,18,26,51,0.5098039215686274,1
39,87,0.448,11,29,0.379,20,25,0.8,12,32,44,26,5,1,16,29,28,58,0.4827586206896552,0
31,81,0.383,10,31,0.323,14,15,0.933,6,25,31,27,5,1,12,12,21,50,0.42,0
52,91,0.571,22,45,0.489,10,12,0.833,10,41,51,32,6,5,10,13,30,46,0.6521739130434783,1
36,89,0.404,9,38,0.237,18,20,0.9,15,30,45,23,5,6,16,20,27,51,0.5294117647058824,0
44,89,0.494,15,37,0.405,19,20,0.95,12,34,46,27,7,4,13,18,29,52,0.5576923076923077,1
38,83,0.458,14,33,0.424,15,17,0.882,9,35,44,18,5,3,15,21,24,50,0.48,0
40,83,0.482,12,37,0.324,16,21,0.762,6,30,36,31,6,2,8,18,28,46,0.6086956521739131,1
36,100,0.36,10,40,0.25,11,15,0.733,13,31,44,29,8,7,12,9,26,60,0.43333333333333335,0
49,92,0.533,11,30,0.367,7,10,0.7,8,47,55,28,6,10,16,14,38,62,0.6129032258064516,1
39,89,0.438,9,33,0.273,15,19,0.789,10,38,48,21,7,5,15,18,30,56,0.5357142857142857,1
35,89,0.393,9,26,0.346,19,22,0.864,12,33,45,27,6,5,12,18,26,63,0.4126984126984127,0
44,88,0.5,13,38,0.342,29,37,0.784,12,36,48,28,6,4,12,21,31,50,0.62,1
47,103,0.456,18,47,0.383,13,18,0.722,13,34,47,34,7,2,9,25,29,56,0.5178571428571429,0
42,102,0.412,11,36,0.306,18,28,0.643,22,34,56,20,9,4,9,25,31,66,0.4696969696969697,0
39,79,0.494,15,35,0.429,28,41,0.683,8,38,46,27,8,11,11,20,24,44,0.5454545454545454,1
44,92,0.478,21,45,0.467,17,20,0.85,15,27,42,35,7,3,19,22,23,47,0.48936170212765956,0
50,89,0.562,10,32,0.313,23,29,0.793,8,31,39,36,14,6,10,21,40,57,0.7017543859649122,1
35,84,0.417,11,29,0.379,19,24,0.792,16,18,34,15,8,0,12,11,24,55,0.43636363636363634,0
48,76,0.632,12,26,0.462,10,11,0.909,7,27,34,25,7,7,12,22,36,50,0.72,1
42,88,0.477,11,35,0.314,14,15,0.933,10,33,43,27,10,1,13,17,31,53,0.5849056603773585,1
41,86,0.477,10,35,0.286,12,16,0.75,6,33,39,29,3,1,14,20,31,51,0.6078431372549019,0
38,99,0.384,10,37,0.27,14,22,0.636,16,32,48,26,14,5,19,32,28,62,0.45161290322580644,0
35,77,0.455,10,31,0.323,36,44,0.818,9,45,54,28,15,11,24,20,25,46,0.5434782608695652,1
47,97,0.485,17,41,0.415,16,23,0.696,9,30,39,32,9,9,8,20,30,56,0.5357142857142857,1
50,98,0.51,6,26,0.231,19,26,0.731,15,41,56,30,6,7,15,20,44,72,0.6111111111111112,0
52,91,0.571,14,31,0.452,20,24,0.833,5,32,37,34,8,4,10,13,38,60,0.6333333333333333,1
49,101,0.485,14,45,0.311,10,13,0.769,15,29,44,29,5,7,13,21,35,56,0.625,0
42,90,0.467,11,44,0.25,15,20,0.75,11,33,44,24,10,5,14,22,31,46,0.6739130434782609,0
44,83,0.53,13,26,0.5,12,19,0.632,7,33,40,30,9,3,16,16,31,57,0.543859649122807,1
46,89,0.517,11,30,0.367,25,27,0.926,11,41,52,24,8,5,14,22,35,59,0.5932203389830508,1
31,83,0.373,8,29,0.276,21,30,0.7,9,26,35,18,8,5,15,23,23,54,0.42592592592592593,0
49,92,0.533,20,42,0.476,22,28,0.786,13,28,41,42,8,6,13,19,29,50,0.58,1
43,93,0.462,22,49,0.449,29,32,0.906,17,31,48,33,10,3,16,22,21,44,0.4772727272727273,0
45,83,0.542,23,47,0.489,16,21,0.762,5,31,36,27,10,11,14,16,22,36,0.6111111111111112,1
44,94,0.468,10,28,0.357,14,16,0.875,13,32,45,30,6,2,13,17,34,66,0.5151515151515151,0
43,84,0.512,14,25,0.56,16,18,0.889,10,23,33,26,8,3,13,23,29,59,0.4915254237288136,1
39,70,0.557,10,22,0.455,21,26,0.808,7,26,33,31,8,5,19,18,29,48,0.6041666666666666,0
40,83,0.482,15,36,0.417,18,24,0.75,11,30,41,20,7,4,16,21,25,47,0.5319148936170213,0
43,90,0.478,19,44,0.432,18,21,0.857,10,29,39,24,10,5,10,21,24,46,0.5217391304347826,1
40,104,0.385,17,38,0.447,13,23,0.565,14,26,40,30,14,1,14,15,23,66,0.3484848484848485,0
56,101,0.554,7,31,0.226,11,15,0.733,13,47,60,41,11,11,16,16,49,70,0.7,1
43,88,0.489,10,35,0.286,14,21,0.667,10,31,41,28,5,9,11,18,33,53,0.6226415094339622,0
50,107,0.467,16,41,0.39,12,14,0.857,15,33,48,32,6,4,9,19,34,66,0.5151515151515151,1
47,89,0.528,12,30,0.4,9,18,0.5,6,35,41,27,6,4,15,21,35,59,0.5932203389830508,0
50,94,0.532,13,30,0.433,16,19,0.842,7,35,42,36,10,5,14,15,37,64,0.578125,1
36,82,0.439,15,41,0.366,18,28,0.643,12,32,44,27,6,5,24,18,21,41,0.5121951219512195,0
50,96,0.521,16,41,0.39,11,18,0.611,9,34,43,35,16,6,14,21,34,55,0.6181818181818182,1
42,93,0.452,12,32,0.375,11,13,0.846,11,31,42,27,6,2,14,15,30,61,0.4918032786885246,0
50,90,0.556,17,35,0.486,12,17,0.706,8,36,44,24,9,11,15,16,33,55,0.6,1
38,79,0.481,15,34,0.441,19,27,0.704,12,33,45,24,11,6,18,13,23,45,0.5111111111111111,1
37,84,0.44,10,29,0.345,12,14,0.857,7,31,38,23,7,3,18,23,27,55,0.4909090909090909,0
50,98,0.51,11,25,0.44,11,16,0.688,11,31,42,37,9,5,8,12,39,73,0.5342465753424658,0
52,93,0.559,13,33,0.394,10,14,0.714,7,35,42,29,5,6,10,12,39,60,0.65,1
33,80,0.413,11,37,0.297,16,22,0.727,6,33,39,19,7,2,20,24,22,43,0.5116279069767442,0
41,84,0.488,14,31,0.452,25,30,0.833,7,38,45,24,10,6,11,18,27,53,0.5094339622641509,1
40,92,0.435,20,42,0.476,15,22,0.682,12,30,42,28,11,3,10,23,20,50,0.4,1
37,86,0.43,9,39,0.231,24,27,0.889,15,39,54,26,3,2,19,21,28,47,0.5957446808510638,0
50,102,0.49,15,39,0.385,8,8,1.0,11,36,47,37,3,7,12,20,35,63,0.5555555555555556,1
46,106,0.434,12,39,0.308,17,24,0.708,20,34,54,27,5,4,9,11,34,67,0.5074626865671642,0
32,88,0.364,11,39,0.282,9,11,0.818,13,30,43,21,13,6,19,15,21,49,0.42857142857142855,0
38,89,0.427,13,42,0.31,8,10,0.8,13,40,53,28,7,7,22,15,25,47,0.5319148936170213,1
38,95,0.4,7,31,0.226,27,35,0.771,19,39,58,23,10,8,10,20,31,64,0.484375,0
37,93,0.398,15,45,0.333,25,34,0.735,17,37,54,25,8,5,14,23,22,48,0.4583333333333333,1
42,96,0.438,15,38,0.395,19,23,0.826,16,31,47,33,9,7,14,14,27,58,0.46551724137931033,0
49,95,0.516,11,27,0.407,14,18,0.778,10,36,46,28,7,4,13,18,38,68,0.5588235294117647,1
37,84,0.44,12,32,0.375,15,17,0.882,14,37,51,20,7,2,21,20,25,52,0.4807692307692308,1
38,91,0.418,8,35,0.229,11,16,0.688,14,27,41,26,12,3,13,17,30,56,0.5357142857142857,0
41,87,0.471,13,37,0.351,17,25,0.68,11,36,47,24,10,4,10,18,28,50,0.56,1
43,98,0.439,13,35,0.371,8,13,0.615,16,36,52,23,8,4,14,18,30,63,0.47619047619047616,0
38,82,0.463,13,29,0.448,17,25,0.68,10,36,46,20,6,11,15,14,25,53,0.4716981132075472,1
39,104,0.375,7,32,0.219,10,13,0.769,18,36,54,20,6,7,11,19,32,72,0.4444444444444444,0
41,104,0.394,9,38,0.237,15,21,0.714,16,27,43,20,10,3,16,17,32,66,0.48484848484848486,0
55,92,0.598,20,40,0.5,17,21,0.81,8,48,56,30,5,9,15,22,35,52,0.6730769230769231,1
34,80,0.425,8,27,0.296,21,31,0.677,5,38,43,24,5,8,11,15,26,53,0.49056603773584906,0
40,90,0.444,12,29,0.414,12,15,0.8,9,42,51,20,6,7,10,25,28,61,0.45901639344262296,1
50,85,0.588,13,33,0.394,14,22,0.636,11,34,45,38,8,6,13,17,37,52,0.7115384615384616,1
46,101,0.455,8,25,0.32,12,18,0.667,19,26,45,25,11,2,11,17,38,76,0.5,0
43,87,0.494,12,24,0.5,14,21,0.667,13,33,46,25,9,9,13,15,31,63,0.49206349206349204,1
43,85,0.506,14,31,0.452,9,13,0.692,7,29,36,29,7,7,12,21,29,54,0.5370370370370371,0
35,104,0.337,6,35,0.171,10,11,0.909,16,40,56,20,7,2,11,17,29,69,0.42028985507246375,0
36,84,0.429,12,38,0.316,17,23,0.739,6,45,51,22,6,9,13,14,24,46,0.5217391304347826,1
46,81,0.568,15,35,0.429,9,12,0.75,11,25,36,27,8,4,7,16,31,46,0.6739130434782609,1
37,82,0.451,13,38,0.342,15,16,0.938,15,24,39,21,1,3,14,15,24,44,0.5454545454545454,0
35,84,0.417,14,38,0.368,8,18,0.444,14,37,51,23,7,9,20,19,21,46,0.45652173913043476,0
41,90,0.456,12,29,0.414,15,17,0.882,9,35,44,31,10,3,10,17,29,61,0.47540983606557374,1
43,88,0.489,11,32,0.344,22,26,0.846,12,33,45,29,10,5,10,20,32,56,0.5714285714285714,1
35,81,0.432,11,34,0.324,22,29,0.759,11,31,42,27,5,3,17,18,24,47,0.5106382978723404,0
46,97,0.474,17,35,0.486,14,15,0.933,10,38,48,30,12,8,12,22,29,62,0.46774193548387094,1
38,93,0.409,16,41,0.39,18,23,0.783,13,37,50,18,6,7,18,16,22,52,0.4230769230769231,0
41,87,0.471,14,31,0.452,15,21,0.714,8,30,38,15,9,4,16,13,27,56,0.48214285714285715,0
52,93,0.559,14,36,0.389,15,17,0.882,6,40,46,38,12,0,15,16,38,57,0.6666666666666666,1
45,91,0.495,15,37,0.405,18,22,0.818,14,27,41,29,10,1,10,15,30,54,0.5555555555555556,1
40,82,0.488,8,27,0.296,19,20,0.95,10,29,39,23,7,2,16,14,32,55,0.5818181818181818,0
41,95,0.432,13,40,0.325,19,21,0.905,12,37,49,29,12,0,11,15,28,55,0.509090909090909,1
40,88,0.455,16,41,0.39,10,14,0.714,12,37,49,25,5,7,19,17,24,47,0.5106382978723404,0
43,79,0.544,18,37,0.486,15,18,0.833,7,40,47,32,6,10,19,13,25,42,0.5952380952380952,1
36,97,0.371,16,46,0.348,10,11,0.909,13,28,41,24,12,5,10,18,20,51,0.39215686274509803,0
47,90,0.522,15,35,0.429,4,8,0.5,3,31,34,28,7,4,12,14,32,55,0.5818181818181818,0
44,93,0.473,17,40,0.425,18,19,0.947,14,37,51,32,6,9,15,12,27,53,0.5094339622641509,1
37,75,0.493,7,24,0.292,12,17,0.706,4,37,41,24,12,6,19,12,30,51,0.5882352941176471,1
33,95,0.347,3,32,0.094,11,16,0.688,22,34,56,14,11,4,16,16,30,63,0.47619047619047616,0
42,91,0.462,13,31,0.419,12,19,0.632,10,36,46,34,8,11,20,17,29,60,0.48333333333333334,0
46,90,0.511,17,35,0.486,19,22,0.864,5,33,38,36,13,8,17,17,29,55,0.5272727272727272,1
42,83,0.506,10,32,0.313,20,27,0.741,6,41,47,35,6,6,11,16,32,51,0.6274509803921569,1
40,90,0.444,12,40,0.3,13,18,0.722,4,36,40,29,6,2,9,22,28,50,0.56,0
53,96,0.552,12,28,0.429,12,17,0.706,12,33,45,35,4,7,12,17,41,68,0.6029411764705882,1
46,100,0.46,13,42,0.31,17,23,0.739,13,30,43,27,8,5,10,19,33,58,0.5689655172413793,0
44,90,0.489,15,42,0.357,8,14,0.571,12,34,46,32,5,5,10,24,29,48,0.6041666666666666,1
29,75,0.387,7,26,0.269,21,26,0.808,8,32,40,16,6,4,15,13,22,49,0.4489795918367347,0
38,79,0.481,14,30,0.467,21,26,0.808,10,32,42,25,9,6,17,15,24,49,0.4897959183673469,0
41,92,0.446,15,39,0.385,16,21,0.762,15,29,44,31,9,4,14,16,26,53,0.49056603773584906,1
45,87,0.517,11,30,0.367,20,25,0.8,10,29,39,27,12,3,11,12,34,57,0.5964912280701754,1
45,85,0.529,13,32,0.406,7,12,0.583,11,30,41,30,10,5,15,20,32,53,0.6037735849056604,0
35,94,0.372,11,38,0.289,16,19,0.842,12,31,43,24,11,4,18,15,24,56,0.42857142857142855,0
46,93,0.495,12,32,0.375,20,23,0.87,15,40,55,27,8,8,18,15,34,61,0.5573770491803278,1
37,94,0.394,14,42,0.333,11,12,0.917,8,20,28,20,6,5,10,23,23,52,0.4423076923076923,0
39,74,0.527,5,22,0.227,34,37,0.919,9,47,56,21,7,9,14,16,34,52,0.6538461538461539,1
37,75,0.493,14,37,0.378,17,23,0.739,8,39,47,22,3,8,20,19,23,38,0.6052631578947368,1
39,98,0.398,2,29,0.069,15,18,0.833,15,24,39,22,11,3,6,18,37,69,0.5362318840579711,0
48,91,0.527,14,33,0.424,9,15,0.6,5,31,36,23,11,6,5,12,34,58,0.5862068965517241,0
44,83,0.53,20,40,0.5,13,18,0.722,9,38,47,35,2,4,16,12,24,43,0.5581395348837209,1
30,81,0.37,11,40,0.275,14,17,0.824,5,32,37,24,6,2,13,16,19,41,0.4634146341463415,0
46,89,0.517,16,40,0.4,15,18,0.833,11,40,51,29,7,3,10,17,30,49,0.6122448979591837,1
39,82,0.476,16,41,0.39,11,15,0.733,7,34,41,28,9,7,23,15,23,41,0.5609756097560976,0
43,93,0.462,13,31,0.419,15,17,0.882,11,35,46,28,16,8,14,14,30,62,0.4838709677419355,1
39,77,0.506,18,34,0.529,19,23,0.826,10,34,44,23,4,5,15,21,21,43,0.4883720930232558,1
31,83,0.373,14,46,0.304,16,23,0.696,13,25,38,27,6,5,13,20,17,37,0.4594594594594595,0
37,95,0.389,9,39,0.231,12,18,0.667,12,34,46,22,5,8,15,16,28,56,0.5,0
44,93,0.473,10,27,0.37,14,18,0.778,12,43,55,19,7,8,15,14,34,66,0.5151515151515151,1
31,79,0.392,8,31,0.258,11,14,0.786,9,26,35,18,10,1,22,22,23,48,0.4791666666666667,0
39,74,0.527,9,25,0.36,21,25,0.84,5,33,38,20,14,2,19,22,30,49,0.6122448979591837,1
37,70,0.529,14,26,0.538,18,26,0.692,6,28,34,29,8,8,20,19,23,44,0.5227272727272727,1
35,86,0.407,10,31,0.323,16,19,0.842,15,25,40,24,9,4,18,25,25,55,0.45454545454545453,0
47,94,0.5,21,46,0.457,8,11,0.727,9,35,44,39,12,6,19,11,26,48,0.5416666666666666,1
46,93,0.495,12,35,0.343,8,10,0.8,11,30,41,34,5,5,21,12,34,58,0.5862068965517241,0
45,104,0.433,22,54,0.407,11,19,0.579,5,34,39,37,7,11,12,25,23,50,0.46,0
44,110,0.4,13,37,0.351,31,38,0.816,25,49,74,29,6,8,19,18,31,73,0.4246575342465753,1
38,95,0.4,12,35,0.343,8,13,0.615,15,28,43,28,8,5,14,14,26,60,0.43333333333333335,0
46,86,0.535,15,35,0.429,10,11,0.909,5,38,43,35,10,6,16,17,31,51,0.6078431372549019,1
42,90,0.467,11,29,0.379,19,23,0.826,7,33,40,26,2,4,10,12,31,61,0.5081967213114754,0
50,102,0.49,14,38,0.368,9,9,1.0,14,36,50,34,5,9,10,21,36,64,0.5625,1
47,86,0.547,14,36,0.389,8,10,0.8,8,31,39,28,6,5,17,12,33,50,0.66,1
45,89,0.506,10,37,0.27,12,16,0.75,9,27,36,29,10,1,14,17,35,52,0.6730769230769231,0
36,93,0.387,11,37,0.297,18,20,0.9,17,33,50,23,8,5,15,22,25,56,0.44642857142857145,0
39,79,0.494,14,35,0.4,18,22,0.818,5,34,39,29,4,13,14,19,25,44,0.5681818181818182,1
52,96,0.542,15,43,0.349,17,21,0.81,11,39,50,32,7,10,16,20,37,53,0.6981132075471698,1
46,98,0.469,13,35,0.371,20,30,0.667,12,32,44,34,11,3,12,21,33,63,0.5238095238095238,0
37,86,0.43,8,28,0.286,15,21,0.714,8,31,39,18,3,8,14,14,29,58,0.5,0
46,90,0.511,22,46,0.478,10,13,0.769,8,35,43,30,6,4,10,16,24,44,0.5454545454545454,1
39,86,0.453,16,39,0.41,17,20,0.85,8,36,44,21,9,3,8,18,23,47,0.48936170212765956,1
36,82,0.439,12,39,0.308,15,20,0.75,9,33,42,24,3,3,13,18,24,43,0.5581395348837209,0
35,83,0.422,7,26,0.269,20,24,0.833,9,36,45,21,10,1,15,16,28,57,0.49122807017543857,0
36,84,0.429,12,34,0.353,19,21,0.905,9,32,41,22,10,8,15,23,24,50,0.48,1
52,102,0.51,17,41,0.415,10,12,0.833,10,35,45,35,6,6,15,19,35,61,0.5737704918032787,0
53,101,0.525,8,23,0.348,20,24,0.833,7,38,45,30,6,6,11,16,45,78,0.5769230769230769,1
44,98,0.449,14,44,0.318,8,16,0.5,16,37,53,26,8,5,11,19,30,54,0.5555555555555556,1
35,95,0.368,12,39,0.308,17,24,0.708,17,39,56,23,7,3,13,15,23,56,0.4107142857142857,0
34,80,0.425,16,37,0.432,23,28,0.821,7,30,37,25,8,1,13,22,18,43,0.4186046511627907,0
42,77,0.545,10,30,0.333,21,31,0.677,10,35,45,27,9,6,15,20,32,47,0.6808510638297872,1
33,99,0.333,11,45,0.244,28,31,0.903,19,39,58,14,8,5,13,29,22,54,0.4074074074074074,0
36,89,0.404,13,37,0.351,25,37,0.676,14,37,51,20,6,6,14,21,23,52,0.4423076923076923,1
44,89,0.494,9,31,0.29,21,22,0.955,7,30,37,20,6,2,11,15,35,58,0.603448275862069,0
48,91,0.527,19,39,0.487,17,20,0.85,11,34,45,39,6,8,12,20,29,52,0.5576923076923077,1
44,94,0.468,9,34,0.265,13,18,0.722,10,32,42,20,4,4,8,12,35,60,0.5833333333333334,0
52,94,0.553,21,43,0.488,13,13,1.0,9,38,47,33,4,8,9,15,31,51,0.6078431372549019,1
37,86,0.43,15,46,0.326,24,32,0.75,11,38,49,22,7,4,7,18,22,40,0.55,1
36,86,0.419,11,27,0.407,14,16,0.875,7,37,44,25,4,2,12,21,25,59,0.423728813559322,0
33,83,0.398,18,41,0.439,26,30,0.867,12,41,53,25,7,6,16,20,15,42,0.35714285714285715,1
33,89,0.371,10,36,0.278,24,28,0.857,9,33,42,24,10,7,9,23,23,53,0.4339622641509434,0
46,98,0.469,12,34,0.353,11,15,0.733,9,30,39,29,5,3,10,17,34,64,0.53125,0
54,94,0.574,13,32,0.406,19,25,0.76,9,40,49,32,5,7,9,13,41,62,0.6612903225806451,1
48,92,0.522,13,31,0.419,13,16,0.813,16,30,46,31,13,8,14,20,35,61,0.5737704918032787,1
35,79,0.443,9,24,0.375,13,22,0.591,8,22,30,15,6,8,23,17,26,55,0.4727272727272727,0
50,100,0.5,11,29,0.379,13,24,0.542,14,31,45,29,8,6,8,29,39,71,0.5492957746478874,1
42,85,0.494,12,31,0.387,24,32,0.75,8,36,44,29,4,5,13,22,30,54,0.5555555555555556,0
40,95,0.421,10,32,0.313,12,18,0.667,17,27,44,25,9,8,16,21,30,63,0.47619047619047616,0
48,86,0.558,15,32,0.469,18,26,0.692,11,36,47,25,9,4,17,17,33,54,0.6111111111111112,1
43,84,0.512,14,33,0.424,14,17,0.824,7,25,32,24,5,6,5,13,29,51,0.5686274509803921,0
46,96,0.479,19,44,0.432,10,11,0.909,15,33,48,38,5,7,7,17,27,52,0.5192307692307693,1
44,98,0.449,18,44,0.409,14,18,0.778,15,41,56,26,10,5,14,14,26,54,0.48148148148148145,1
41,95,0.432,12,45,0.267,11,17,0.647,11,36,47,31,9,2,14,14,29,50,0.58,0
37,87,0.425,11,34,0.324,17,23,0.739,12,30,42,23,4,4,12,19,26,53,0.49056603773584906,0
41,88,0.466,15,32,0.469,17,22,0.773,12,33,45,28,6,8,11,19,26,56,0.4642857142857143,1
54,92,0.587,11,26,0.423,5,7,0.714,11,36,47,34,5,7,10,8,43,66,0.6515151515151515,1
47,89,0.528,12,29,0.414,8,11,0.727,6,25,31,33,5,4,7,9,35,60,0.5833333333333334,0
39,92,0.424,11,35,0.314,18,24,0.75,13,37,50,23,8,5,23,25,28,57,0.49122807017543857,1
30,83,0.361,15,40,0.375,25,33,0.758,9,36,45,21,15,9,24,17,15,43,0.3488372093023256,0
42,87,0.483,14,35,0.4,22,26,0.846,12,30,42,24,3,5,11,19,28,52,0.5384615384615384,0
46,88,0.523,13,34,0.382,21,25,0.84,8,26,34,33,6,6,6,20,33,54,0.6111111111111112,1
42,96,0.438,16,42,0.381,18,26,0.692,13,36,49,27,13,3,13,22,26,54,0.48148148148148145,1
39,85,0.459,9,29,0.31,22,29,0.759,9,38,47,23,6,6,19,17,30,56,0.5357142857142857,0
36,92,0.391,7,41,0.171,9,13,0.692,12,34,46,24,2,3,17,13,29,51,0.5686274509803921,0
53,96,0.552,25,49,0.51,9,11,0.818,7,44,51,35,10,5,8,19,28,47,0.5957446808510638,1
42,86,0.488,16,39,0.41,7,10,0.7,10,37,47,32,8,9,12,13,26,47,0.5531914893617021,1
39,87,0.448,17,44,0.386,3,8,0.375,10,29,39,31,7,5,11,11,22,43,0.5116279069767442,0
40,88,0.455,11,37,0.297,29,31,0.935,13,29,42,26,10,5,9,19,29,51,0.5686274509803921,1
40,86,0.465,16,41,0.39,20,23,0.87,12,33,45,20,6,2,17,18,24,45,0.5333333333333333,0
32,85,0.376,10,34,0.294,15,17,0.882,7,33,40,17,7,5,9,12,22,51,0.43137254901960786,1
31,80,0.388,9,33,0.273,17,18,0.944,12,42,54,24,4,7,15,14,22,47,0.46808510638297873,0
33,86,0.384,8,36,0.222,17,20,0.85,5,23,28,25,11,2,12,19,25,50,0.5,0
43,72,0.597,7,23,0.304,20,25,0.8,7,41,48,24,7,6,22,16,36,49,0.7346938775510204,1
49,102,0.48,9,31,0.29,11,15,0.733,10,31,41,21,16,8,6,15,40,71,0.5633802816901409,1
40,91,0.44,14,39,0.359,16,18,0.889,15,35,50,26,2,7,22,15,26,52,0.5,0
41,93,0.441,6,30,0.2,17,21,0.81,14,28,42,20,9,4,12,14,35,63,0.5555555555555556,0
46,85,0.541,10,25,0.4,15,19,0.789,10,35,45,33,6,8,16,17,36,60,0.6,1
43,92,0.467,8,27,0.296,12,16,0.75,11,34,45,24,8,6,17,15,35,65,0.5384615384615384,0
42,91,0.462,13,38,0.342,14,18,0.778,11,34,45,27,8,6,16,16,29,53,0.5471698113207547,1
38,82,0.463,12,37,0.324,18,22,0.818,15,35,50,26,6,3,19,22,26,45,0.5777777777777777,1
35,79,0.443,15,42,0.357,17,30,0.567,12,21,33,27,10,6,13,20,20,37,0.5405405405405406,0
37,94,0.394,15,39,0.385,15,16,0.938,13,25,38,22,12,7,10,20,22,55,0.4,0
41,80,0.513,16,34,0.471,18,25,0.72,12,43,55,29,8,7,21,15,25,46,0.5434782608695652,1
37,84,0.44,16,40,0.4,16,25,0.64,5,33,38,25,9,3,14,21,21,44,0.4772727272727273,0
37,78,0.474,15,38,0.395,24,28,0.857,7,39,46,20,8,3,12,20,22,40,0.55,1
45,92,0.489,16,39,0.41,8,11,0.727,12,29,41,28,5,3,14,26,29,53,0.5471698113207547,0
40,79,0.506,11,28,0.393,28,37,0.757,12,28,40,28,9,7,11,17,29,51,0.5686274509803921,1
42,84,0.5,11,32,0.344,18,22,0.818,7,25,32,28,9,2,10,17,31,52,0.5961538461538461,1
41,92,0.446,11,37,0.297,16,18,0.889,20,31,51,29,6,6,18,22,30,55,0.5454545454545454,0
40,94,0.426,16,38,0.421,19,23,0.826,10,33,43,26,6,3,15,15,24,56,0.42857142857142855,0
49,101,0.485,16,40,0.4,13,15,0.867,11,40,51,29,6,9,13,16,33,61,0.5409836065573771,1
40,82,0.488,12,28,0.429,15,19,0.789,8,30,38,25,6,2,12,24,28,54,0.5185185185185185,0
41,84,0.488,12,30,0.4,18,24,0.75,10,34,44,25,4,7,14,16,29,54,0.5370370370370371,1
40,74,0.541,13,35,0.371,8,15,0.533,8,33,41,23,9,1,18,16,27,39,0.6923076923076923,1
33,72,0.458,12,33,0.364,11,11,1.0,3,28,31,19,7,1,19,19,21,39,0.5384615384615384,0
39,93,0.419,15,38,0.395,11,12,0.917,14,39,53,24,6,9,13,13,24,55,0.43636363636363634,0
39,90,0.433,20,42,0.476,7,11,0.636,8,34,42,28,11,3,9,10,19,48,0.3958333333333333,1
50,93,0.538,18,39,0.462,19,24,0.792,9,34,43,34,3,2,9,21,32,54,0.5925925925925926,1
45,93,0.484,13,39,0.333,17,21,0.81,9,32,41,23,5,6,9,23,32,54,0.5925925925925926,0
42,96,0.438,15,34,0.441,18,22,0.818,11,41,52,32,9,7,10,19,27,62,0.43548387096774194,1
41,96,0.427,15,40,0.375,10,14,0.714,10,41,51,25,6,6,15,15,26,56,0.4642857142857143,0
38,87,0.437,12,36,0.333,13,16,0.813,12,38,50,24,1,10,19,12,26,51,0.5098039215686274,0
49,105,0.467,9,34,0.265,7,11,0.636,16,35,51,23,15,5,7,15,40,71,0.5633802816901409,1
39,89,0.438,12,42,0.286,20,22,0.909,10,32,42,26,5,3,11,16,27,47,0.574468085106383,0
42,85,0.494,14,31,0.452,20,23,0.87,8,34,42,27,7,5,9,14,28,54,0.5185185185185185,1
44,87,0.506,10,31,0.323,18,23,0.783,13,38,51,26,6,5,16,13,34,56,0.6071428571428571,1
38,99,0.384,16,52,0.308,8,11,0.727,17,23,40,27,8,6,12,18,22,47,0.46808510638297873,0
53,105,0.505,24,49,0.49,9,11,0.818,17,45,62,38,9,5,11,19,29,56,0.5178571428571429,1
36,93,0.387,13,44,0.295,13,22,0.591,11,34,45,21,6,7,12,11,23,49,0.46938775510204084,0
39,89,0.438,10,44,0.227,13,17,0.765,10,32,42,27,5,4,15,16,29,45,0.6444444444444445,0
43,84,0.512,11,30,0.367,15,20,0.75,8,34,42,27,7,3,11,17,32,54,0.5925925925925926,1
34,89,0.382,11,39,0.282,11,15,0.733,6,30,36,19,8,5,15,10,23,50,0.46,0
51,91,0.56,19,39,0.487,4,7,0.571,8,42,50,37,10,13,16,13,32,52,0.6153846153846154,1
44,80,0.55,12,29,0.414,22,26,0.846,8,33,41,19,5,8,9,17,32,51,0.6274509803921569,1
45,94,0.479,16,37,0.432,10,17,0.588,13,25,38,33,6,2,8,21,29,57,0.5087719298245614,0
54,97,0.557,12,31,0.387,10,12,0.833,9,37,46,32,8,2,14,23,42,66,0.6363636363636364,1
42,81,0.519,15,32,0.469,21,25,0.84,3,31,34,25,4,5,14,14,27,49,0.5510204081632653,0
41,91,0.451,13,37,0.351,20,23,0.87,15,39,54,21,3,15,15,14,28,54,0.5185185185185185,1
39,102,0.382,13,35,0.371,18,21,0.857,17,30,47,25,11,9,11,21,26,67,0.3880597014925373,0
43,74,0.581,9,22,0.409,33,39,0.846,7,32,39,23,10,5,18,18,34,52,0.6538461538461539,1
41,81,0.506,14,34,0.412,24,27,0.889,7,25,32,27,10,2,17,28,27,47,0.574468085106383,0
45,90,0.5,17,39,0.436,12,15,0.8,7,32,39,29,7,4,9,13,28,51,0.5490196078431373,1
44,96,0.458,15,47,0.319,14,16,0.875,14,31,45,28,4,7,10,14,29,49,0.5918367346938775,0
44,81,0.543,12,26,0.462,19,21,0.905,9,33,42,21,4,5,15,14,32,55,0.5818181818181818,1
40,88,0.455,12,38,0.316,17,20,0.85,9,26,35,26,7,4,9,20,28,50,0.56,0
40,82,0.488,17,38,0.447,11,17,0.647,2,35,37,30,7,2,12,20,23,44,0.5227272727272727,0
40,87,0.46,16,41,0.39,18,23,0.783,10,35,45,27,5,6,10,16,24,46,0.5217391304347826,1
41,91,0.451,11,38,0.289,16,25,0.64,13,34,47,24,6,3,12,18,30,53,0.5660377358490566,0
45,90,0.5,4,21,0.19,21,22,0.955,8,37,45,27,10,4,8,19,41,69,0.5942028985507246,1
41,84,0.488,17,41,0.415,13,18,0.722,4,24,28,24,12,4,14,17,24,43,0.5581395348837209,0
43,82,0.524,12,30,0.4,20,21,0.952,13,37,50,24,7,4,23,18,31,52,0.5961538461538461,1
46,87,0.529,16,36,0.444,17,23,0.739,7,33,40,29,6,5,14,22,30,51,0.5882352941176471,1
44,97,0.454,11,42,0.262,23,28,0.821,13,35,48,31,8,2,11,22,33,55,0.6,0
46,98,0.469,7,25,0.28,14,19,0.737,13,35,48,23,9,6,11,20,39,73,0.5342465753424658,1
42,82,0.512,10,26,0.385,17,23,0.739,7,32,39,26,5,10,15,24,32,56,0.5714285714285714,0
43,94,0.457,16,44,0.364,11,15,0.733,9,27,36,30,5,2,9,20,27,50,0.54,0
44,86,0.512,15,35,0.429,17,20,0.85,10,39,49,29,6,6,16,16,29,51,0.5686274509803921,1
46,91,0.505,16,33,0.485,21,21,1.0,9,28,37,39,8,4,12,20,30,58,0.5172413793103449,0
52,102,0.51,10,32,0.313,17,18,0.944,14,32,46,31,8,3,13,15,42,70,0.6,1
39,94,0.415,8,30,0.267,18,22,0.818,7,38,45,25,5,5,14,25,31,64,0.484375,0
38,88,0.432,11,34,0.324,26,36,0.722,10,36,46,27,7,8,13,20,27,54,0.5,1
46,93,0.495,16,41,0.39,14,17,0.824,6,37,43,28,3,2,8,17,30,52,0.5769230769230769,0
47,90,0.522,16,34,0.471,13,19,0.684,4,34,38,27,2,7,5,16,31,56,0.5535714285714286,1
37,87,0.425,15,35,0.429,10,15,0.667,15,32,47,21,9,5,16,20,22,52,0.4230769230769231,1
30,74,0.405,10,26,0.385,22,30,0.733,10,28,38,21,10,11,13,19,20,48,0.4166666666666667,0
27,79,0.342,6,26,0.231,14,20,0.7,12,25,37,12,7,10,14,12,21,53,0.39622641509433965,0
38,79,0.481,16,33,0.485,6,8,0.75,11,32,43,20,7,10,16,14,22,46,0.4782608695652174,1
38,82,0.463,11,29,0.379,13,18,0.722,7,36,43,24,6,5,11,16,27,53,0.5094339622641509,0
42,89,0.472,12,38,0.316,11,13,0.846,9,36,45,28,5,8,9,16,30,51,0.5882352941176471,1
35,79,0.443,11,31,0.355,22,23,0.957,9,39,48,22,7,10,14,18,24,48,0.5,1
35,88,0.398,9,37,0.243,16,20,0.8,13,29,42,21,8,7,12,19,26,51,0.5098039215686274,0
45,94,0.479,14,37,0.378,19,26,0.731,14,33,47,33,12,10,7,15,31,57,0.543859649122807,1
37,89,0.416,16,35,0.457,17,25,0.68,19,30,49,22,5,5,17,16,21,54,0.3888888888888889,0
40,100,0.4,9,42,0.214,11,15,0.733,13,35,48,18,6,5,7,19,31,58,0.5344827586206896,0
43,87,0.494,6,33,0.182,20,23,0.87,10,44,54,25,5,11,11,20,37,54,0.6851851851851852,1
36,90,0.4,14,42,0.333,13,17,0.765,16,25,41,22,4,2,16,14,22,48,0.4583333333333333,0
44,81,0.543,11,30,0.367,11,15,0.733,9,36,45,26,9,3,17,18,33,51,0.6470588235294118,1
47,94,0.5,8,26,0.308,19,25,0.76,14,22,36,22,7,2,15,15,39,68,0.5735294117647058,0
55,83,0.663,19,32,0.594,13,16,0.813,5,27,32,40,8,10,14,22,36,51,0.7058823529411765,1
51,92,0.554,14,38,0.368,26,32,0.813,4,32,36,29,13,8,14,18,37,54,0.6851851851851852,1
45,99,0.455,13,37,0.351,21,25,0.84,20,36,56,27,8,4,20,26,32,62,0.5161290322580645,0
44,86,0.512,17,33,0.515,21,28,0.75,12,37,49,34,6,6,14,22,27,53,0.5094339622641509,1
41,88,0.466,10,30,0.333,21,29,0.724,9,30,39,26,9,7,12,24,31,58,0.5344827586206896,0
37,86,0.43,13,35,0.371,15,19,0.789,12,26,38,27,7,3,12,19,24,51,0.47058823529411764,0
42,84,0.5,12,35,0.343,16,18,0.889,9,36,45,29,7,6,16,20,30,49,0.6122448979591837,1
46,94,0.489,15,39,0.385,10,13,0.769,13,30,43,29,7,4,12,12,31,55,0.5636363636363636,1
44,87,0.506,9,31,0.29,10,16,0.625,10,31,41,21,6,1,15,14,35,56,0.625,0
43,91,0.473,16,43,0.372,16,19,0.842,9,34,43,29,9,6,20,18,27,48,0.5625,0
49,103,0.476,16,40,0.4,14,15,0.933,18,34,52,31,10,3,15,18,33,63,0.5238095238095238,1
43,75,0.573,14,27,0.519,16,22,0.727,4,39,43,32,8,7,12,10,29,48,0.6041666666666666,1
38,91,0.418,17,46,0.37,10,13,0.769,12,29,41,28,6,4,11,15,21,45,0.4666666666666667,0
42,79,0.532,18,35,0.514,18,20,0.9,8,32,40,33,7,3,15,17,24,44,0.5454545454545454,1
37,76,0.487,14,32,0.438,13,20,0.65,5,26,31,25,8,4,12,17,23,44,0.5227272727272727,0
43,87,0.494,17,38,0.447,21,27,0.778,7,34,41,28,5,6,7,15,26,49,0.5306122448979592,1
47,104,0.452,14,47,0.298,9,10,0.9,17,35,52,30,3,9,10,23,33,57,0.5789473684210527,0
41,97,0.423,16,46,0.348,11,13,0.846,11,27,38,27,8,6,12,18,25,51,0.49019607843137253,0
44,83,0.53,10,24,0.417,22,29,0.759,14,42,56,29,9,4,21,12,34,59,0.576271186440678,1
39,81,0.481,16,39,0.41,16,22,0.727,6,34,40,35,5,5,15,18,23,42,0.5476190476190477,1
43,95,0.453,10,33,0.303,12,18,0.667,16,35,51,20,9,6,13,18,33,62,0.532258064516129,0
31,80,0.388,9,30,0.3,8,14,0.571,14,33,47,20,9,5,15,18,22,50,0.44,1
26,80,0.325,9,40,0.225,12,16,0.75,16,34,50,19,9,5,21,14,17,40,0.425,0
32,78,0.41,11,33,0.333,18,27,0.667,8,31,39,21,8,4,16,14,21,45,0.4666666666666667,0
49,93,0.527,21,47,0.447,5,5,1.0,8,38,46,36,8,6,10,18,28,46,0.6086956521739131,1
38,78,0.487,8,23,0.348,27,33,0.818,5,41,46,20,5,10,13,21,30,55,0.5454545454545454,1
33,88,0.375,9,36,0.25,22,29,0.759,13,33,46,18,7,3,13,27,24,52,0.46153846153846156,0
39,84,0.464,12,29,0.414,22,27,0.815,6,36,42,23,8,1,12,18,27,55,0.4909090909090909,1
39,86,0.453,6,32,0.188,20,23,0.87,7,37,44,24,10,5,13,20,33,54,0.6111111111111112,0
51,93,0.548,13,41,0.317,12,15,0.8,10,39,49,33,10,6,6,17,38,52,0.7307692307692307,1
35,89,0.393,7,34,0.206,15,22,0.682,14,29,43,19,6,2,13,12,28,55,0.509090909090909,0
46,84,0.548,12,32,0.375,13,19,0.684,12,30,42,23,8,6,14,18,34,52,0.6538461538461539,1
40,84,0.476,15,46,0.326,16,19,0.842,10,27,37,30,9,0,13,18,25,38,0.6578947368421053,0
47,93,0.505,11,30,0.367,14,17,0.824,11,31,42,30,6,4,12,16,36,63,0.5714285714285714,0
52,95,0.547,10,29,0.345,11,18,0.611,11,31,42,36,8,8,9,14,42,66,0.6363636363636364,1
34,88,0.386,13,40,0.325,16,23,0.696,9,31,40,27,7,2,13,16,21,48,0.4375,0
41,86,0.477,10,42,0.238,22,24,0.917,9,42,51,26,8,5,12,19,31,44,0.7045454545454546,1
49,100,0.49,15,40,0.375,8,12,0.667,14,31,45,34,7,10,3,11,34,60,0.5666666666666667,1
39,87,0.448,10,28,0.357,11,11,1.0,9,29,38,23,3,5,11,11,29,59,0.4915254237288136,0
46,93,0.495,12,27,0.444,8,12,0.667,10,35,45,28,7,4,14,19,34,66,0.5151515151515151,1
39,93,0.419,14,37,0.378,10,15,0.667,13,37,50,27,6,10,15,15,25,56,0.44642857142857145,0
48,94,0.511,12,33,0.364,10,14,0.714,19,29,48,26,11,6,11,20,36,61,0.5901639344262295,1
34,72,0.472,11,30,0.367,21,25,0.84,8,26,34,22,7,4,18,18,23,42,0.5476190476190477,0
37,82,0.451,11,36,0.306,12,16,0.75,4,24,28,26,9,3,13,18,26,46,0.5652173913043478,0
42,94,0.447,8,33,0.242,17,21,0.81,17,36,53,27,8,7,18,19,34,61,0.5573770491803278,1
30,80,0.375,8,33,0.242,11,16,0.688,7,24,31,17,7,4,8,16,22,47,0.46808510638297873,0
40,79,0.506,14,40,0.35,12,15,0.8,9,42,51,32,4,4,13,15,26,39,0.6666666666666666,1
48,89,0.539,9,28,0.321,16,19,0.842,4,39,43,34,8,10,9,11,39,61,0.639344262295082,1
43,99,0.434,14,37,0.378,11,15,0.733,13,37,50,24,5,4,13,16,29,62,0.46774193548387094,0
30,82,0.366,7,39,0.179,27,35,0.771,10,34,44,23,3,2,13,18,23,43,0.5348837209302325,0
49,92,0.533,18,40,0.45,13,16,0.813,6,45,51,34,11,1,9,26,31,52,0.5961538461538461,1
37,80,0.463,10,32,0.313,19,21,0.905,8,28,36,21,10,5,13,19,27,48,0.5625,1
39,82,0.476,11,36,0.306,12,14,0.857,10,32,42,30,9,5,15,20,28,46,0.6086956521739131,0
43,92,0.467,20,49,0.408,17,19,0.895,14,32,46,25,5,8,9,14,23,43,0.5348837209302325,1
41,86,0.477,15,32,0.469,10,11,0.909,9,29,38,23,4,7,10,18,26,54,0.48148148148148145,0
37,92,0.402,9,28,0.321,16,19,0.842,15,27,42,19,9,3,17,20,28,64,0.4375,0
44,82,0.537,6,27,0.222,15,19,0.789,9,33,42,30,6,13,17,16,38,55,0.6909090909090909,1
41,93,0.441,9,36,0.25,13,19,0.684,3,34,37,32,13,8,11,20,32,57,0.5614035087719298,0
39,88,0.443,11,30,0.367,24,31,0.774,11,47,58,27,7,7,22,21,28,58,0.4827586206896552,1
48,92,0.522,10,28,0.357,26,32,0.813,7,41,48,22,6,5,12,21,38,64,0.59375,1
46,99,0.465,14,45,0.311,23,28,0.821,9,38,47,30,4,6,9,25,32,54,0.5925925925925926,0
44,82,0.537,13,36,0.361,9,13,0.692,6,29,35,26,12,7,20,11,31,46,0.6739130434782609,1
36,85,0.424,16,40,0.4,10,11,0.909,16,30,46,24,12,5,24,19,20,45,0.4444444444444444,0
40,82,0.488,11,33,0.333,9,13,0.692,7,34,41,24,4,2,10,13,29,49,0.5918367346938775,1
34,80,0.425,5,21,0.238,15,18,0.833,8,34,42,18,5,2,9,13,29,59,0.4915254237288136,0
47,92,0.511,20,45,0.444,2,3,0.667,8,38,46,38,4,4,12,18,27,47,0.574468085106383,1
35,80,0.438,4,22,0.182,21,26,0.808,7,36,43,22,7,6,12,13,31,58,0.5344827586206896,0
38,81,0.469,7,26,0.269,23,27,0.852,8,24,32,21,7,4,13,19,31,55,0.5636363636363636,0
40,77,0.519,14,32,0.438,20,26,0.769,6,28,34,29,6,6,13,20,26,45,0.5777777777777777,1
38,88,0.432,14,39,0.359,12,18,0.667,13,25,38,19,11,6,15,23,24,49,0.4897959183673469,0
38,82,0.463,10,30,0.333,20,24,0.833,12,37,49,24,7,5,18,21,28,52,0.5384615384615384,1
38,78,0.487,14,32,0.438,17,22,0.773,7,31,38,25,8,2,14,12,24,46,0.5217391304347826,0
46,88,0.523,19,41,0.463,9,12,0.75,9,35,44,30,11,2,14,19,27,47,0.574468085106383,1
47,99,0.475,11,31,0.355,7,10,0.7,19,32,51,27,4,3,14,12,36,68,0.5294117647058824,0
47,89,0.528,25,50,0.5,8,11,0.727,6,27,33,31,12,5,10,13,22,39,0.5641025641025641,1
48,80,0.6,20,40,0.5,10,14,0.714,6,29,35,32,9,2,10,16,28,40,0.7,1
41,86,0.477,16,35,0.457,13,16,0.813,11,25,36,28,4,2,13,14,25,51,0.49019607843137253,0
46,93,0.495,12,38,0.316,15,19,0.789,7,25,32,29,11,2,14,19,34,55,0.6181818181818182,0
51,87,0.586,12,28,0.429,21,24,0.875,8,39,47,24,7,1,19,19,39,59,0.6610169491525424,1
39,79,0.494,17,35,0.486,10,14,0.714,6,24,30,20,6,4,13,18,22,44,0.5,0
39,72,0.542,16,36,0.444,20,24,0.833,6,31,37,29,6,4,15,14,23,36,0.6388888888888888,1
43,84,0.512,12,29,0.414,21,26,0.808,10,30,40,25,6,2,19,20,31,55,0.5636363636363636,0
45,86,0.523,16,39,0.41,20,23,0.87,8,26,34,28,10,7,13,24,29,47,0.6170212765957447,1
38,87,0.437,6,29,0.207,23,26,0.885,15,35,50,16,11,1,15,18,32,58,0.5517241379310345,1
34,84,0.405,11,33,0.333,14,16,0.875,13,32,45,19,10,2,18,19,23,51,0.45098039215686275,0
40,87,0.46,11,38,0.289,16,20,0.8,10,47,57,31,3,3,10,20,29,49,0.5918367346938775,1
35,94,0.372,6,37,0.162,20,27,0.741,12,36,48,20,6,3,5,16,29,57,0.5087719298245614,0
43,91,0.473,7,34,0.206,15,21,0.714,9,35,44,23,14,6,8,16,36,57,0.631578947368421,1
36,84,0.429,10,38,0.263,13,15,0.867,9,39,48,27,5,2,18,16,26,46,0.5652173913043478,0
37,77,0.481,12,33,0.364,18,19,0.947,5,32,37,18,6,8,15,17,25,44,0.5681818181818182,0
42,87,0.483,13,35,0.371,15,20,0.75,9,31,40,28,8,2,9,21,29,52,0.5576923076923077,1
49,89,0.551,10,25,0.4,9,12,0.75,7,33,40,37,13,5,13,20,39,64,0.609375,1
37,81,0.457,11,29,0.379,21,27,0.778,12,32,44,23,6,4,17,13,26,52,0.5,0
40,80,0.5,14,31,0.452,19,22,0.864,6,33,39,25,7,4,15,15,26,49,0.5306122448979592,1
38,81,0.469,14,34,0.412,13,20,0.65,9,31,40,24,11,4,16,24,24,47,0.5106382978723404,0
41,92,0.446,20,39,0.513,20,27,0.741,11,30,41,32,7,5,9,16,21,53,0.39622641509433965,0
46,90,0.511,14,36,0.389,18,20,0.9,10,39,49,24,6,7,13,21,32,54,0.5925925925925926,1
36,84,0.429,13,32,0.406,13,22,0.591,9,23,32,27,12,7,16,21,23,52,0.4423076923076923,0
49,85,0.576,8,24,0.333,21,29,0.724,12,39,51,33,9,4,15,16,41,61,0.6721311475409836,1
37,82,0.451,12,38,0.316,17,20,0.85,7,38,45,22,6,7,16,12,25,44,0.5681818181818182,0
47,98,0.48,15,42,0.357,8,12,0.667,11,37,48,28,9,7,10,19,32,56,0.5714285714285714,1
33,77,0.429,10,25,0.4,24,31,0.774,12,33,45,18,8,3,21,18,23,52,0.4423076923076923,0
50,105,0.476,6,30,0.2,15,16,0.938,17,33,50,21,13,4,13,23,44,75,0.5866666666666667,1
51,97,0.526,14,34,0.412,12,15,0.8,14,31,45,38,3,4,7,19,37,63,0.5873015873015873,1
47,92,0.511,12,34,0.353,15,18,0.833,8,31,39,32,3,4,10,13,35,58,0.603448275862069,0
45,87,0.517,12,35,0.343,16,21,0.762,8,37,45,25,7,8,12,19,33,52,0.6346153846153846,1
37,81,0.457,18,44,0.409,20,26,0.769,7,29,36,34,7,4,14,20,19,37,0.5135135135135135,0
42,84,0.5,12,33,0.364,11,12,0.917,10,26,36,23,3,7,20,15,30,51,0.5882352941176471,0
52,97,0.536,13,33,0.394,9,10,0.9,10,29,39,36,8,5,10,13,39,64,0.609375,1
37,82,0.451,10,31,0.323,14,18,0.778,12,28,40,21,11,4,16,21,27,51,0.5294117647058824,0
36,81,0.444,13,41,0.317,24,25,0.96,10,31,41,25,9,4,16,23,23,40,0.575,1
37,86,0.43,11,39,0.282,13,16,0.813,10,42,52,19,8,9,16,21,26,47,0.5531914893617021,1
30,85,0.353,10,37,0.27,21,26,0.808,11,31,42,22,7,5,12,20,20,48,0.4166666666666667,0
44,93,0.473,19,41,0.463,12,15,0.8,7,37,44,31,8,6,9,16,25,52,0.4807692307692308,1
38,83,0.458,6,26,0.231,18,21,0.857,10,41,51,23,4,5,16,14,32,57,0.5614035087719298,0
37,84,0.44,12,28,0.429,19,22,0.864,6,31,37,26,7,6,8,16,25,56,0.44642857142857145,0
42,100,0.42,9,35,0.257,14,21,0.667,22,38,60,22,5,5,12,21,33,65,0.5076923076923077,1
40,89,0.449,12,35,0.343,12,16,0.75,11,36,47,24,7,2,10,11,28,54,0.5185185185185185,1
38,83,0.458,14,36,0.389,11,14,0.786,7,37,44,24,4,7,12,19,24,47,0.5106382978723404,0
41,84,0.488,17,34,0.5,11,12,0.917,10,35,45,32,10,7,16,22,24,50,0.48,1
28,74,0.378,11,36,0.306,26,29,0.897,10,30,40,17,10,5,16,13,17,38,0.4473684210526316,0
51,87,0.586,14,33,0.424,13,15,0.867,7,32,39,36,7,5,14,16,37,54,0.6851851851851852,0
51,94,0.543,24,41,0.585,14,14,1.0,10,25,35,35,11,2,11,12,27,53,0.5094339622641509,1
37,84,0.44,8,31,0.258,14,15,0.933,11,26,37,23,7,3,18,18,29,53,0.5471698113207547,0
43,85,0.506,11,36,0.306,14,20,0.7,10,29,39,22,7,4,15,16,32,49,0.6530612244897959,1
47,102,0.461,8,31,0.258,13,19,0.684,11,37,48,29,13,5,12,20,39,71,0.5492957746478874,0
46,99,0.465,9,37,0.243,21,23,0.913,13,37,50,30,6,10,18,17,37,62,0.5967741935483871,1
43,87,0.494,24,50,0.48,20,24,0.833,12,31,43,30,9,6,15,17,19,37,0.5135135135135135,1
41,89,0.461,10,34,0.294,12,14,0.857,10,30,40,24,3,5,16,20,31,55,0.5636363636363636,0
36,84,0.429,9,29,0.31,13,15,0.867,8,35,43,21,6,3,13,15,27,55,0.4909090909090909,0
43,95,0.453,22,49,0.449,11,13,0.846,15,38,53,30,8,8,11,9,21,46,0.45652173913043476,1
40,88,0.455,8,28,0.286,19,25,0.76,13,30,43,21,7,5,13,24,32,60,0.5333333333333333,0
41,93,0.441,11,33,0.333,17,21,0.81,13,27,40,26,9,5,9,21,30,60,0.5,1
44,91,0.484,14,37,0.378,17,20,0.85,14,30,44,29,6,1,13,17,30,54,0.5555555555555556,1
42,88,0.477,14,36,0.389,14,18,0.778,12,27,39,29,7,5,13,16,28,52,0.5384615384615384,0
38,80,0.475,12,32,0.375,20,28,0.714,9,30,39,27,8,4,14,18,26,48,0.5416666666666666,1
42,91,0.462,9,38,0.237,10,16,0.625,14,31,45,28,8,3,11,24,33,53,0.6226415094339622,0
42,98,0.429,9,41,0.22,12,15,0.8,12,30,42,32,8,5,9,14,33,57,0.5789473684210527,0
52,90,0.578,15,36,0.417,17,20,0.85,4,44,48,39,6,4,9,15,37,54,0.6851851851851852,1
35,89,0.393,12,33,0.364,9,14,0.643,11,38,49,23,8,3,15,13,23,56,0.4107142857142857,0
37,85,0.435,13,36,0.361,11,12,0.917,7,39,46,23,7,12,12,16,24,49,0.4897959183673469,1
37,98,0.378,13,38,0.342,24,30,0.8,15,34,49,22,13,7,14,23,24,60,0.4,0
42,94,0.447,11,35,0.314,26,32,0.813,15,44,59,30,7,10,19,25,31,59,0.5254237288135594,1
44,91,0.484,16,41,0.39,10,12,0.833,12,23,35,27,9,9,9,15,28,50,0.56,1
39,84,0.464,14,32,0.438,12,14,0.857,14,33,47,25,6,3,17,13,25,52,0.4807692307692308,0
42,83,0.506,10,34,0.294,10,13,0.769,11,37,48,29,7,5,14,19,32,49,0.6530612244897959,1
31,84,0.369,12,40,0.3,17,22,0.773,14,28,42,19,6,4,14,13,19,44,0.4318181818181818,0
42,81,0.519,14,27,0.519,17,22,0.773,11,38,49,26,5,1,17,19,28,54,0.5185185185185185,1
42,88,0.477,12,35,0.343,16,23,0.696,8,29,37,25,10,7,7,16,30,53,0.5660377358490566,0
38,79,0.481,9,29,0.31,7,9,0.778,4,26,30,19,8,1,17,13,29,50,0.58,0
44,81,0.543,12,34,0.353,12,13,0.923,10,31,41,32,10,6,18,10,32,47,0.6808510638297872,1
44,91,0.484,10,30,0.333,15,17,0.882,3,37,40,31,6,3,9,18,34,61,0.5573770491803278,1
39,89,0.438,14,39,0.359,15,21,0.714,9,39,48,31,6,10,16,14,25,50,0.5,0
47,91,0.516,13,39,0.333,30,36,0.833,12,35,47,25,6,11,7,15,34,52,0.6538461538461539,1
42,98,0.429,15,39,0.385,15,20,0.75,17,27,44,24,6,2,11,27,27,59,0.4576271186440678,0
45,84,0.536,17,35,0.486,12,14,0.857,9,32,41,20,3,6,15,25,28,49,0.5714285714285714,0
40,85,0.471,18,40,0.45,24,29,0.828,11,26,37,25,6,5,9,18,22,45,0.4888888888888889,1
38,83,0.458,13,36,0.361,18,19,0.947,7,30,37,19,7,2,8,20,25,47,0.5319148936170213,1
35,75,0.467,15,42,0.357,19,22,0.864,6,31,37,30,3,2,12,19,20,33,0.6060606060606061,0
50,88,0.568,11,29,0.379,11,18,0.611,5,35,40,38,13,6,13,16,39,59,0.6610169491525424,1
37,90,0.411,5,23,0.217,24,30,0.8,12,34,46,23,8,1,15,14,32,67,0.47761194029850745,0
42,96,0.438,18,49,0.367,14,18,0.778,16,29,45,29,4,3,12,15,24,47,0.5106382978723404,0
58,100,0.58,19,39,0.487,2,6,0.333,13,35,48,43,6,5,7,17,39,61,0.639344262295082,1
40,90,0.444,10,36,0.278,17,18,0.944,11,36,47,20,6,5,16,22,30,54,0.5555555555555556,0
43,88,0.489,10,34,0.294,23,29,0.793,10,35,45,29,10,7,10,16,33,54,0.6111111111111112,1
41,95,0.432,13,37,0.351,7,18,0.389,13,27,40,33,12,7,11,12,28,58,0.4827586206896552,0
45,90,0.5,19,39,0.487,6,8,0.75,14,41,55,34,7,12,23,18,26,51,0.5098039215686274,1
45,86,0.523,13,31,0.419,13,15,0.867,8,34,42,29,15,7,12,13,32,55,0.5818181818181818,1
39,81,0.481,15,34,0.441,10,15,0.667,8,30,38,21,6,4,17,16,24,47,0.5106382978723404,0
48,93,0.516,12,40,0.3,15,18,0.833,18,35,53,32,14,6,16,16,36,53,0.6792452830188679,1
33,80,0.413,10,31,0.323,13,18,0.722,11,20,31,21,11,3,22,15,23,49,0.46938775510204084,0
38,83,0.458,4,30,0.133,17,19,0.895,5,33,38,29,6,3,18,23,34,53,0.6415094339622641,0
43,86,0.5,10,32,0.313,17,28,0.607,11,32,43,33,12,3,13,20,33,54,0.6111111111111112,1
38,79,0.481,11,31,0.355,13,17,0.765,4,27,31,28,6,6,10,18,27,48,0.5625,0
45,84,0.536,6,20,0.3,17,20,0.85,9,33,42,31,5,4,10,14,39,64,0.609375,1
42,93,0.452,12,31,0.387,21,25,0.84,12,31,43,23,8,3,11,17,30,62,0.4838709677419355,0
47,93,0.505,17,45,0.378,16,20,0.8,13,36,49,27,7,6,16,21,30,48,0.625,1
41,92,0.446,13,44,0.295,13,16,0.813,15,34,49,29,7,1,14,12,28,48,0.5833333333333334,0
43,91,0.473,16,41,0.39,13,15,0.867,11,29,40,27,5,4,10,17,27,50,0.54,1
42,78,0.538,6,20,0.3,16,21,0.762,3,30,33,24,11,1,19,18,36,58,0.6206896551724138,0
47,86,0.547,14,36,0.389,13,19,0.684,10,30,40,33,12,4,16,16,33,50,0.66,1
40,91,0.44,12,35,0.343,23,29,0.793,12,24,36,27,11,3,11,23,28,56,0.5,0
41,74,0.554,22,41,0.537,24,27,0.889,7,31,38,28,4,11,17,19,19,33,0.5757575757575758,1
37,86,0.43,11,39,0.282,17,19,0.895,10,27,37,21,12,7,15,20,26,47,0.5531914893617021,0
41,81,0.506,10,25,0.4,17,23,0.739,10,35,45,20,9,3,20,19,31,56,0.5535714285714286,1
47,89,0.528,16,45,0.356,19,27,0.704,8,27,35,31,9,5,7,15,31,44,0.7045454545454546,1
42,83,0.506,9,31,0.29,9,13,0.692,8,34,42,25,4,1,19,23,33,52,0.6346153846153846,0
48,99,0.485,15,36,0.417,12,16,0.75,12,38,50,32,8,10,11,14,33,63,0.5238095238095238,1
43,106,0.406,14,48,0.292,11,16,0.688,24,40,64,24,6,6,14,15,29,58,0.5,0
33,96,0.344,8,37,0.216,20,24,0.833,13,29,42,20,13,7,9,23,25,59,0.423728813559322,0
32,73,0.438,12,31,0.387,25,33,0.758,11,43,54,22,1,7,21,16,20,42,0.47619047619047616,1
42,82,0.512,18,36,0.5,9,12,0.75,12,44,56,25,3,2,13,13,24,46,0.5217391304347826,1
31,86,0.36,13,47,0.277,13,15,0.867,7,27,34,22,3,4,6,9,18,39,0.46153846153846156,0
34,81,0.42,7,29,0.241,16,19,0.842,10,31,41,22,6,5,12,14,27,52,0.5192307692307693,0
41,85,0.482,14,27,0.519,8,16,0.5,13,33,46,27,9,5,12,12,27,58,0.46551724137931033,1
44,77,0.571,14,33,0.424,23,27,0.852,7,33,40,26,8,8,17,21,30,44,0.6818181818181818,1
45,93,0.484,12,33,0.364,15,25,0.6,15,26,41,29,11,1,10,19,33,60,0.55,0
33,82,0.402,12,34,0.353,21,31,0.677,9,42,51,18,10,4,18,17,21,48,0.4375,1
37,95,0.389,7,38,0.184,16,23,0.696,15,41,56,24,12,7,16,23,30,57,0.5263157894736842,0
48,95,0.505,12,32,0.375,15,19,0.789,13,33,46,27,17,5,16,20,36,63,0.5714285714285714,1
40,76,0.526,11,30,0.367,12,17,0.706,5,31,36,34,12,3,27,18,29,46,0.6304347826086957,0
35,84,0.417,11,39,0.282,10,14,0.714,11,28,39,25,3,4,15,9,24,45,0.5333333333333333,0
50,90,0.556,20,42,0.476,12,14,0.857,11,32,43,40,9,5,9,14,30,48,0.625,1
44,86,0.512,21,48,0.438,15,17,0.882,12,29,41,28,5,3,12,9,23,38,0.6052631578947368,1
47,82,0.573,9,24,0.375,10,11,0.909,3,26,29,36,7,3,7,18,38,58,0.6551724137931034,0
40,89,0.449,11,37,0.297,28,33,0.848,12,28,40,24,2,4,10,11,29,52,0.5576923076923077,0
54,97,0.557,27,49,0.551,12,14,0.857,12,32,44,31,7,3,9,26,27,48,0.5625,1
34,76,0.447,12,34,0.353,13,15,0.867,8,33,41,26,5,6,15,15,22,42,0.5238095238095238,0
42,97,0.433,15,40,0.375,6,12,0.5,16,31,47,25,10,4,10,15,27,57,0.47368421052631576,1
38,87,0.437,15,40,0.375,18,21,0.857,6,36,42,26,6,5,7,19,23,47,0.48936170212765956,1
42,88,0.477,10,35,0.286,13,18,0.722,12,37,49,27,5,3,13,20,32,53,0.6037735849056604,0
41,91,0.451,8,24,0.333,24,33,0.727,19,30,49,25,8,9,14,17,33,67,0.4925373134328358,1
43,93,0.462,10,28,0.357,15,17,0.882,14,31,45,27,8,8,16,24,33,65,0.5076923076923077,0
56,94,0.596,11,24,0.458,8,10,0.8,7,32,39,38,11,5,10,18,45,70,0.6428571428571429,1
40,85,0.471,9,33,0.273,17,21,0.81,8,26,34,27,6,6,15,9,31,52,0.5961538461538461,0
40,94,0.426,8,33,0.242,21,26,0.808,13,29,42,27,9,7,12,20,32,61,0.5245901639344263,0
44,92,0.478,11,35,0.314,13,19,0.684,16,39,55,28,7,8,18,18,33,57,0.5789473684210527,1
41,81,0.506,11,34,0.324,21,31,0.677,6,35,41,27,8,7,10,22,30,47,0.6382978723404256,1
32,79,0.405,11,41,0.268,26,32,0.813,10,36,46,20,4,5,17,25,21,38,0.5526315789473685,0
48,90,0.533,18,37,0.486,7,9,0.778,12,25,37,32,7,10,8,18,30,53,0.5660377358490566,1
40,83,0.482,10,28,0.357,17,18,0.944,10,27,37,27,2,9,14,11,30,55,0.5454545454545454,0
59,107,0.551,18,36,0.5,9,16,0.563,10,30,40,39,6,4,11,31,41,71,0.5774647887323944,0
50,89,0.562,12,25,0.48,38,43,0.884,8,33,41,28,6,7,10,14,38,64,0.59375,1
30,72,0.417,9,29,0.31,15,20,0.75,4,26,30,24,3,3,17,16,21,43,0.4883720930232558,0
43,83,0.518,15,38,0.395,20,23,0.87,9,35,44,29,13,0,12,17,28,45,0.6222222222222222,1
33,89,0.371,10,43,0.233,17,22,0.773,10,27,37,20,9,1,12,16,23,46,0.5,0
49,92,0.533,11,34,0.324,9,14,0.643,15,42,57,33,7,5,17,21,38,58,0.6551724137931034,1
38,85,0.447,14,36,0.389,20,26,0.769,7,34,41,23,8,3,13,19,24,49,0.4897959183673469,0
40,84,0.476,21,40,0.525,13,18,0.722,7,37,44,30,9,5,16,17,19,44,0.4318181818181818,1
47,95,0.495,11,38,0.289,13,19,0.684,12,26,38,21,7,8,9,16,36,57,0.631578947368421,0
46,87,0.529,18,36,0.5,10,17,0.588,15,29,44,30,5,3,13,18,28,51,0.5490196078431373,1
39,97,0.402,14,49,0.286,15,18,0.833,14,38,52,32,8,5,14,21,25,48,0.5208333333333334,1
36,87,0.414,10,35,0.286,23,28,0.821,9,37,46,27,9,8,12,14,26,52,0.5,0
34,80,0.425,9,28,0.321,15,18,0.833,6,27,33,22,5,4,12,13,25,52,0.4807692307692308,0
46,86,0.535,17,41,0.415,6,10,0.6,9,38,47,41,4,3,14,15,29,45,0.6444444444444445,1
37,94,0.394,11,44,0.25,18,27,0.667,17,23,40,25,9,9,17,15,26,50,0.52,0
48,90,0.533,15,32,0.469,17,18,0.944,15,35,50,38,10,7,16,23,33,58,0.5689655172413793,1
36,87,0.414,7,33,0.212,13,15,0.867,10,34,44,14,5,6,17,25,29,54,0.5370370370370371,0
37,93,0.398,12,39,0.308,24,25,0.96,13,32,45,19,7,7,9,16,25,54,0.46296296296296297,1
50,86,0.581,17,28,0.607,16,22,0.727,7,27,34,28,7,3,8,21,33,58,0.5689655172413793,1
46,85,0.541,6,20,0.3,18,22,0.818,11,25,36,26,4,4,10,19,40,65,0.6153846153846154,0
34,88,0.386,10,34,0.294,21,22,0.955,7,30,37,22,8,5,12,22,24,54,0.4444444444444444,0
45,89,0.506,19,46,0.413,15,22,0.682,12,40,52,30,6,6,14,18,26,43,0.6046511627906976,1
34,82,0.415,11,34,0.324,17,20,0.85,15,32,47,18,2,4,15,25,23,48,0.4791666666666667,0
38,86,0.442,10,38,0.263,22,28,0.786,11,29,40,25,6,6,8,18,28,48,0.5833333333333334,1
42,83,0.506,10,28,0.357,8,14,0.571,5,42,47,28,5,7,15,14,32,55,0.5818181818181818,0
40,91,0.44,8,31,0.258,16,19,0.842,5,35,40,23,10,1,7,15,32,60,0.5333333333333333,1
37,81,0.457,9,39,0.231,13,18,0.722,16,34,50,20,3,4,20,16,28,42,0.6666666666666666,1
37,85,0.435,5,27,0.185,9,12,0.75,8,22,30,23,10,2,10,15,32,58,0.5517241379310345,0
44,92,0.478,12,42,0.286,15,18,0.833,10,37,47,31,9,7,6,17,32,50,0.64,1
37,87,0.425,13,39,0.333,18,22,0.818,11,35,46,28,6,3,13,15,24,48,0.5,0
47,85,0.553,13,38,0.342,6,10,0.6,7,36,43,31,6,5,12,20,34,47,0.723404255319149,1
37,92,0.402,8,33,0.242,10,13,0.769,11,28,39,24,3,2,9,9,29,59,0.4915254237288136,0
42,108,0.389,14,44,0.318,30,32,0.938,15,54,69,30,4,8,17,13,28,64,0.4375,1
49,119,0.412,15,51,0.294,11,17,0.647,15,46,61,37,9,5,14,26,34,68,0.5,0
46,86,0.535,15,34,0.441,12,14,0.857,7,38,45,28,5,3,12,17,31,52,0.5961538461538461,1
39,86,0.453,14,38,0.368,20,23,0.87,5,32,37,26,7,2,10,18,25,48,0.5208333333333334,0
51,92,0.554,22,39,0.564,8,13,0.615,5,44,49,34,10,4,9,18,29,53,0.5471698113207547,1
35,90,0.389,11,30,0.367,15,19,0.789,11,31,42,27,6,5,14,15,24,60,0.4,0
43,85,0.506,14,31,0.452,6,10,0.6,6,27,33,35,8,2,19,18,29,54,0.5370370370370371,0
44,85,0.518,16,41,0.39,16,20,0.8,8,33,41,23,12,9,17,17,28,44,0.6363636363636364,1
34,85,0.4,13,42,0.31,18,23,0.783,12,28,40,25,3,4,13,23,21,43,0.4883720930232558,0
49,98,0.5,12,27,0.444,15,18,0.833,13,41,54,28,7,5,8,19,37,71,0.5211267605633803,1
42,85,0.494,19,44,0.432,8,14,0.571,9,23,32,33,7,1,15,21,23,41,0.5609756097560976,0
44,76,0.579,13,33,0.394,17,22,0.773,8,30,38,30,8,2,16,14,31,43,0.7209302325581395,1
39,83,0.47,16,33,0.485,10,11,0.909,12,39,51,29,3,7,17,13,23,50,0.46,1
38,88,0.432,10,40,0.25,11,12,0.917,9,29,38,24,9,4,8,13,28,48,0.5833333333333334,0
45,81,0.556,18,33,0.545,28,35,0.8,4,39,43,31,5,4,16,19,27,48,0.5625,1
46,97,0.474,17,43,0.395,15,19,0.789,13,26,39,30,10,3,14,23,29,54,0.5370370370370371,0
31,81,0.383,9,32,0.281,20,25,0.8,10,31,41,15,9,1,12,14,22,49,0.4489795918367347,0
42,82,0.512,11,36,0.306,11,16,0.688,9,31,40,28,8,3,12,17,31,46,0.6739130434782609,1
50,104,0.481,15,43,0.349,17,23,0.739,16,34,50,25,10,3,16,24,35,61,0.5737704918032787,1
47,96,0.49,14,38,0.368,18,24,0.75,13,36,49,26,7,7,19,24,33,58,0.5689655172413793,0
40,90,0.444,10,34,0.294,11,13,0.846,12,40,52,26,5,5,13,18,30,56,0.5357142857142857,1
36,85,0.424,10,32,0.313,11,21,0.524,10,29,39,25,10,5,11,13,26,53,0.49056603773584906,0
40,90,0.444,14,36,0.389,14,20,0.7,11,32,43,28,8,5,8,16,26,54,0.48148148148148145,1
39,82,0.476,13,33,0.394,16,19,0.842,10,41,51,17,3,11,12,18,26,49,0.5306122448979592,0
55,94,0.585,22,44,0.5,13,16,0.813,15,27,42,37,7,8,11,17,33,50,0.66,1
39,84,0.464,11,31,0.355,12,13,0.923,11,17,28,31,7,4,18,17,28,53,0.5283018867924528,0
44,86,0.512,16,33,0.485,14,21,0.667,9,32,41,40,9,7,21,21,28,53,0.5283018867924528,1
39,83,0.47,13,35,0.371,20,22,0.909,6,30,36,25,8,4,22,16,26,48,0.5416666666666666,0
47,98,0.48,10,33,0.303,18,23,0.783,10,35,45,24,8,9,8,16,37,65,0.5692307692307692,1
46,91,0.505,14,34,0.412,13,17,0.765,5,39,44,26,4,4,14,21,32,57,0.5614035087719298,0
45,94,0.479,14,36,0.389,18,21,0.857,9,34,43,28,7,6,12,15,31,58,0.5344827586206896,0
51,104,0.49,15,44,0.341,6,10,0.6,17,36,53,24,5,5,11,17,36,60,0.6,1
38,82,0.463,14,39,0.359,10,19,0.526,5,41,46,21,1,4,14,25,24,43,0.5581395348837209,0
36,91,0.396,8,32,0.25,27,34,0.794,11,37,48,22,11,5,7,19,28,59,0.4745762711864407,1
38,75,0.507,9,30,0.3,23,29,0.793,5,39,44,24,3,6,13,18,29,45,0.6444444444444445,0
43,91,0.473,25,44,0.568,14,22,0.636,12,31,43,26,9,3,7,22,18,47,0.3829787234042553,1
48,89,0.539,11,32,0.344,8,9,0.889,11,39,50,35,7,5,13,19,37,57,0.6491228070175439,1
34,84,0.405,12,46,0.261,17,24,0.708,12,29,41,23,4,2,11,10,22,38,0.5789473684210527,0
42,94,0.447,16,40,0.4,14,17,0.824,16,26,42,28,6,7,9,20,26,54,0.48148148148148145,0
45,82,0.549,16,37,0.432,11,13,0.846,5,32,37,34,4,3,14,17,29,45,0.6444444444444445,1
38,74,0.514,9,28,0.321,26,37,0.703,6,33,39,28,6,7,9,20,29,46,0.6304347826086957,1
35,88,0.398,8,28,0.286,20,27,0.741,13,33,46,29,6,1,13,24,27,60,0.45,0
35,86,0.407,5,30,0.167,15,18,0.833,10,38,48,24,3,3,16,14,30,56,0.5357142857142857,0
43,89,0.483,10,31,0.323,13,14,0.929,6,40,46,27,8,6,10,14,33,58,0.5689655172413793,1
35,87,0.402,5,30,0.167,7,11,0.636,10,33,43,20,4,2,24,19,30,57,0.5263157894736842,0
54,92,0.587,21,39,0.538,13,18,0.722,6,38,44,41,17,4,9,13,33,53,0.6226415094339622,1
39,87,0.448,13,41,0.317,12,15,0.8,13,26,39,26,6,6,14,15,26,46,0.5652173913043478,0
49,87,0.563,16,30,0.533,14,14,1.0,7,31,38,33,7,7,11,13,33,57,0.5789473684210527,1
41,85,0.482,8,24,0.333,10,12,0.833,12,29,41,19,11,4,17,17,33,61,0.5409836065573771,1
38,86,0.442,10,29,0.345,11,15,0.733,13,25,38,20,10,8,17,11,28,57,0.49122807017543857,0
35,74,0.473,15,35,0.429,22,33,0.667,6,36,42,24,4,6,10,12,20,39,0.5128205128205128,1
40,92,0.435,15,32,0.469,8,12,0.667,10,35,45,24,9,1,11,22,25,60,0.4166666666666667,0
51,110,0.464,14,37,0.378,10,12,0.833,18,32,50,24,10,1,12,24,37,73,0.5068493150684932,0
44,82,0.537,16,40,0.4,26,32,0.813,8,38,46,34,3,2,15,16,28,42,0.6666666666666666,1
35,91,0.385,13,42,0.31,18,28,0.643,15,30,45,19,10,6,10,18,22,49,0.4489795918367347,1
37,80,0.463,8,31,0.258,18,19,0.947,11,40,51,23,4,9,21,23,29,49,0.5918367346938775,0
37,89,0.416,6,24,0.25,16,20,0.8,8,39,47,19,9,5,13,18,31,65,0.47692307692307695,1
36,88,0.409,9,33,0.273,6,8,0.75,9,38,47,22,2,4,19,18,27,55,0.4909090909090909,0
43,78,0.551,8,28,0.286,28,35,0.8,6,34,40,27,7,5,12,18,35,50,0.7,1
42,92,0.457,14,35,0.4,15,18,0.833,9,30,39,24,5,3,11,26,28,57,0.49122807017543857,0
39,82,0.476,15,37,0.405,11,12,0.917,8,43,51,27,7,7,13,13,24,45,0.5333333333333333,1
34,86,0.395,13,35,0.371,11,18,0.611,10,31,41,22,9,3,9,12,21,51,0.4117647058823529,0
31,86,0.36,12,36,0.333,14,17,0.824,13,32,45,25,11,7,19,19,19,50,0.38,0
38,78,0.487,22,44,0.5,20,23,0.87,5,38,43,28,8,8,17,16,16,34,0.47058823529411764,1
42,77,0.545,15,40,0.375,17,22,0.773,6,44,50,24,8,6,20,15,27,37,0.7297297297297297,1
39,92,0.424,12,36,0.333,14,19,0.737,9,29,38,19,12,3,13,17,27,56,0.48214285714285715,0
43,75,0.573,14,29,0.483,30,34,0.882,7,34,41,28,4,5,10,16,29,46,0.6304347826086957,1
44,88,0.5,23,52,0.442,7,11,0.636,5,26,31,32,3,2,9,25,21,36,0.5833333333333334,0
38,82,0.463,8,25,0.32,17,21,0.81,6,22,28,26,10,4,15,12,30,57,0.5263157894736842,0
50,87,0.575,21,33,0.636,9,13,0.692,11,40,51,36,7,4,17,19,29,54,0.5370370370370371,1
48,93,0.516,24,47,0.511,5,9,0.556,10,37,47,24,7,8,14,17,24,46,0.5217391304347826,1
39,92,0.424,13,38,0.342,16,19,0.842,12,31,43,22,9,3,12,14,26,54,0.48148148148148145,0
42,80,0.525,17,29,0.586,8,12,0.667,8,35,43,30,11,3,16,18,25,51,0.49019607843137253,1
38,81,0.469,11,37,0.297,14,21,0.667,8,29,37,28,12,5,14,10,27,44,0.6136363636363636,0
44,82,0.537,13,34,0.382,12,24,0.5,9,34,43,29,6,8,13,23,31,48,0.6458333333333334,1
38,92,0.413,13,43,0.302,23,34,0.676,15,31,46,24,8,3,11,19,25,49,0.5102040816326531,0
34,83,0.41,16,41,0.39,22,28,0.786,11,22,33,22,6,4,12,18,18,42,0.42857142857142855,0
45,84,0.536,20,40,0.5,17,23,0.739,13,31,44,34,8,6,15,23,25,44,0.5681818181818182,1
45,92,0.489,16,39,0.41,11,13,0.846,12,29,41,34,15,3,16,14,29,53,0.5471698113207547,1
40,89,0.449,17,43,0.395,16,18,0.889,16,29,45,31,7,5,19,12,23,46,0.5,0
49,83,0.59,24,43,0.558,13,16,0.813,9,30,39,28,6,10,16,17,25,40,0.625,1
47,90,0.522,11,30,0.367,15,20,0.75,7,23,30,31,10,2,12,14,36,60,0.6,0
40,81,0.494,14,36,0.389,25,29,0.862,6,36,42,22,11,8,14,19,26,45,0.5777777777777777,1
40,88,0.455,11,38,0.289,16,21,0.762,7,35,42,27,6,1,16,22,29,50,0.58,0
41,82,0.5,19,40,0.475,12,18,0.667,8,37,45,29,4,5,15,21,22,42,0.5238095238095238,1
37,94,0.394,7,28,0.25,20,24,0.833,16,35,51,17,8,2,8,17,30,66,0.45454545454545453,0
43,89,0.483,19,53,0.358,13,16,0.813,11,40,51,28,3,3,11,15,24,36,0.6666666666666666,1
41,91,0.451,13,37,0.351,9,11,0.818,8,32,40,28,3,2,7,15,28,54,0.5185185185185185,0
40,91,0.44,11,33,0.333,19,23,0.826,15,29,44,28,11,9,13,18,29,58,0.5,1
40,79,0.506,11,28,0.393,17,22,0.773,9,32,41,22,7,9,14,16,29,51,0.5686274509803921,0
41,87,0.471,10,26,0.385,19,28,0.679,12,31,43,20,3,4,15,19,31,61,0.5081967213114754,0
53,103,0.515,13,31,0.419,14,17,0.824,14,33,47,35,6,9,10,21,40,72,0.5555555555555556,1
43,87,0.494,18,47,0.383,20,25,0.8,16,33,49,29,7,6,14,21,25,40,0.625,1
42,89,0.472,11,27,0.407,16,24,0.667,12,25,37,29,10,1,9,17,31,62,0.5,0
40,90,0.444,11,31,0.355,12,15,0.8,11,33,44,28,9,3,11,21,29,59,0.4915254237288136,0
36,76,0.474,11,32,0.344,21,27,0.778,9,34,43,26,4,6,16,17,25,44,0.5681818181818182,1
42,105,0.4,13,44,0.295,8,16,0.5,15,44,59,33,4,12,8,19,29,61,0.47540983606557374,0
43,98,0.439,11,34,0.324,13,16,0.813,11,41,52,28,5,10,8,15,32,64,0.5,1
39,89,0.438,15,40,0.375,7,11,0.636,8,34,42,27,8,7,15,14,24,49,0.4897959183673469,0
41,90,0.456,15,32,0.469,7,7,1.0,11,41,52,29,9,4,17,18,26,58,0.4482758620689655,1
35,76,0.461,12,34,0.353,17,21,0.81,7,23,30,25,11,2,14,17,23,42,0.5476190476190477,0
36,74,0.486,17,38,0.447,20,21,0.952,7,32,39,24,5,4,18,17,19,36,0.5277777777777778,1
41,92,0.446,14,48,0.292,10,14,0.714,12,25,37,23,10,0,15,23,27,44,0.6136363636363636,0
41,77,0.532,11,26,0.423,20,22,0.909,6,33,39,29,12,5,18,17,30,51,0.5882352941176471,1
37,87,0.425,13,39,0.333,18,22,0.818,12,31,43,30,10,9,15,18,24,48,0.5,0
36,78,0.462,14,30,0.467,23,25,0.92,9,33,42,27,8,4,18,20,22,48,0.4583333333333333,1
31,76,0.408,11,27,0.407,22,27,0.815,9,29,38,18,6,1,16,21,20,49,0.40816326530612246,0
39,92,0.424,12,42,0.286,19,25,0.76,20,36,56,29,10,6,10,18,27,50,0.54,1
52,101,0.515,18,41,0.439,6,12,0.5,13,34,47,38,6,8,15,17,34,60,0.5666666666666667,1
43,89,0.483,10,32,0.313,15,21,0.714,5,35,40,25,11,6,17,19,33,57,0.5789473684210527,0
46,85,0.541,16,39,0.41,21,24,0.875,9,32,41,38,10,6,15,14,30,46,0.6521739130434783,1
41,85,0.482,16,37,0.432,15,18,0.833,7,26,33,26,7,3,20,22,25,48,0.5208333333333334,0
45,103,0.437,11,48,0.229,12,18,0.667,18,39,57,31,8,6,12,17,34,55,0.6181818181818182,0
47,93,0.505,9,38,0.237,14,17,0.824,5,39,44,26,9,2,11,20,38,55,0.6909090909090909,1
43,94,0.457,10,30,0.333,17,21,0.81,8,29,37,24,14,3,10,13,33,64,0.515625,0
49,90,0.544,13,38,0.342,10,15,0.667,6,42,48,36,9,8,16,13,36,52,0.6923076923076923,1
35,81,0.432,5,24,0.208,25,28,0.893,5,26,31,21,8,5,14,11,30,57,0.5263157894736842,0
50,92,0.543,17,40,0.425,18,19,0.947,11,35,46,33,7,10,11,18,33,52,0.6346153846153846,1
46,103,0.447,10,38,0.263,9,11,0.818,19,26,45,27,8,9,9,21,36,65,0.5538461538461539,0
42,87,0.483,12,32,0.375,19,27,0.704,15,35,50,22,4,8,13,16,30,55,0.5454545454545454,1
37,93,0.398,7,26,0.269,8,12,0.667,14,41,55,19,4,2,16,19,30,67,0.44776119402985076,1
32,78,0.41,5,31,0.161,17,22,0.773,2,34,36,22,10,8,11,15,27,47,0.574468085106383,0
46,91,0.505,7,23,0.304,12,17,0.706,13,41,54,25,5,8,9,12,39,68,0.5735294117647058,1
38,95,0.4,18,44,0.409,7,12,0.583,13,31,44,26,5,10,11,14,20,51,0.39215686274509803,0
33,90,0.367,7,30,0.233,12,14,0.857,10,38,48,19,4,6,21,15,26,60,0.43333333333333335,0
49,96,0.51,20,43,0.465,15,22,0.682,9,41,50,37,13,9,9,12,29,53,0.5471698113207547,1
41,80,0.513,13,32,0.406,22,30,0.733,7,32,39,27,9,2,13,20,28,48,0.5833333333333334,1
36,76,0.474,12,29,0.414,24,28,0.857,7,28,35,21,9,1,14,26,24,47,0.5106382978723404,0
39,83,0.47,7,26,0.269,16,19,0.842,7,30,37,28,9,4,15,14,32,57,0.5614035087719298,0
44,87,0.506,18,33,0.545,16,17,0.941,8,35,43,32,11,2,16,17,26,54,0.48148148148148145,1
46,91,0.505,8,28,0.286,25,29,0.862,11,38,49,21,10,4,17,10,38,63,0.6031746031746031,1
45,91,0.495,18,42,0.429,12,13,0.923,6,33,39,26,11,4,18,22,27,49,0.5510204081632653,0
34,85,0.4,13,38,0.342,14,21,0.667,11,45,56,21,7,2,21,22,21,47,0.44680851063829785,0
38,94,0.404,18,49,0.367,15,17,0.882,11,42,53,20,7,7,14,17,20,45,0.4444444444444444,1
47,80,0.588,17,35,0.486,22,25,0.88,12,31,43,29,6,2,21,23,30,45,0.6666666666666666,1
36,86,0.419,12,40,0.3,26,30,0.867,12,17,29,23,11,1,12,19,24,46,0.5217391304347826,0
36,83,0.434,11,35,0.314,17,25,0.68,6,45,51,27,3,4,14,19,25,48,0.5208333333333334,0
34,90,0.378,7,33,0.212,27,32,0.844,7,41,48,22,10,2,7,20,27,57,0.47368421052631576,1
43,92,0.467,14,40,0.35,9,11,0.818,8,33,41,28,11,7,11,15,29,52,0.5576923076923077,1
39,94,0.415,13,43,0.302,14,16,0.875,16,35,51,24,8,4,17,10,26,51,0.5098039215686274,0
42,86,0.488,18,42,0.429,7,12,0.583,9,26,35,26,6,3,16,23,24,44,0.5454545454545454,0
44,80,0.55,12,28,0.429,20,29,0.69,9,30,39,34,9,2,13,20,32,52,0.6153846153846154,1
38,99,0.384,17,51,0.333,7,13,0.538,15,39,54,21,4,3,7,15,21,48,0.4375,0
38,89,0.427,12,44,0.273,13,18,0.722,12,39,51,25,6,4,8,11,26,45,0.5777777777777777,1
36,83,0.434,10,29,0.345,18,24,0.75,9,29,38,22,9,2,18,15,26,54,0.48148148148148145,0
44,93,0.473,7,23,0.304,13,16,0.813,19,38,57,27,11,5,17,19,37,70,0.5285714285714286,1
42,94,0.447,9,38,0.237,22,26,0.846,15,22,37,24,9,3,10,19,33,56,0.5892857142857143,0
43,72,0.597,15,30,0.5,23,23,1.0,4,32,36,29,6,4,20,22,28,42,0.6666666666666666,1
41,93,0.441,12,35,0.343,12,18,0.667,11,33,44,27,12,5,15,19,29,58,0.5,0
40,84,0.476,12,34,0.353,16,21,0.762,8,33,41,30,9,9,18,17,28,50,0.56,1
44,89,0.494,13,36,0.361,18,21,0.857,8,40,48,27,8,4,9,18,31,53,0.5849056603773585,1
34,90,0.378,14,44,0.318,22,25,0.88,12,33,45,25,7,2,9,13,20,46,0.43478260869565216,0
42,86,0.488,8,30,0.267,20,24,0.833,9,30,39,24,8,6,15,17,34,56,0.6071428571428571,0
46,88,0.523,15,35,0.429,19,21,0.905,8,31,39,30,8,5,14,23,31,53,0.5849056603773585,1
35,91,0.385,9,30,0.3,23,29,0.793,14,29,43,20,11,4,15,16,26,61,0.4262295081967213,0
51,91,0.56,13,35,0.371,16,18,0.889,8,43,51,32,9,4,15,22,38,56,0.6785714285714286,1
32,79,0.405,8,30,0.267,18,24,0.75,10,28,38,22,13,4,18,14,24,49,0.4897959183673469,0
42,90,0.467,10,31,0.323,14,16,0.875,15,34,49,24,13,7,21,14,32,59,0.5423728813559322,1
36,79,0.456,14,36,0.389,31,36,0.861,9,38,47,24,9,3,17,18,22,43,0.5116279069767442,1
41,94,0.436,12,42,0.286,17,21,0.81,12,33,45,21,8,6,13,24,29,52,0.5576923076923077,0
42,83,0.506,17,46,0.37,10,13,0.769,6,28,34,34,9,8,17,13,25,37,0.6756756756756757,1
44,86,0.512,9,29,0.31,12,12,1.0,11,30,41,28,11,2,17,17,35,57,0.6140350877192983,0
33,85,0.388,10,29,0.345,11,14,0.786,8,36,44,23,9,6,19,20,23,56,0.4107142857142857,0
33,76,0.434,9,26,0.346,22,29,0.759,7,42,49,29,12,3,18,19,24,50,0.48,1
41,94,0.436,9,29,0.31,17,24,0.708,16,39,55,29,7,5,13,23,32,65,0.49230769230769234,1
38,88,0.432,5,33,0.152,21,30,0.7,12,33,45,24,9,5,10,21,33,55,0.6,0
42,92,0.457,17,39,0.436,2,4,0.5,5,23,28,25,9,2,10,24,25,53,0.4716981132075472,0
38,73,0.521,11,27,0.407,26,33,0.788,11,37,48,20,3,7,18,11,27,46,0.5869565217391305,1
37,87,0.425,12,37,0.324,24,29,0.828,11,27,38,30,8,2,16,18,25,50,0.5,0
53,88,0.602,23,41,0.561,13,16,0.813,6,41,47,38,9,7,17,21,30,47,0.6382978723404256,1
39,90,0.433,11,35,0.314,8,12,0.667,11,29,40,24,11,3,19,11,28,55,0.509090909090909,0
45,80,0.563,16,37,0.432,10,16,0.625,6,34,40,30,11,11,20,12,29,43,0.6744186046511628,1
41,79,0.519,16,39,0.41,18,23,0.783,9,32,41,27,12,9,19,22,25,40,0.625,1
36,87,0.414,9,26,0.346,15,21,0.714,15,29,44,21,9,2,19,18,27,61,0.4426229508196721,0
40,102,0.392,14,38,0.368,13,13,1.0,22,31,53,26,8,2,15,12,26,64,0.40625,0
49,87,0.563,16,38,0.421,10,13,0.769,5,35,40,34,11,8,13,12,33,49,0.673469387755102,1
40,94,0.426,15,48,0.313,12,16,0.75,11,43,54,31,8,12,9,17,25,46,0.5434782608695652,1
30,86,0.349,7,30,0.233,10,13,0.769,7,39,46,17,5,5,17,14,23,56,0.4107142857142857,0
45,87,0.517,18,36,0.5,13,17,0.765,10,26,36,33,14,4,17,17,27,51,0.5294117647058824,1
45,83,0.542,17,40,0.425,11,14,0.786,7,29,36,29,12,9,18,14,28,43,0.6511627906976745,0
46,93,0.495,17,41,0.415,27,35,0.771,4,28,32,31,11,6,11,34,29,52,0.5576923076923077,0
46,85,0.541,15,39,0.385,40,45,0.889,6,41,47,21,4,6,17,26,31,46,0.6739130434782609,1
39,83,0.47,15,35,0.429,17,21,0.81,6,23,29,21,4,6,11,9,24,48,0.5,0
49,92,0.533,14,35,0.4,6,6,1.0,11,36,47,32,9,8,16,19,35,57,0.6140350877192983,1
39,84,0.464,8,27,0.296,29,32,0.906,8,31,39,21,3,2,7,22,31,57,0.543859649122807,0
44,86,0.512,9,32,0.281,20,21,0.952,4,33,37,27,4,6,7,24,35,54,0.6481481481481481,1
42,88,0.477,11,30,0.367,23,27,0.852,7,29,36,27,10,2,11,16,31,58,0.5344827586206896,0
41,84,0.488,14,35,0.4,24,24,1.0,11,37,48,26,5,2,16,22,27,49,0.5510204081632653,1
50,97,0.515,15,39,0.385,12,14,0.857,13,33,46,29,12,3,16,20,35,58,0.603448275862069,1
39,84,0.464,11,31,0.355,28,32,0.875,10,31,41,27,10,2,15,14,28,53,0.5283018867924528,0
45,92,0.489,14,29,0.483,18,22,0.818,13,28,41,25,9,6,7,22,31,63,0.49206349206349204,1
35,75,0.467,12,34,0.353,27,32,0.844,9,29,38,27,3,7,14,16,23,41,0.5609756097560976,0
38,75,0.507,6,20,0.3,16,22,0.727,8,29,37,20,7,5,21,17,32,55,0.5818181818181818,0
42,90,0.467,11,34,0.324,18,19,0.947,10,30,40,24,12,4,10,17,31,56,0.5535714285714286,1
40,85,0.471,16,39,0.41,17,19,0.895,8,34,42,26,8,7,14,17,24,46,0.5217391304347826,1
39,87,0.448,14,39,0.359,13,14,0.929,9,29,38,30,7,8,16,17,25,48,0.5208333333333334,0
52,114,0.456,12,39,0.308,17,19,0.895,8,38,46,31,15,3,12,20,40,75,0.5333333333333333,1
44,98,0.449,16,44,0.364,22,26,0.846,14,45,59,31,5,11,25,17,28,54,0.5185185185185185,0
42,89,0.472,16,40,0.4,22,30,0.733,8,35,43,29,9,11,15,25,26,49,0.5306122448979592,0
49,96,0.51,11,31,0.355,21,28,0.75,8,41,49,33,9,4,14,26,38,65,0.5846153846153846,1
42,88,0.477,18,45,0.4,15,21,0.714,5,41,46,29,8,3,18,16,24,43,0.5581395348837209,1
45,113,0.398,10,46,0.217,11,14,0.786,17,42,59,28,13,2,16,23,35,67,0.5223880597014925,0
46,83,0.554,17,36,0.472,19,20,0.95,6,25,31,31,6,4,11,15,29,47,0.6170212765957447,1
47,88,0.534,10,28,0.357,13,19,0.684,12,27,39,20,4,5,9,18,37,60,0.6166666666666667,0
50,93,0.538,17,50,0.34,13,20,0.65,16,39,55,35,6,7,15,19,33,43,0.7674418604651163,1
39,89,0.438,10,32,0.313,16,21,0.762,8,31,39,24,8,3,12,16,29,57,0.5087719298245614,0
39,86,0.453,7,24,0.292,21,23,0.913,10,32,42,23,9,6,15,15,32,62,0.5161290322580645,0
45,86,0.523,15,35,0.429,13,18,0.722,6,31,37,29,8,7,12,21,30,51,0.5882352941176471,1
47,80,0.588,26,41,0.634,14,21,0.667,4,38,42,37,3,12,15,17,21,39,0.5384615384615384,1
44,96,0.458,12,35,0.343,20,24,0.833,10,30,40,31,8,3,8,14,32,61,0.5245901639344263,0
42,87,0.483,10,40,0.25,8,8,1.0,10,41,51,30,5,11,17,12,32,47,0.6808510638297872,1
36,104,0.346,6,30,0.2,9,11,0.818,17,32,49,21,10,5,8,13,30,74,0.40540540540540543,0
37,93,0.398,17,52,0.327,0,0,0.0,12,26,38,27,11,4,12,8,20,41,0.4878048780487805,0
43,81,0.531,17,36,0.472,1,2,0.5,10,39,49,29,6,5,18,4,26,45,0.5777777777777777,1
44,89,0.494,20,43,0.465,13,17,0.765,7,34,41,26,5,4,13,22,24,46,0.5217391304347826,0
43,90,0.478,18,41,0.439,26,32,0.813,10,34,44,30,9,8,8,14,25,49,0.5102040816326531,1
33,96,0.344,20,58,0.345,19,26,0.731,21,35,56,23,8,4,17,22,13,38,0.34210526315789475,0
39,80,0.488,11,30,0.367,23,31,0.742,6,36,42,21,11,8,14,18,28,50,0.56,1
34,84,0.405,14,30,0.467,20,24,0.833,9,35,44,20,3,5,16,17,20,54,0.37037037037037035,0
44,98,0.449,13,37,0.351,19,23,0.826,16,35,51,29,11,8,9,18,31,61,0.5081967213114754,1
41,87,0.471,12,26,0.462,11,11,1.0,10,53,63,28,5,3,21,22,29,61,0.47540983606557374,1
30,89,0.337,8,35,0.229,24,28,0.857,8,30,38,17,16,7,8,13,22,54,0.4074074074074074,0
36,87,0.414,11,36,0.306,27,29,0.931,13,32,45,25,13,2,9,9,25,51,0.49019607843137253,1
40,85,0.471,13,38,0.342,7,8,0.875,13,34,47,28,3,3,22,19,27,47,0.574468085106383,0
54,99,0.545,16,45,0.356,16,23,0.696,15,29,44,33,9,8,14,23,38,54,0.7037037037037037,1
47,94,0.5,5,21,0.238,24,33,0.727,16,24,40,21,8,6,15,20,42,73,0.5753424657534246,0
46,94,0.489,14,37,0.378,5,11,0.455,13,30,43,30,12,12,10,10,32,57,0.5614035087719298,1
36,91,0.396,10,31,0.323,13,13,1.0,11,33,44,19,5,2,15,9,26,60,0.43333333333333335,0
40,79,0.506,14,36,0.389,21,22,0.955,5,28,33,25,11,2,14,18,26,43,0.6046511627906976,1
43,82,0.524,18,40,0.45,10,16,0.625,7,31,38,35,7,2,18,20,25,42,0.5952380952380952,0
35,94,0.372,16,40,0.4,16,18,0.889,15,30,45,19,8,5,10,22,19,54,0.35185185185185186,0
38,86,0.442,11,36,0.306,19,24,0.792,14,42,56,25,4,15,15,16,27,50,0.54,1
33,84,0.393,14,32,0.438,18,19,0.947,10,34,44,21,10,10,16,21,19,52,0.36538461538461536,0
37,82,0.451,15,37,0.405,21,29,0.724,12,35,47,27,11,10,16,15,22,45,0.4888888888888889,1
41,82,0.5,13,30,0.433,12,21,0.571,9,26,35,23,9,5,10,21,28,52,0.5384615384615384,0
46,83,0.554,11,25,0.44,13,23,0.565,11,33,44,31,7,8,14,21,35,58,0.603448275862069,1
46,95,0.484,18,50,0.36,14,15,0.933,9,39,48,29,8,6,13,13,28,45,0.6222222222222222,1
44,95,0.463,12,36,0.333,8,10,0.8,9,35,44,23,9,3,13,13,32,59,0.5423728813559322,0
43,87,0.494,15,44,0.341,10,13,0.769,8,31,39,27,8,8,7,13,28,43,0.6511627906976745,1
33,81,0.407,13,30,0.433,13,13,1.0,12,34,46,22,3,1,18,16,20,51,0.39215686274509803,0
36,78,0.462,11,30,0.367,16,23,0.696,5,29,34,19,6,1,16,15,25,48,0.5208333333333334,0
43,84,0.512,15,40,0.375,16,20,0.8,10,33,43,27,9,4,15,20,28,44,0.6363636363636364,1
32,96,0.333,9,40,0.225,16,20,0.8,4,43,47,24,8,4,15,14,23,56,0.4107142857142857,0
47,101,0.465,16,38,0.421,17,21,0.81,7,55,62,33,12,6,12,16,31,63,0.49206349206349204,1
49,99,0.495,14,36,0.389,6,10,0.6,17,35,52,24,7,4,15,12,35,63,0.5555555555555556,1
40,86,0.465,16,42,0.381,13,16,0.813,10,26,36,25,7,12,12,16,24,44,0.5454545454545454,0
51,96,0.531,14,36,0.389,11,15,0.733,11,31,42,28,14,5,9,15,37,60,0.6166666666666667,1
38,77,0.494,14,35,0.4,15,23,0.652,7,31,38,27,4,2,20,12,24,42,0.5714285714285714,0
36,77,0.468,12,35,0.343,16,20,0.8,10,36,46,24,8,13,16,18,24,42,0.5714285714285714,1
35,97,0.361,8,34,0.235,14,17,0.824,20,29,49,22,9,3,13,18,27,63,0.42857142857142855,0
49,86,0.57,22,40,0.55,15,18,0.833,5,35,40,35,7,2,13,16,27,46,0.5869565217391305,1
46,84,0.548,16,38,0.421,15,20,0.75,5,27,32,26,7,0,14,17,30,46,0.6521739130434783,0
40,95,0.421,21,47,0.447,20,22,0.909,16,23,39,22,8,6,10,18,19,48,0.3958333333333333,0
44,87,0.506,14,39,0.359,22,27,0.815,15,34,49,27,8,7,16,20,30,48,0.625,1
32,76,0.421,15,35,0.429,19,22,0.864,4,29,33,20,3,7,20,15,17,41,0.4146341463414634,0
54,104,0.519,14,41,0.341,9,13,0.692,16,37,53,34,12,1,6,20,40,63,0.6349206349206349,1
46,89,0.517,9,32,0.281,19,22,0.864,7,32,39,37,7,2,14,17,37,57,0.6491228070175439,0
50,95,0.526,13,32,0.406,16,23,0.696,11,30,41,28,9,2,11,14,37,63,0.5873015873015873,1
46,95,0.484,8,31,0.258,7,9,0.778,6,34,40,23,11,7,7,10,38,64,0.59375,1
36,83,0.434,8,29,0.276,9,12,0.75,9,40,49,20,5,5,20,9,28,54,0.5185185185185185,0
42,90,0.467,20,38,0.526,10,16,0.625,5,33,38,24,11,5,9,13,22,52,0.4230769230769231,1
40,86,0.465,13,34,0.382,16,21,0.762,11,42,53,27,6,5,16,15,27,52,0.5192307692307693,0
41,88,0.466,6,35,0.171,22,25,0.88,14,32,46,26,7,4,18,14,35,53,0.660377358490566,1
43,96,0.448,10,39,0.256,13,19,0.684,20,24,44,23,9,7,13,17,33,57,0.5789473684210527,0
42,81,0.519,13,37,0.351,26,34,0.765,10,29,39,25,5,6,19,17,29,44,0.6590909090909091,1
43,95,0.453,17,39,0.436,17,21,0.81,16,26,42,19,14,2,15,27,26,56,0.4642857142857143,0
37,77,0.481,10,31,0.323,19,22,0.864,7,34,41,23,1,1,17,21,27,46,0.5869565217391305,0
45,86,0.523,17,41,0.415,18,23,0.783,6,31,37,37,7,2,7,16,28,45,0.6222222222222222,1
40,90,0.444,9,30,0.3,17,25,0.68,9,31,40,23,4,1,15,25,31,60,0.5166666666666667,0
38,79,0.481,10,37,0.27,23,29,0.793,7,37,44,29,8,11,14,22,28,42,0.6666666666666666,1
41,82,0.5,11,32,0.344,14,19,0.737,16,29,45,22,3,4,14,19,30,50,0.6,0
38,83,0.458,14,30,0.467,21,25,0.84,8,23,31,21,10,3,5,15,24,53,0.4528301886792453,1
42,85,0.494,11,30,0.367,12,13,0.923,8,34,42,27,7,3,19,15,31,55,0.5636363636363636,0
47,89,0.528,13,38,0.342,18,20,0.9,8,30,38,29,13,5,10,12,34,51,0.6666666666666666,1
43,95,0.453,8,27,0.296,19,25,0.76,10,35,45,25,7,7,11,21,35,68,0.5147058823529411,0
42,88,0.477,18,37,0.486,23,28,0.821,8,36,44,22,6,6,13,20,24,51,0.47058823529411764,1
44,92,0.478,11,39,0.282,17,20,0.85,10,38,48,25,3,5,9,20,33,53,0.6226415094339622,1
37,95,0.389,12,35,0.343,21,29,0.724,16,32,48,20,4,5,7,14,25,60,0.4166666666666667,0
40,76,0.526,12,32,0.375,16,17,0.941,6,35,41,25,4,4,19,16,28,44,0.6363636363636364,1
40,91,0.44,14,38,0.368,13,14,0.929,9,26,35,26,12,1,7,19,26,53,0.49056603773584906,0
49,97,0.505,13,36,0.361,9,10,0.9,6,27,33,31,9,4,9,19,36,61,0.5901639344262295,0
45,85,0.529,15,33,0.455,16,23,0.696,11,38,49,31,2,4,18,13,30,52,0.5769230769230769,1
48,98,0.49,14,35,0.4,19,28,0.679,17,39,56,28,9,6,13,25,34,63,0.5396825396825397,1
45,86,0.523,18,43,0.419,19,29,0.655,4,35,39,32,6,5,12,22,27,43,0.627906976744186,0
49,103,0.476,14,38,0.368,10,10,1.0,8,28,36,33,9,4,12,16,35,65,0.5384615384615384,0
51,89,0.573,16,32,0.5,14,21,0.667,10,38,48,29,10,15,17,13,35,57,0.6140350877192983,1
46,91,0.505,19,40,0.475,9,11,0.818,10,37,47,36,10,9,10,11,27,51,0.5294117647058824,1
44,93,0.473,16,33,0.485,6,9,0.667,12,31,43,30,4,1,14,8,28,60,0.4666666666666667,0
46,89,0.517,14,34,0.412,10,16,0.625,14,34,48,22,6,5,20,20,32,55,0.5818181818181818,0
45,94,0.479,14,43,0.326,19,23,0.826,12,30,42,35,10,6,9,14,31,51,0.6078431372549019,1
39,89,0.438,12,36,0.333,25,27,0.926,9,23,32,25,6,5,17,12,27,53,0.5094339622641509,0
65,100,0.65,19,36,0.528,8,10,0.8,12,36,48,41,10,6,16,24,46,64,0.71875,1
50,103,0.485,11,38,0.289,5,14,0.357,17,42,59,31,7,8,18,13,39,65,0.6,1
41,104,0.394,8,37,0.216,15,17,0.882,16,35,51,23,13,8,12,14,33,67,0.4925373134328358,0
46,89,0.517,12,36,0.333,22,26,0.846,16,38,54,32,9,5,18,17,34,53,0.6415094339622641,1
45,100,0.45,8,33,0.242,13,18,0.722,16,27,43,22,9,2,13,18,37,67,0.5522388059701493,0
38,90,0.422,9,34,0.265,18,21,0.857,13,28,41,23,6,3,19,21,29,56,0.5178571428571429,0
46,87,0.529,9,36,0.25,17,19,0.895,13,33,46,29,13,7,19,16,37,51,0.7254901960784313,1
47,86,0.547,16,29,0.552,15,18,0.833,13,19,32,28,13,3,13,24,31,57,0.543859649122807,1
36,70,0.514,9,26,0.346,25,31,0.806,12,24,36,22,7,5,24,20,27,44,0.6136363636363636,0
48,87,0.552,11,29,0.379,17,18,0.944,7,32,39,32,12,3,15,13,37,58,0.6379310344827587,1
41,86,0.477,15,37,0.405,11,14,0.786,10,29,39,26,8,1,19,17,26,49,0.5306122448979592,0
49,101,0.485,8,31,0.258,13,16,0.813,15,29,44,25,15,3,12,21,41,70,0.5857142857142857,0
46,91,0.505,12,32,0.375,16,21,0.762,16,37,53,27,7,6,21,17,34,59,0.576271186440678,1
32,97,0.33,8,39,0.205,14,17,0.824,12,29,41,19,8,2,15,15,24,58,0.41379310344827586,0
54,97,0.557,14,34,0.412,13,16,0.813,11,47,58,38,6,6,15,17,40,63,0.6349206349206349,1
30,75,0.4,7,27,0.259,21,23,0.913,7,27,34,16,10,4,17,18,23,48,0.4791666666666667,0
42,85,0.494,11,35,0.314,18,19,0.947,7,36,43,27,11,5,14,18,31,50,0.62,1
32,83,0.386,9,34,0.265,13,17,0.765,4,38,42,19,8,6,13,14,23,49,0.46938775510204084,0
41,96,0.427,14,44,0.318,11,15,0.733,13,44,57,30,8,6,14,16,27,52,0.5192307692307693,1
31,98,0.316,7,45,0.156,13,17,0.765,23,31,54,18,11,2,18,19,24,53,0.4528301886792453,0
43,87,0.494,13,34,0.382,22,27,0.815,13,38,51,29,11,6,14,19,30,53,0.5660377358490566,1
36,92,0.391,8,33,0.242,15,20,0.75,11,29,40,17,7,3,14,9,28,59,0.4745762711864407,0
49,91,0.538,15,34,0.441,10,14,0.714,12,42,54,33,9,3,14,17,34,57,0.5964912280701754,1
35,84,0.417,14,35,0.4,26,29,0.897,6,35,41,24,8,7,8,12,21,49,0.42857142857142855,1
43,93,0.462,9,30,0.3,11,15,0.733,10,40,50,30,4,2,12,23,34,63,0.5396825396825397,0
33,80,0.413,10,32,0.313,18,23,0.783,8,34,42,19,5,3,16,17,23,48,0.4791666666666667,0
43,98,0.439,18,39,0.462,14,15,0.933,15,34,49,28,10,5,8,17,25,59,0.423728813559322,1
41,91,0.451,11,37,0.297,23,28,0.821,8,26,34,30,4,2,9,16,30,54,0.5555555555555556,0
54,95,0.568,11,26,0.423,12,15,0.8,10,37,47,27,6,8,7,20,43,69,0.6231884057971014,1
38,90,0.422,14,39,0.359,14,19,0.737,18,29,47,23,12,4,13,19,24,51,0.47058823529411764,0
36,86,0.419,12,35,0.343,21,23,0.913,15,34,49,23,4,3,15,17,24,51,0.47058823529411764,1
35,92,0.38,13,43,0.302,8,10,0.8,7,31,38,27,12,6,12,19,22,49,0.4489795918367347,0
38,82,0.463,14,33,0.424,22,24,0.917,9,38,47,26,6,6,15,11,24,49,0.4897959183673469,1
36,88,0.409,11,41,0.268,15,22,0.682,14,26,40,21,9,4,15,17,25,47,0.5319148936170213,0
44,85,0.518,7,19,0.368,10,13,0.769,11,34,45,29,9,8,15,19,37,66,0.5606060606060606,1
28,86,0.326,8,37,0.216,19,30,0.633,11,29,40,16,12,7,12,25,20,49,0.40816326530612246,0
36,81,0.444,8,30,0.267,17,21,0.81,10,44,54,21,9,4,18,21,28,51,0.5490196078431373,1
39,79,0.494,8,29,0.276,17,19,0.895,6,34,40,22,3,7,12,15,31,50,0.62,0
47,102,0.461,15,42,0.357,5,6,0.833,15,34,49,27,7,4,6,20,32,60,0.5333333333333333,1
33,75,0.44,9,28,0.321,20,25,0.8,3,25,28,16,9,6,15,19,24,47,0.5106382978723404,0
44,88,0.5,12,32,0.375,20,22,0.909,13,39,52,26,8,2,15,24,32,56,0.5714285714285714,1
36,81,0.444,12,35,0.343,20,22,0.909,9,24,33,17,8,7,11,21,24,46,0.5217391304347826,0
36,91,0.396,16,35,0.457,23,28,0.821,23,32,55,20,6,7,12,18,20,56,0.35714285714285715,1
38,81,0.469,12,37,0.324,6,6,1.0,5,29,34,23,4,1,11,13,26,44,0.5909090909090909,0
39,82,0.476,22,49,0.449,14,16,0.875,10,34,44,27,6,6,11,10,17,33,0.5151515151515151,1
31,80,0.388,10,33,0.303,25,33,0.758,9,32,41,14,7,9,9,15,21,47,0.44680851063829785,0
40,87,0.46,18,36,0.5,11,13,0.846,10,35,45,21,5,3,14,22,22,51,0.43137254901960786,1
36,91,0.396,8,38,0.211,14,21,0.667,14,36,50,20,4,5,13,16,28,53,0.5283018867924528,0
41,87,0.471,14,37,0.378,13,13,1.0,5,42,47,21,5,5,12,22,27,50,0.54,1
37,96,0.385,11,39,0.282,7,9,0.778,18,34,52,22,7,6,14,16,26,57,0.45614035087719296,0
37,85,0.435,10,32,0.313,10,13,0.769,8,36,44,21,5,7,13,13,27,53,0.5094339622641509,1
29,80,0.363,9,35,0.257,19,26,0.731,11,30,41,18,8,5,17,22,20,45,0.4444444444444444,0
34,82,0.415,12,39,0.308,16,26,0.615,15,33,48,18,11,6,15,24,22,43,0.5116279069767442,1
38,78,0.487,13,30,0.433,10,13,0.769,4,34,38,24,6,3,15,20,25,48,0.5208333333333334,0
39,88,0.443,8,34,0.235,15,17,0.882,9,36,45,26,6,4,9,17,31,54,0.5740740740740741,1
36,84,0.429,13,36,0.361,16,22,0.727,10,34,44,26,3,6,11,21,23,48,0.4791666666666667,0
37,91,0.407,11,33,0.333,19,23,0.826,12,34,46,22,5,6,8,17,26,58,0.4482758620689655,1
32,76,0.421,14,33,0.424,18,27,0.667,11,39,50,17,8,7,14,23,18,43,0.4186046511627907,1
32,87,0.368,8,30,0.267,21,26,0.808,14,33,47,18,9,4,9,19,24,57,0.42105263157894735,0
50,90,0.556,16,36,0.444,9,14,0.643,7,38,45,38,3,6,6,18,34,54,0.6296296296296297,1
38,86,0.442,13,32,0.406,19,21,0.905,8,32,40,24,4,4,8,13,25,54,0.46296296296296297,0
35,78,0.449,8,22,0.364,15,19,0.789,11,30,41,19,7,1,20,22,27,56,0.48214285714285715,0
35,78,0.449,9,32,0.281,26,30,0.867,10,29,39,23,11,2,14,21,26,46,0.5652173913043478,1
37,75,0.493,23,43,0.535,14,18,0.778,4,36,40,25,9,1,14,22,14,32,0.4375,1
37,80,0.463,12,32,0.375,15,21,0.714,6,33,39,21,9,8,13,17,25,48,0.5208333333333334,0
33,73,0.452,7,26,0.269,19,21,0.905,8,27,35,16,4,2,18,24,26,47,0.5531914893617021,0
46,78,0.59,14,29,0.483,18,20,0.9,5,32,37,25,5,2,9,19,32,49,0.6530612244897959,1
44,90,0.489,5,28,0.179,19,22,0.864,14,37,51,27,4,3,13,14,39,62,0.6290322580645161,1
44,90,0.489,5,27,0.185,12,17,0.706,8,30,38,23,8,2,7,16,39,63,0.6190476190476191,0
32,82,0.39,8,34,0.235,11,13,0.846,5,27,32,24,2,8,14,16,24,48,0.5,0
47,92,0.511,13,37,0.351,14,16,0.875,14,37,51,24,7,3,9,21,34,55,0.6181818181818182,1
44,90,0.489,13,30,0.433,13,19,0.684,11,21,32,27,4,3,9,25,31,60,0.5166666666666667,0
41,75,0.547,15,31,0.484,28,33,0.848,8,28,36,24,6,8,11,18,26,44,0.5909090909090909,1
32,70,0.457,10,29,0.345,16,20,0.8,8,33,41,19,5,4,19,24,22,41,0.5365853658536586,0
39,86,0.453,9,35,0.257,14,19,0.737,11,25,36,21,12,7,9,16,30,51,0.5882352941176471,1
41,88,0.466,10,31,0.323,26,27,0.963,11,32,43,20,6,2,12,26,31,57,0.543859649122807,0
45,105,0.429,13,49,0.265,18,24,0.75,19,31,50,32,5,4,8,20,32,56,0.5714285714285714,1
43,87,0.494,13,34,0.382,27,31,0.871,15,35,50,26,5,1,14,25,30,53,0.5660377358490566,1
35,76,0.461,11,28,0.393,28,32,0.875,5,23,28,24,8,3,10,26,24,48,0.5,0
39,87,0.448,9,30,0.3,21,25,0.84,9,31,40,30,9,4,14,15,30,57,0.5263157894736842,0
48,92,0.522,8,26,0.308,15,18,0.833,8,38,46,23,6,2,12,20,40,66,0.6060606060606061,1
39,82,0.476,11,37,0.297,15,21,0.714,10,33,43,22,4,6,6,16,28,45,0.6222222222222222,1
32,77,0.416,9,28,0.321,11,14,0.786,9,27,36,21,2,2,12,14,23,49,0.46938775510204084,0
40,83,0.482,17,36,0.472,9,13,0.692,9,38,47,27,13,5,16,14,23,47,0.48936170212765956,1
32,84,0.381,9,32,0.281,12,14,0.857,11,34,45,18,14,2,21,15,23,52,0.4423076923076923,0
34,72,0.472,4,17,0.235,17,21,0.81,2,27,29,24,10,3,15,20,30,55,0.5454545454545454,0
43,77,0.558,12,26,0.462,14,19,0.737,8,35,43,24,7,6,18,19,31,51,0.6078431372549019,1
43,80,0.538,18,29,0.621,12,18,0.667,5,24,29,22,10,6,13,27,25,51,0.49019607843137253,1
40,81,0.494,11,33,0.333,20,25,0.8,14,28,42,22,5,5,17,21,29,48,0.6041666666666666,0
46,90,0.511,12,33,0.364,9,14,0.643,7,35,42,26,5,4,9,18,34,57,0.5964912280701754,0
46,89,0.517,22,43,0.512,12,18,0.667,5,33,38,33,5,6,8,18,24,46,0.5217391304347826,1
37,86,0.43,7,27,0.259,16,26,0.615,15,37,52,19,1,11,12,19,30,59,0.5084745762711864,1
29,82,0.354,9,33,0.273,25,29,0.862,9,33,42,23,5,5,9,24,20,49,0.40816326530612246,0
41,89,0.461,15,36,0.417,25,31,0.806,17,27,44,23,6,6,12,27,26,53,0.49056603773584906,1
38,74,0.514,10,26,0.385,30,36,0.833,10,23,33,20,6,7,12,26,28,48,0.5833333333333334,0
39,84,0.464,10,35,0.286,18,27,0.667,11,30,41,30,7,6,9,12,29,49,0.5918367346938775,0
42,89,0.472,16,38,0.421,8,9,0.889,9,36,45,28,6,1,14,16,26,51,0.5098039215686274,1
36,86,0.419,14,37,0.378,16,18,0.889,11,35,46,21,5,3,11,20,22,49,0.4489795918367347,1
35,86,0.407,9,33,0.273,9,12,0.75,8,34,42,17,4,3,15,18,26,53,0.49056603773584906,0
35,82,0.427,12,40,0.3,15,24,0.625,8,36,44,18,9,7,14,18,23,42,0.5476190476190477,1
32,85,0.376,8,34,0.235,17,20,0.85,12,38,50,22,10,8,19,25,24,51,0.47058823529411764,0
36,78,0.462,9,31,0.29,22,29,0.759,7,36,43,17,5,7,14,17,27,47,0.574468085106383,0
38,88,0.432,13,37,0.351,15,19,0.789,8,31,39,23,9,3,10,25,25,51,0.49019607843137253,1
36,81,0.444,12,38,0.316,8,13,0.615,10,26,36,25,3,3,13,18,24,43,0.5581395348837209,0
44,84,0.524,11,29,0.379,16,20,0.8,11,33,44,23,8,4,11,15,33,55,0.6,1
42,91,0.462,15,39,0.385,13,19,0.684,12,34,46,28,5,7,17,23,27,52,0.5192307692307693,1
40,86,0.465,10,36,0.278,16,24,0.667,6,34,40,19,10,8,15,19,30,50,0.6,0
36,87,0.414,3,29,0.103,9,10,0.9,2,27,29,20,4,0,6,17,33,58,0.5689655172413793,0
42,77,0.545,16,40,0.4,18,27,0.667,8,48,56,23,5,3,15,15,26,37,0.7027027027027027,1
47,87,0.54,14,39,0.359,15,20,0.75,9,31,40,27,5,6,10,22,33,48,0.6875,1
33,87,0.379,9,35,0.257,18,21,0.857,14,31,45,18,4,0,15,19,24,52,0.46153846153846156,0
35,83,0.422,7,27,0.259,21,32,0.656,15,25,40,19,4,0,12,18,28,56,0.5,0
46,85,0.541,13,40,0.325,15,17,0.882,7,37,44,33,7,3,11,26,33,45,0.7333333333333333,1
43,93,0.462,14,31,0.452,18,24,0.75,20,28,48,28,6,8,9,17,29,62,0.46774193548387094,1
38,87,0.437,17,40,0.425,22,23,0.957,16,30,46,20,6,5,12,22,21,47,0.44680851063829785,0
34,82,0.415,8,31,0.258,25,32,0.781,16,29,45,23,4,2,11,26,26,51,0.5098039215686274,0
40,83,0.482,12,36,0.333,22,33,0.667,18,27,45,26,6,4,10,24,28,47,0.5957446808510638,1
42,86,0.488,7,28,0.25,5,10,0.5,7,31,38,15,8,10,15,23,35,58,0.603448275862069,0
35,89,0.393,11,36,0.306,22,26,0.846,15,33,48,19,6,4,14,15,24,53,0.4528301886792453,1
43,82,0.524,11,27,0.407,9,12,0.75,7,35,42,24,4,6,14,20,32,55,0.5818181818181818,1
35,75,0.467,13,31,0.419,16,20,0.8,3,31,34,24,12,2,12,18,22,44,0.5,0
29,86,0.337,10,31,0.323,26,30,0.867,18,31,49,17,11,4,17,32,19,55,0.34545454545454546,0
34,77,0.442,8,24,0.333,30,36,0.833,10,38,48,19,8,8,16,23,26,53,0.49056603773584906,1
42,84,0.5,13,33,0.394,9,14,0.643,10,32,42,28,11,12,12,20,29,51,0.5686274509803921,1
29,83,0.349,9,30,0.3,13,18,0.722,18,32,50,16,6,6,19,14,20,53,0.37735849056603776,0
46,88,0.523,10,26,0.385,15,19,0.789,7,25,32,32,9,5,8,22,36,62,0.5806451612903226,0
44,82,0.537,11,23,0.478,22,26,0.846,8,32,40,25,5,4,15,19,33,59,0.559322033898305,1
37,90,0.411,11,42,0.262,10,13,0.769,7,31,38,19,2,3,5,18,26,48,0.5416666666666666,0
45,92,0.489,18,46,0.391,12,14,0.857,13,42,55,22,2,7,9,13,27,46,0.5869565217391305,1
33,84,0.393,12,35,0.343,17,25,0.68,11,28,39,19,5,8,16,21,21,49,0.42857142857142855,0
40,89,0.449,16,35,0.457,21,28,0.75,16,36,52,29,8,8,11,18,24,54,0.4444444444444444,1
48,93,0.516,15,34,0.441,10,17,0.588,14,20,34,33,5,3,9,17,33,59,0.559322033898305,0
49,86,0.57,14,30,0.467,18,22,0.818,12,32,44,28,5,3,11,14,35,56,0.625,1
47,86,0.547,13,28,0.464,11,16,0.688,7,37,44,24,4,3,12,20,34,58,0.5862068965517241,1
33,80,0.413,8,35,0.229,20,24,0.833,6,25,31,22,5,3,7,15,25,45,0.5555555555555556,0
42,90,0.467,18,37,0.486,17,24,0.708,12,32,44,30,8,6,10,21,24,53,0.4528301886792453,1
42,89,0.472,10,30,0.333,16,17,0.941,8,33,41,25,5,6,10,18,32,59,0.5423728813559322,0
38,80,0.475,14,27,0.519,16,22,0.727,10,31,41,19,6,6,13,18,24,53,0.4528301886792453,0
42,89,0.472,12,32,0.375,15,18,0.833,13,29,42,22,6,6,10,20,30,57,0.5263157894736842,1
43,80,0.538,14,29,0.483,17,20,0.85,8,32,40,26,9,4,11,25,29,51,0.5686274509803921,1
31,71,0.437,10,33,0.303,18,25,0.72,5,27,32,23,5,3,16,20,21,38,0.5526315789473685,0
41,80,0.513,13,34,0.382,11,14,0.786,9,35,44,22,3,4,12,14,28,46,0.6086956521739131,1
36,84,0.429,12,36,0.333,9,10,0.9,7,28,35,17,4,2,8,14,24,48,0.5,0
38,81,0.469,10,30,0.333,15,19,0.789,6,35,41,23,7,11,14,22,28,51,0.5490196078431373,0
39,91,0.429,11,33,0.333,16,25,0.64,15,33,48,21,7,2,14,16,28,58,0.4827586206896552,1
30,89,0.337,7,37,0.189,22,31,0.71,16,27,43,18,8,2,14,12,23,52,0.4423076923076923,0
50,88,0.568,14,31,0.452,7,8,0.875,9,43,52,31,9,7,14,25,36,57,0.631578947368421,1
45,79,0.57,13,29,0.448,12,15,0.8,5,26,31,29,7,6,12,20,32,50,0.64,1
39,82,0.476,11,28,0.393,18,27,0.667,12,30,42,21,5,3,11,21,28,54,0.5185185185185185,0
38,78,0.487,12,32,0.375,21,24,0.875,10,38,48,15,6,4,15,12,26,46,0.5652173913043478,1
41,94,0.436,15,48,0.313,5,7,0.714,8,24,32,26,8,3,8,17,26,46,0.5652173913043478,0
35,92,0.38,7,27,0.259,23,24,0.958,12,33,45,18,8,9,8,20,28,65,0.4307692307692308,1
36,88,0.409,12,35,0.343,12,23,0.522,12,35,47,26,4,13,14,18,24,53,0.4528301886792453,0
38,78,0.487,8,26,0.308,13,19,0.684,8,25,33,30,7,7,14,20,30,52,0.5769230769230769,0
44,80,0.55,9,19,0.474,15,18,0.833,8,30,38,30,6,5,12,17,35,61,0.5737704918032787,1
31,72,0.431,12,27,0.444,17,22,0.773,5,24,29,24,5,6,18,19,19,45,0.4222222222222222,0
47,101,0.465,12,35,0.343,15,19,0.789,20,33,53,26,7,5,9,22,35,66,0.5303030303030303,1
38,79,0.481,13,31,0.419,9,12,0.75,6,22,28,25,5,2,10,16,25,48,0.5208333333333334,0
42,80,0.525,19,43,0.442,10,12,0.833,11,32,43,32,6,6,14,15,23,37,0.6216216216216216,1
40,76,0.526,14,35,0.4,10,13,0.769,9,37,46,27,5,5,14,17,26,41,0.6341463414634146,1
37,87,0.425,10,40,0.25,8,10,0.8,8,25,33,20,8,2,7,15,27,47,0.574468085106383,0
26,86,0.302,7,36,0.194,11,14,0.786,10,33,43,18,2,5,12,17,19,50,0.38,0
40,86,0.465,15,40,0.375,20,24,0.833,11,51,62,26,9,4,6,14,25,46,0.5434782608695652,1
36,82,0.439,13,34,0.382,18,26,0.692,13,22,35,20,6,5,9,15,23,48,0.4791666666666667,0
49,91,0.538,9,26,0.346,9,13,0.692,14,33,47,35,3,8,9,21,40,65,0.6153846153846154,1
44,92,0.478,15,41,0.366,13,17,0.765,7,24,31,25,10,5,10,20,29,51,0.5686274509803921,0
42,82,0.512,16,34,0.471,17,24,0.708,14,33,47,25,5,4,18,23,26,48,0.5416666666666666,1
31,79,0.392,10,34,0.294,26,30,0.867,11,36,47,18,9,6,9,21,21,45,0.4666666666666667,1
34,83,0.41,8,33,0.242,14,16,0.875,11,33,44,18,3,7,10,23,26,50,0.52,0
53,79,0.671,13,24,0.542,11,16,0.688,7,26,33,33,7,9,14,22,40,55,0.7272727272727273,1
36,85,0.424,13,35,0.371,24,27,0.889,9,19,28,22,5,2,10,17,23,50,0.46,0
53,99,0.535,13,35,0.371,9,10,0.9,10,34,44,38,8,4,22,23,40,64,0.625,0
47,99,0.475,15,45,0.333,24,30,0.8,13,30,43,30,11,5,15,15,32,54,0.5925925925925926,1
43,87,0.494,6,25,0.24,16,17,0.941,11,37,48,21,5,8,13,15,37,62,0.5967741935483871,1
38,89,0.427,18,49,0.367,11,18,0.611,10,30,40,23,8,3,10,17,20,40,0.5,0
44,84,0.524,11,29,0.379,11,16,0.688,12,25,37,23,5,2,16,23,33,55,0.6,0
47,88,0.534,15,37,0.405,17,20,0.85,13,27,40,28,9,2,12,16,32,51,0.6274509803921569,1
41,84,0.488,12,31,0.387,15,22,0.682,11,33,44,24,7,7,10,17,29,53,0.5471698113207547,1
35,85,0.412,12,31,0.387,26,32,0.813,12,28,40,26,7,7,9,19,23,54,0.42592592592592593,0
39,83,0.47,16,46,0.348,20,26,0.769,7,29,36,24,7,12,9,18,23,37,0.6216216216216216,1
46,91,0.505,5,22,0.227,14,14,1.0,9,34,43,32,4,1,11,21,41,69,0.5942028985507246,0
43,85,0.506,9,30,0.3,12,17,0.706,10,23,33,26,4,2,10,24,34,55,0.6181818181818182,0
38,68,0.559,14,28,0.5,26,31,0.839,7,25,32,19,7,5,14,19,24,40,0.6,1
40,89,0.449,14,44,0.318,11,14,0.786,12,32,44,22,10,6,13,18,26,45,0.5777777777777777,1
40,87,0.46,10,29,0.345,12,16,0.75,13,34,47,24,5,4,14,19,30,58,0.5172413793103449,0
39,74,0.527,11,24,0.458,16,25,0.64,6,34,40,23,9,4,15,23,28,50,0.56,1
34,81,0.42,14,40,0.35,18,21,0.857,10,28,38,23,6,4,14,22,20,41,0.4878048780487805,0
46,84,0.548,15,34,0.441,17,23,0.739,9,36,45,19,7,5,13,20,31,50,0.62,1
38,89,0.427,10,32,0.313,17,21,0.81,13,28,41,17,8,5,14,17,28,57,0.49122807017543857,0
35,84,0.417,7,27,0.259,12,19,0.632,10,33,43,9,8,1,11,16,28,57,0.49122807017543857,0
39,82,0.476,16,42,0.381,13,19,0.684,10,37,47,23,6,9,14,16,23,40,0.575,1
38,80,0.475,6,26,0.231,16,24,0.667,9,34,43,21,5,3,15,17,32,54,0.5925925925925926,0
38,84,0.452,10,39,0.256,19,20,0.95,10,31,41,29,10,5,11,15,28,45,0.6222222222222222,1
38,82,0.463,17,46,0.37,13,14,0.929,6,30,36,26,4,6,9,19,21,36,0.5833333333333334,1
38,86,0.442,9,25,0.36,14,16,0.875,7,36,43,15,5,1,9,17,29,61,0.47540983606557374,0
29,80,0.363,14,41,0.341,12,13,0.923,4,27,31,18,2,5,14,19,15,39,0.38461538461538464,0
46,91,0.505,15,37,0.405,15,22,0.682,13,39,52,21,7,2,9,17,31,54,0.5740740740740741,1
35,78,0.449,11,37,0.297,7,13,0.538,7,28,35,18,4,4,13,20,24,41,0.5853658536585366,0
38,89,0.427,13,39,0.333,17,20,0.85,15,36,51,25,9,2,9,15,25,50,0.5,1
